"","date","tmin","tmax","prcp","delta"
"1",1960-01-01,-40,99,0,139
"2",1960-01-02,-18,148,0,166
"3",1960-01-03,20,188,0,168
"4",1960-01-04,-3,153,0,156
"5",1960-01-05,-18,68,0,86
"6",1960-01-06,-53,66,0,119
"7",1960-01-07,-7,42,0,49
"8",1960-01-08,-24,54,0,78
"9",1960-01-09,-42,97,0,139
"10",1960-01-10,-5,142,0,147
"11",1960-01-11,-43,60,0,103
"12",1960-01-12,-50,63,0,113
"13",1960-01-13,-54,102,0,156
"14",1960-01-14,-23,24,18,47
"15",1960-01-15,-19,2,62,21
"16",1960-01-16,-39,28,0,67
"17",1960-01-17,-38,6,0,44
"18",1960-01-18,-16,-4,13,12
"19",1960-01-19,-25,-6,16,19
"20",1960-01-20,-56,37,0,93
"21",1960-01-21,-54,14,0,68
"22",1960-01-22,-70,-36,0,34
"23",1960-01-23,-81,-17,0,64
"24",1960-01-24,-93,39,0,132
"25",1960-01-25,-35,53,0,88
"26",1960-01-26,-53,49,0,102
"27",1960-01-27,-89,23,0,112
"28",1960-01-28,-33,11,0,44
"29",1960-01-29,-80,66,0,146
"30",1960-01-30,-27,78,0,105
"31",1960-01-31,-44,61,0,105
"32",1960-02-01,-42,34,0,76
"33",1960-02-02,-53,116,0,169
"34",1960-02-03,-36,99,0,135
"35",1960-02-04,-2,142,0,144
"36",1960-02-05,-19,182,0,201
"37",1960-02-06,-6,236,0,242
"38",1960-02-07,23,151,0,128
"39",1960-02-08,-39,228,0,267
"40",1960-02-09,12,158,0,146
"41",1960-02-10,-49,147,0,196
"42",1960-02-11,-27,77,0,104
"43",1960-02-12,-77,76,0,153
"44",1960-02-13,-28,157,0,185
"45",1960-02-14,-43,86,0,129
"46",1960-02-15,22,76,5,54
"47",1960-02-16,2,134,0,132
"48",1960-02-17,16,86,0,70
"49",1960-02-18,-60,119,0,179
"50",1960-02-19,-35,179,0,214
"51",1960-02-20,40,144,0,104
"52",1960-02-21,-40,122,0,162
"53",1960-02-22,-35,167,0,202
"54",1960-02-23,-7,221,0,228
"55",1960-02-24,10,253,0,243
"56",1960-02-25,43,181,0,138
"57",1960-02-26,10,73,0,63
"58",1960-02-27,-63,137,0,200
"59",1960-02-28,-33,186,0,219
"60",1960-02-29,33,196,0,163
"61",1960-03-01,7,201,0,194
"62",1960-03-02,35,102,0,67
"63",1960-03-03,44,86,0,42
"64",1960-03-04,-8,77,1,85
"65",1960-03-05,62,186,0,124
"66",1960-03-06,90,139,210,49
"67",1960-03-07,54,107,8,53
"68",1960-03-08,61,139,0,78
"69",1960-03-09,34,127,0,93
"70",1960-03-10,40,167,0,127
"71",1960-03-11,58,190,0,132
"72",1960-03-12,2,118,0,116
"73",1960-03-13,-7,51,178,58
"74",1960-03-14,-33,90,0,123
"75",1960-03-15,21,91,0,70
"76",1960-03-16,7,135,1,128
"77",1960-03-17,66,124,0,58
"78",1960-03-18,66,91,99,25
"79",1960-03-19,70,134,36,64
"80",1960-03-20,86,199,0,113
"81",1960-03-21,46,131,0,85
"82",1960-03-22,25,140,0,115
"83",1960-03-23,41,110,80,69
"84",1960-03-24,-3,50,156,53
"85",1960-03-25,-36,145,2,181
"86",1960-03-26,40,184,0,144
"87",1960-03-27,59,215,0,156
"88",1960-03-28,121,214,0,93
"89",1960-03-29,101,140,0,39
"90",1960-03-30,68,103,26,35
"91",1960-03-31,33,105,0,72
"92",1960-04-01,7,158,0,151
"93",1960-04-02,21,164,0,143
"94",1960-04-03,54,212,0,158
"95",1960-04-04,58,173,0,115
"96",1960-04-05,47,230,0,183
"97",1960-04-06,67,262,0,195
"98",1960-04-07,46,203,0,157
"99",1960-04-08,29,106,16,77
"100",1960-04-09,81,198,29,117
"101",1960-04-10,81,161,0,80
"102",1960-04-11,46,101,10,55
"103",1960-04-12,46,69,26,23
"104",1960-04-13,31,182,0,151
"105",1960-04-14,105,166,0,61
"106",1960-04-15,95,196,0,101
"107",1960-04-16,66,168,0,102
"108",1960-04-17,7,221,0,214
"109",1960-04-18,91,214,0,123
"110",1960-04-19,95,233,0,138
"111",1960-04-20,38,267,0,229
"112",1960-04-21,116,299,0,183
"113",1960-04-22,105,311,0,206
"114",1960-04-23,144,282,0,138
"115",1960-04-24,124,326,0,202
"116",1960-04-25,151,314,0,163
"117",1960-04-26,140,253,6,113
"118",1960-04-27,110,177,15,67
"119",1960-04-28,86,237,0,151
"120",1960-04-29,119,294,0,175
"121",1960-04-30,122,324,0,202
"122",1960-05-01,105,291,0,186
"123",1960-05-02,143,373,0,230
"124",1960-05-03,197,315,0,118
"125",1960-05-04,177,268,0,91
"126",1960-05-05,130,178,0,48
"127",1960-05-06,79,130,45,51
"128",1960-05-07,54,122,0,68
"129",1960-05-08,85,110,69,25
"130",1960-05-09,93,158,57,65
"131",1960-05-10,104,293,0,189
"132",1960-05-11,177,279,0,102
"133",1960-05-12,148,228,0,80
"134",1960-05-13,137,234,0,97
"135",1960-05-14,125,247,0,122
"136",1960-05-15,113,316,0,203
"137",1960-05-16,191,330,0,139
"138",1960-05-17,182,289,0,107
"139",1960-05-18,148,246,0,98
"140",1960-05-19,108,289,0,181
"141",1960-05-20,102,290,0,188
"142",1960-05-21,79,316,0,237
"143",1960-05-22,171,277,0,106
"144",1960-05-23,180,256,0,76
"145",1960-05-24,104,273,0,169
"146",1960-05-25,95,292,0,197
"147",1960-05-26,147,348,0,201
"148",1960-05-27,166,299,13,133
"149",1960-05-28,106,282,0,176
"150",1960-05-29,127,321,0,194
"151",1960-05-30,167,326,0,159
"152",1960-05-31,200,307,0,107
"153",1960-06-01,159,351,0,192
"154",1960-06-02,178,390,0,212
"155",1960-06-03,223,339,0,116
"156",1960-06-04,213,388,0,175
"157",1960-06-05,188,366,0,178
"158",1960-06-06,224,359,0,135
"159",1960-06-07,211,329,0,118
"160",1960-06-08,199,344,0,145
"161",1960-06-09,231,352,0,121
"162",1960-06-10,230,325,0,95
"163",1960-06-11,229,325,6,96
"164",1960-06-12,192,357,0,165
"165",1960-06-13,223,329,0,106
"166",1960-06-14,228,310,0,82
"167",1960-06-15,169,325,0,156
"168",1960-06-16,218,328,0,110
"169",1960-06-17,214,343,0,129
"170",1960-06-18,246,320,0,74
"171",1960-06-19,226,314,0,88
"172",1960-06-20,223,349,0,126
"173",1960-06-21,219,418,0,199
"174",1960-06-22,236,371,0,135
"175",1960-06-23,220,378,0,158
"176",1960-06-24,256,383,0,127
"177",1960-06-25,237,329,0,92
"178",1960-06-26,203,319,0,116
"179",1960-06-27,241,302,0,61
"180",1960-06-28,191,393,0,202
"181",1960-06-29,215,356,0,141
"182",1960-06-30,207,325,37,118
"183",1960-07-01,208,276,87,68
"184",1960-07-02,211,262,124,51
"185",1960-07-03,240,336,0,96
"186",1960-07-04,257,349,0,92
"187",1960-07-05,270,338,1,68
"188",1960-07-06,242,329,375,87
"189",1960-07-07,232,319,6,87
"190",1960-07-08,216,332,0,116
"191",1960-07-09,217,327,0,110
"192",1960-07-10,200,290,122,90
"193",1960-07-11,189,284,0,95
"194",1960-07-12,231,276,3,45
"195",1960-07-13,219,302,0,83
"196",1960-07-14,231,339,0,108
"197",1960-07-15,248,308,15,60
"198",1960-07-16,229,368,28,139
"199",1960-07-17,235,360,0,125
"200",1960-07-18,252,351,60,99
"201",1960-07-19,236,349,27,113
"202",1960-07-20,239,354,0,115
"203",1960-07-21,247,342,3,95
"204",1960-07-22,225,329,300,104
"205",1960-07-23,223,279,4,56
"206",1960-07-24,212,281,0,69
"207",1960-07-25,212,257,15,45
"208",1960-07-26,209,299,0,90
"209",1960-07-27,213,274,107,61
"210",1960-07-28,186,239,128,53
"211",1960-07-29,204,268,0,64
"212",1960-07-30,209,308,5,99
"213",1960-07-31,221,342,0,121
"214",1960-08-01,251,356,0,105
"215",1960-08-02,264,333,0,69
"216",1960-08-03,255,309,0,54
"217",1960-08-04,249,335,0,86
"218",1960-08-05,250,323,0,73
"219",1960-08-06,229,343,0,114
"220",1960-08-07,231,354,0,123
"221",1960-08-08,260,344,12,84
"222",1960-08-09,223,269,9,46
"223",1960-08-10,209,251,129,42
"224",1960-08-11,216,274,0,58
"225",1960-08-12,182,273,0,91
"226",1960-08-13,208,283,10,75
"227",1960-08-14,204,283,0,79
"228",1960-08-15,188,281,31,93
"229",1960-08-16,217,284,9,67
"230",1960-08-17,196,309,0,113
"231",1960-08-18,211,314,0,103
"232",1960-08-19,208,324,0,116
"233",1960-08-20,238,319,5,81
"234",1960-08-21,203,239,105,36
"235",1960-08-22,198,279,0,81
"236",1960-08-23,173,333,0,160
"237",1960-08-24,196,315,0,119
"238",1960-08-25,200,324,0,124
"239",1960-08-26,202,310,0,108
"240",1960-08-27,189,247,14,58
"241",1960-08-28,180,291,0,111
"242",1960-08-29,177,334,0,157
"243",1960-08-30,191,357,0,166
"244",1960-08-31,218,339,0,121
"245",1960-09-01,197,337,0,140
"246",1960-09-02,219,299,4,80
"247",1960-09-03,195,256,1,61
"248",1960-09-04,184,271,32,87
"249",1960-09-05,204,229,346,25
"250",1960-09-06,197,267,91,70
"251",1960-09-07,200,294,7,94
"252",1960-09-08,175,313,0,138
"253",1960-09-09,176,290,0,114
"254",1960-09-10,174,327,0,153
"255",1960-09-11,200,324,0,124
"256",1960-09-12,200,299,0,99
"257",1960-09-13,209,268,0,59
"258",1960-09-14,159,270,0,111
"259",1960-09-15,127,292,0,165
"260",1960-09-16,150,284,0,134
"261",1960-09-17,119,281,0,162
"262",1960-09-18,111,300,0,189
"263",1960-09-19,131,319,0,188
"264",1960-09-20,172,324,0,152
"265",1960-09-21,142,333,0,191
"266",1960-09-22,159,327,0,168
"267",1960-09-23,168,332,0,164
"268",1960-09-24,182,254,0,72
"269",1960-09-25,146,183,56,37
"270",1960-09-26,146,210,2,64
"271",1960-09-27,168,203,9,35
"272",1960-09-28,124,173,195,49
"273",1960-09-29,119,179,42,60
"274",1960-09-30,139,201,0,62
"275",1960-10-01,140,178,0,38
"276",1960-10-02,112,156,12,44
"277",1960-10-03,89,210,11,121
"278",1960-10-04,114,182,0,68
"279",1960-10-05,136,191,5,55
"280",1960-10-06,117,226,0,109
"281",1960-10-07,127,207,0,80
"282",1960-10-08,84,253,0,169
"283",1960-10-09,100,276,0,176
"284",1960-10-10,126,276,0,150
"285",1960-10-11,115,264,0,149
"286",1960-10-12,115,244,0,129
"287",1960-10-13,159,220,8,61
"288",1960-10-14,108,173,32,65
"289",1960-10-15,114,162,86,48
"290",1960-10-16,93,155,0,62
"291",1960-10-17,33,213,0,180
"292",1960-10-18,40,244,0,204
"293",1960-10-19,71,215,0,144
"294",1960-10-20,67,242,0,175
"295",1960-10-21,80,250,0,170
"296",1960-10-22,88,233,0,145
"297",1960-10-23,124,228,0,104
"298",1960-10-24,112,180,14,68
"299",1960-10-25,38,112,79,74
"300",1960-10-26,13,154,0,141
"301",1960-10-27,22,184,0,162
"302",1960-10-28,56,164,0,108
"303",1960-10-29,41,229,0,188
"304",1960-10-30,54,249,0,195
"305",1960-10-31,88,185,0,97
"306",1960-11-01,35,177,0,142
"307",1960-11-02,96,132,0,36
"308",1960-11-03,92,167,6,75
"309",1960-11-04,56,189,0,133
"310",1960-11-05,42,238,0,196
"311",1960-11-06,33,239,0,206
"312",1960-11-07,61,199,0,138
"313",1960-11-08,71,125,4,54
"314",1960-11-09,42,87,3,45
"315",1960-11-10,39,134,2,95
"316",1960-11-11,63,144,0,81
"317",1960-11-12,37,168,0,131
"318",1960-11-13,24,131,0,107
"319",1960-11-14,-8,164,0,172
"320",1960-11-15,64,151,0,87
"321",1960-11-16,66,165,0,99
"322",1960-11-17,20,192,0,172
"323",1960-11-18,75,193,0,118
"324",1960-11-19,15,200,0,185
"325",1960-11-20,73,198,0,125
"326",1960-11-21,86,158,0,72
"327",1960-11-22,15,125,0,110
"328",1960-11-23,-15,16,87,31
"329",1960-11-24,-29,2,21,31
"330",1960-11-25,-27,49,0,76
"331",1960-11-26,-38,9,0,47
"332",1960-11-27,-45,57,0,102
"333",1960-11-28,-32,56,0,88
"334",1960-11-29,-26,109,0,135
"335",1960-11-30,17,110,0,93
"336",1960-12-01,-27,116,0,143
"337",1960-12-02,-28,158,0,186
"338",1960-12-03,-19,86,0,105
"339",1960-12-04,-43,53,0,96
"340",1960-12-05,-40,78,0,118
"341",1960-12-06,-64,83,0,147
"342",1960-12-07,-57,84,0,141
"343",1960-12-08,-6,101,0,107
"344",1960-12-09,18,154,0,136
"345",1960-12-10,-5,193,0,198
"346",1960-12-11,10,149,0,139
"347",1960-12-12,-41,102,0,143
"348",1960-12-13,-40,122,0,162
"349",1960-12-14,-40,73,0,113
"350",1960-12-15,-60,28,0,88
"351",1960-12-16,-19,51,22,70
"352",1960-12-17,-69,23,15,92
"353",1960-12-18,-115,2,0,117
"354",1960-12-19,-89,55,0,144
"355",1960-12-20,-74,51,0,125
"356",1960-12-21,-100,65,0,165
"357",1960-12-22,-83,60,0,143
"358",1960-12-23,-67,76,0,143
"359",1960-12-24,-47,63,0,110
"360",1960-12-25,-85,34,0,119
"361",1960-12-26,-62,42,0,104
"362",1960-12-27,-61,31,0,92
"363",1960-12-28,-53,33,0,86
"364",1960-12-29,-55,23,0,78
"365",1960-12-30,-69,44,0,113
"366",1960-12-31,-80,42,0,122
"367",1961-01-01,-103,69,0,172
"368",1961-01-02,-27,79,0,106
"369",1961-01-03,-34,71,0,105
"370",1961-01-04,-62,23,0,85
"371",1961-01-05,-25,42,0,67
"372",1961-01-06,-32,44,0,76
"373",1961-01-07,-68,97,0,165
"374",1961-01-08,-21,92,0,113
"375",1961-01-09,-33,30,0,63
"376",1961-01-10,-47,1,0,48
"377",1961-01-11,-105,11,0,116
"378",1961-01-12,-70,51,0,121
"379",1961-01-13,-38,63,0,101
"380",1961-01-14,-76,102,0,178
"381",1961-01-15,-47,49,0,96
"382",1961-01-16,-65,56,0,121
"383",1961-01-17,-60,98,0,158
"384",1961-01-18,-72,88,0,160
"385",1961-01-19,-69,81,0,150
"386",1961-01-20,-76,140,0,216
"387",1961-01-21,-63,147,0,210
"388",1961-01-22,-38,93,0,131
"389",1961-01-23,-7,39,26,46
"390",1961-01-24,0,72,0,72
"391",1961-01-25,-35,120,0,155
"392",1961-01-26,-33,107,0,140
"393",1961-01-27,-12,71,0,83
"394",1961-01-28,7,75,0,68
"395",1961-01-29,-5,62,0,67
"396",1961-01-30,-45,69,0,114
"397",1961-01-31,-76,35,0,111
"398",1961-02-01,-35,66,0,101
"399",1961-02-02,6,106,0,100
"400",1961-02-03,-72,132,0,204
"401",1961-02-04,11,64,5,53
"402",1961-02-05,2,42,0,40
"403",1961-02-06,-9,66,0,75
"404",1961-02-07,-36,94,0,130
"405",1961-02-08,-11,89,0,100
"406",1961-02-09,-23,95,0,118
"407",1961-02-10,3,66,0,63
"408",1961-02-11,-10,100,0,110
"409",1961-02-12,-43,118,0,161
"410",1961-02-13,-10,134,0,144
"411",1961-02-14,-22,88,0,110
"412",1961-02-15,-28,129,0,157
"413",1961-02-16,-7,157,0,164
"414",1961-02-17,-35,156,0,191
"415",1961-02-18,-51,157,0,208
"416",1961-02-19,10,187,0,177
"417",1961-02-20,8,129,0,121
"418",1961-02-21,-36,109,0,145
"419",1961-02-22,15,106,0,91
"420",1961-02-23,-20,183,0,203
"421",1961-02-24,35,180,0,145
"422",1961-02-25,-15,124,0,139
"423",1961-02-26,-45,147,0,192
"424",1961-02-27,-5,210,0,215
"425",1961-02-28,62,177,22,115
"426",1961-03-01,74,123,66,49
"427",1961-03-02,42,99,64,57
"428",1961-03-03,9,106,2,97
"429",1961-03-04,47,108,0,61
"430",1961-03-05,24,164,0,140
"431",1961-03-06,20,120,0,100
"432",1961-03-07,30,92,0,62
"433",1961-03-08,7,107,0,100
"434",1961-03-09,10,135,0,125
"435",1961-03-10,32,132,0,100
"436",1961-03-11,43,140,0,97
"437",1961-03-12,71,158,0,87
"438",1961-03-13,70,134,34,64
"439",1961-03-14,19,117,0,98
"440",1961-03-15,73,151,4,78
"441",1961-03-16,33,189,0,156
"442",1961-03-17,85,180,0,95
"443",1961-03-18,39,132,78,93
"444",1961-03-19,33,83,6,50
"445",1961-03-20,34,80,0,46
"446",1961-03-21,-3,134,4,137
"447",1961-03-22,48,154,0,106
"448",1961-03-23,33,166,0,133
"449",1961-03-24,78,175,0,97
"450",1961-03-25,47,166,0,119
"451",1961-03-26,0,203,0,203
"452",1961-03-27,7,183,0,176
"453",1961-03-28,71,234,0,163
"454",1961-03-29,92,244,0,152
"455",1961-03-30,51,246,0,195
"456",1961-03-31,91,257,0,166
"457",1961-04-01,75,267,0,192
"458",1961-04-02,115,288,0,173
"459",1961-04-03,144,284,0,140
"460",1961-04-04,181,252,0,71
"461",1961-04-05,130,254,0,124
"462",1961-04-06,53,249,0,196
"463",1961-04-07,124,270,0,146
"464",1961-04-08,76,210,0,134
"465",1961-04-09,12,194,0,182
"466",1961-04-10,85,213,0,128
"467",1961-04-11,70,260,0,190
"468",1961-04-12,103,271,0,168
"469",1961-04-13,134,247,0,113
"470",1961-04-14,82,198,59,116
"471",1961-04-15,72,176,0,104
"472",1961-04-16,70,251,0,181
"473",1961-04-17,102,260,0,158
"474",1961-04-18,106,275,0,169
"475",1961-04-19,153,269,0,116
"476",1961-04-20,126,259,0,133
"477",1961-04-21,167,229,0,62
"478",1961-04-22,82,237,0,155
"479",1961-04-23,136,254,0,118
"480",1961-04-24,83,199,157,116
"481",1961-04-25,82,177,107,95
"482",1961-04-26,93,234,0,141
"483",1961-04-27,123,272,0,149
"484",1961-04-28,136,309,0,173
"485",1961-04-29,176,321,0,145
"486",1961-04-30,136,236,0,100
"487",1961-05-01,143,279,0,136
"488",1961-05-02,115,328,0,213
"489",1961-05-03,89,270,1,181
"490",1961-05-04,71,284,0,213
"491",1961-05-05,80,324,0,244
"492",1961-05-06,179,334,0,155
"493",1961-05-07,178,289,0,111
"494",1961-05-08,145,326,0,181
"495",1961-05-09,178,283,224,105
"496",1961-05-10,175,268,0,93
"497",1961-05-11,138,226,7,88
"498",1961-05-12,116,293,0,177
"499",1961-05-13,159,329,0,170
"500",1961-05-14,173,319,0,146
"501",1961-05-15,181,253,0,72
"502",1961-05-16,141,274,0,133
"503",1961-05-17,191,238,0,47
"504",1961-05-18,164,279,0,115
"505",1961-05-19,183,315,0,132
"506",1961-05-20,206,276,0,70
"507",1961-05-21,141,242,52,101
"508",1961-05-22,136,251,8,115
"509",1961-05-23,115,320,0,205
"510",1961-05-24,164,349,0,185
"511",1961-05-25,208,346,0,138
"512",1961-05-26,192,334,0,142
"513",1961-05-27,173,286,19,113
"514",1961-05-28,167,312,0,145
"515",1961-05-29,148,340,0,192
"516",1961-05-30,181,348,0,167
"517",1961-05-31,176,347,0,171
"518",1961-06-01,211,339,0,128
"519",1961-06-02,193,298,0,105
"520",1961-06-03,190,294,15,104
"521",1961-06-04,133,330,0,197
"522",1961-06-05,229,345,0,116
"523",1961-06-06,208,354,0,146
"524",1961-06-07,265,365,0,100
"525",1961-06-08,264,327,0,63
"526",1961-06-09,217,352,0,135
"527",1961-06-10,222,373,0,151
"528",1961-06-11,235,370,0,135
"529",1961-06-12,244,379,0,135
"530",1961-06-13,245,334,0,89
"531",1961-06-14,207,301,0,94
"532",1961-06-15,224,320,0,96
"533",1961-06-16,213,307,69,94
"534",1961-06-17,189,244,39,55
"535",1961-06-18,183,205,15,22
"536",1961-06-19,185,312,0,127
"537",1961-06-20,236,331,1,95
"538",1961-06-21,211,307,37,96
"539",1961-06-22,208,264,301,56
"540",1961-06-23,191,247,625,56
"541",1961-06-24,203,304,0,101
"542",1961-06-25,234,300,0,66
"543",1961-06-26,209,259,103,50
"544",1961-06-27,210,267,9,57
"545",1961-06-28,225,262,37,37
"546",1961-06-29,224,290,2,66
"547",1961-06-30,225,283,0,58
"548",1961-07-01,237,315,0,78
"549",1961-07-02,229,310,15,81
"550",1961-07-03,254,330,0,76
"551",1961-07-04,261,342,17,81
"552",1961-07-05,250,356,0,106
"553",1961-07-06,262,380,0,118
"554",1961-07-07,251,342,0,91
"555",1961-07-08,207,327,0,120
"556",1961-07-09,204,287,0,83
"557",1961-07-10,238,326,0,88
"558",1961-07-11,257,363,0,106
"559",1961-07-12,278,378,0,100
"560",1961-07-13,217,340,416,123
"561",1961-07-14,240,294,3,54
"562",1961-07-15,233,339,0,106
"563",1961-07-16,244,340,6,96
"564",1961-07-17,238,317,27,79
"565",1961-07-18,250,355,19,105
"566",1961-07-19,253,353,0,100
"567",1961-07-20,268,371,0,103
"568",1961-07-21,250,375,0,125
"569",1961-07-22,257,352,0,95
"570",1961-07-23,272,386,0,114
"571",1961-07-24,265,383,0,118
"572",1961-07-25,256,394,0,138
"573",1961-07-26,231,395,0,164
"574",1961-07-27,245,373,0,128
"575",1961-07-28,251,360,0,109
"576",1961-07-29,222,354,0,132
"577",1961-07-30,236,333,257,97
"578",1961-07-31,236,324,91,88
"579",1961-08-01,253,329,132,76
"580",1961-08-02,262,299,0,37
"581",1961-08-03,247,319,2,72
"582",1961-08-04,236,334,0,98
"583",1961-08-05,242,344,0,102
"584",1961-08-06,246,342,7,96
"585",1961-08-07,238,334,4,96
"586",1961-08-08,245,340,0,95
"587",1961-08-09,246,319,0,73
"588",1961-08-10,238,358,2,120
"589",1961-08-11,247,332,6,85
"590",1961-08-12,215,354,0,139
"591",1961-08-13,256,319,23,63
"592",1961-08-14,229,299,234,70
"593",1961-08-15,215,290,0,75
"594",1961-08-16,217,303,0,86
"595",1961-08-17,235,291,13,56
"596",1961-08-18,228,279,0,51
"597",1961-08-19,193,311,0,118
"598",1961-08-20,215,321,0,106
"599",1961-08-21,236,359,0,123
"600",1961-08-22,256,379,0,123
"601",1961-08-23,260,326,0,66
"602",1961-08-24,203,324,0,121
"603",1961-08-25,199,315,0,116
"604",1961-08-26,177,314,0,137
"605",1961-08-27,174,315,0,141
"606",1961-08-28,169,306,0,137
"607",1961-08-29,192,270,37,78
"608",1961-08-30,184,287,0,103
"609",1961-08-31,216,307,2,91
"610",1961-09-01,184,311,0,127
"611",1961-09-02,193,274,16,81
"612",1961-09-03,201,259,95,58
"613",1961-09-04,184,281,0,97
"614",1961-09-05,165,299,0,134
"615",1961-09-06,187,299,0,112
"616",1961-09-07,181,323,13,142
"617",1961-09-08,188,281,16,93
"618",1961-09-09,143,285,0,142
"619",1961-09-10,136,282,0,146
"620",1961-09-11,141,266,2,125
"621",1961-09-12,179,230,230,51
"622",1961-09-13,188,244,0,56
"623",1961-09-14,158,256,0,98
"624",1961-09-15,156,274,0,118
"625",1961-09-16,149,277,0,128
"626",1961-09-17,128,267,0,139
"627",1961-09-18,140,243,0,103
"628",1961-09-19,152,214,237,62
"629",1961-09-20,147,211,52,64
"630",1961-09-21,162,214,0,52
"631",1961-09-22,127,267,0,140
"632",1961-09-23,118,298,0,180
"633",1961-09-24,156,264,2,108
"634",1961-09-25,151,289,0,138
"635",1961-09-26,188,277,0,89
"636",1961-09-27,194,241,151,47
"637",1961-09-28,171,212,750,41
"638",1961-09-29,151,190,0,39
"639",1961-09-30,109,183,0,74
"640",1961-10-01,111,163,30,52
"641",1961-10-02,133,158,3,25
"642",1961-10-03,140,179,0,39
"643",1961-10-04,146,224,0,78
"644",1961-10-05,122,259,0,137
"645",1961-10-06,125,291,0,166
"646",1961-10-07,169,287,0,118
"647",1961-10-08,135,281,0,146
"648",1961-10-09,120,280,0,160
"649",1961-10-10,142,234,0,92
"650",1961-10-11,133,193,70,60
"651",1961-10-12,120,152,2,32
"652",1961-10-13,118,182,0,64
"653",1961-10-14,106,211,0,105
"654",1961-10-15,124,222,0,98
"655",1961-10-16,148,176,66,28
"656",1961-10-17,140,152,368,12
"657",1961-10-18,130,144,169,14
"658",1961-10-19,119,139,2,20
"659",1961-10-20,63,177,0,114
"660",1961-10-21,107,164,55,57
"661",1961-10-22,94,159,0,65
"662",1961-10-23,66,129,0,63
"663",1961-10-24,77,133,0,56
"664",1961-10-25,75,180,1,105
"665",1961-10-26,70,200,0,130
"666",1961-10-27,104,209,0,105
"667",1961-10-28,91,163,7,72
"668",1961-10-29,59,145,0,86
"669",1961-10-30,98,129,14,31
"670",1961-10-31,71,129,0,58
"671",1961-11-01,101,116,99,15
"672",1961-11-02,100,116,27,16
"673",1961-11-03,82,172,0,90
"674",1961-11-04,57,165,0,108
"675",1961-11-05,27,188,0,161
"676",1961-11-06,39,231,0,192
"677",1961-11-07,107,167,0,60
"678",1961-11-08,95,158,0,63
"679",1961-11-09,43,161,0,118
"680",1961-11-10,56,178,0,122
"681",1961-11-11,26,145,0,119
"682",1961-11-12,61,112,2,51
"683",1961-11-13,84,110,4,26
"684",1961-11-14,87,139,0,52
"685",1961-11-15,110,153,1,43
"686",1961-11-16,116,134,1,18
"687",1961-11-17,108,135,21,27
"688",1961-11-18,107,131,0,24
"689",1961-11-19,58,110,115,52
"690",1961-11-20,51,76,102,25
"691",1961-11-21,7,136,0,129
"692",1961-11-22,26,71,0,45
"693",1961-11-23,1,86,0,85
"694",1961-11-24,-11,117,0,128
"695",1961-11-25,15,142,0,127
"696",1961-11-26,54,82,40,28
"697",1961-11-27,47,140,0,93
"698",1961-11-28,58,143,0,85
"699",1961-11-29,51,105,0,54
"700",1961-11-30,18,128,0,110
"701",1961-12-01,1,146,0,145
"702",1961-12-02,2,111,1,109
"703",1961-12-03,-28,63,0,91
"704",1961-12-04,-37,104,0,141
"705",1961-12-05,0,80,0,80
"706",1961-12-06,-35,95,0,130
"707",1961-12-07,-25,135,0,160
"708",1961-12-08,-17,158,0,175
"709",1961-12-09,-8,151,0,159
"710",1961-12-10,-24,168,0,192
"711",1961-12-11,-13,199,0,212
"712",1961-12-12,2,132,0,130
"713",1961-12-13,-38,35,0,73
"714",1961-12-14,-60,27,0,87
"715",1961-12-15,-19,62,2,81
"716",1961-12-16,-7,27,0,34
"717",1961-12-17,7,53,0,46
"718",1961-12-18,-10,33,4,43
"719",1961-12-19,-21,55,0,76
"720",1961-12-20,13,100,0,87
"721",1961-12-21,-50,102,0,152
"722",1961-12-22,-44,120,0,164
"723",1961-12-23,-26,132,0,158
"724",1961-12-24,-20,56,0,76
"725",1961-12-25,-15,22,0,37
"726",1961-12-26,-21,10,6,31
"727",1961-12-27,-19,9,0,28
"728",1961-12-28,-66,29,0,95
"729",1961-12-29,-78,12,0,90
"730",1961-12-30,-76,5,0,81
"731",1961-12-31,-38,11,0,49
"732",1962-01-01,-68,23,0,91
"733",1962-01-02,-38,66,0,104
"734",1962-01-03,-63,97,0,160
"735",1962-01-04,-27,63,0,90
"736",1962-01-05,-88,47,0,135
"737",1962-01-06,-65,70,0,135
"738",1962-01-07,-53,62,0,115
"739",1962-01-08,-18,91,0,109
"740",1962-01-09,-62,56,0,118
"741",1962-01-10,-37,113,0,150
"742",1962-01-11,-52,39,0,91
"743",1962-01-12,-27,54,0,81
"744",1962-01-13,-53,49,0,102
"745",1962-01-14,-12,18,19,30
"746",1962-01-15,-40,29,0,69
"747",1962-01-16,-33,50,0,83
"748",1962-01-17,-25,75,0,100
"749",1962-01-18,-40,70,0,110
"750",1962-01-19,-75,53,0,128
"751",1962-01-20,-78,83,0,161
"752",1962-01-21,-45,84,0,129
"753",1962-01-22,-45,60,0,105
"754",1962-01-23,-71,48,0,119
"755",1962-01-24,-77,58,0,135
"756",1962-01-25,-55,66,0,121
"757",1962-01-26,-15,80,0,95
"758",1962-01-27,-85,78,0,163
"759",1962-01-28,-40,107,0,147
"760",1962-01-29,-30,56,0,86
"761",1962-01-30,-85,16,0,101
"762",1962-01-31,-99,37,0,136
"763",1962-02-01,-65,76,0,141
"764",1962-02-02,-67,109,0,176
"765",1962-02-03,-63,117,0,180
"766",1962-02-04,-47,161,0,208
"767",1962-02-05,-10,92,0,102
"768",1962-02-06,-31,95,0,126
"769",1962-02-07,-27,33,0,60
"770",1962-02-08,7,68,0,61
"771",1962-02-09,11,50,21,39
"772",1962-02-10,15,134,122,119
"773",1962-02-11,37,78,0,41
"774",1962-02-12,-6,70,0,76
"775",1962-02-13,-5,79,0,84
"776",1962-02-14,10,108,0,98
"777",1962-02-15,-36,92,0,128
"778",1962-02-16,-10,151,0,161
"779",1962-02-17,12,146,0,134
"780",1962-02-18,-16,165,0,181
"781",1962-02-19,-45,142,0,187
"782",1962-02-20,-28,216,0,244
"783",1962-02-21,25,129,0,104
"784",1962-02-22,-2,117,0,119
"785",1962-02-23,-3,56,0,59
"786",1962-02-24,-20,32,5,52
"787",1962-02-25,-29,25,31,54
"788",1962-02-26,-13,23,0,36
"789",1962-02-27,-32,102,0,134
"790",1962-02-28,-20,145,0,165
"791",1962-03-01,-35,109,0,144
"792",1962-03-02,-48,149,0,197
"793",1962-03-03,-18,185,0,203
"794",1962-03-04,84,148,0,64
"795",1962-03-05,3,205,0,202
"796",1962-03-06,27,134,0,107
"797",1962-03-07,-46,122,0,168
"798",1962-03-08,34,181,0,147
"799",1962-03-09,34,145,0,111
"800",1962-03-10,10,167,0,157
"801",1962-03-11,47,194,0,147
"802",1962-03-12,59,249,0,190
"803",1962-03-13,37,275,0,238
"804",1962-03-14,105,246,0,141
"805",1962-03-15,32,182,0,150
"806",1962-03-16,5,122,0,117
"807",1962-03-17,-27,179,0,206
"808",1962-03-18,47,167,0,120
"809",1962-03-19,41,117,0,76
"810",1962-03-20,25,124,0,99
"811",1962-03-21,13,104,0,91
"812",1962-03-22,-20,111,0,131
"813",1962-03-23,26,136,0,110
"814",1962-03-24,29,159,0,130
"815",1962-03-25,51,117,0,66
"816",1962-03-26,-43,168,0,211
"817",1962-03-27,6,249,0,243
"818",1962-03-28,29,156,0,127
"819",1962-03-29,-38,136,0,174
"820",1962-03-30,10,200,0,190
"821",1962-03-31,66,245,0,179
"822",1962-04-01,105,217,20,112
"823",1962-04-02,22,105,0,83
"824",1962-04-03,-11,137,0,148
"825",1962-04-04,22,188,0,166
"826",1962-04-05,75,181,0,106
"827",1962-04-06,23,198,0,175
"828",1962-04-07,101,213,13,112
"829",1962-04-08,104,174,12,70
"830",1962-04-09,115,168,2,53
"831",1962-04-10,44,202,0,158
"832",1962-04-11,96,206,0,110
"833",1962-04-12,64,178,0,114
"834",1962-04-13,5,187,0,182
"835",1962-04-14,84,253,0,169
"836",1962-04-15,75,294,0,219
"837",1962-04-16,158,264,0,106
"838",1962-04-17,75,173,0,98
"839",1962-04-18,-5,231,0,236
"840",1962-04-19,66,270,0,204
"841",1962-04-20,106,305,0,199
"842",1962-04-21,99,304,0,205
"843",1962-04-22,175,309,0,134
"844",1962-04-23,129,222,3,93
"845",1962-04-24,98,182,0,84
"846",1962-04-25,62,250,0,188
"847",1962-04-26,139,265,34,126
"848",1962-04-27,86,213,4,127
"849",1962-04-28,95,188,16,93
"850",1962-04-29,100,200,8,100
"851",1962-04-30,106,263,0,157
"852",1962-05-01,136,226,0,90
"853",1962-05-02,163,275,26,112
"854",1962-05-03,139,222,1,83
"855",1962-05-04,110,217,12,107
"856",1962-05-05,63,254,0,191
"857",1962-05-06,98,241,0,143
"858",1962-05-07,83,283,0,200
"859",1962-05-08,168,252,0,84
"860",1962-05-09,144,279,0,135
"861",1962-05-10,139,299,0,160
"862",1962-05-11,138,333,0,195
"863",1962-05-12,95,293,0,198
"864",1962-05-13,175,236,41,61
"865",1962-05-14,137,339,0,202
"866",1962-05-15,171,319,0,148
"867",1962-05-16,86,270,0,184
"868",1962-05-17,145,263,0,118
"869",1962-05-18,91,307,0,216
"870",1962-05-19,132,341,0,209
"871",1962-05-20,135,373,0,238
"872",1962-05-21,203,357,0,154
"873",1962-05-22,178,357,0,179
"874",1962-05-23,224,314,0,90
"875",1962-05-24,196,337,0,141
"876",1962-05-25,175,306,0,131
"877",1962-05-26,201,332,0,131
"878",1962-05-27,178,278,0,100
"879",1962-05-28,167,310,8,143
"880",1962-05-29,107,321,0,214
"881",1962-05-30,129,338,0,209
"882",1962-05-31,226,316,0,90
"883",1962-06-01,231,320,0,89
"884",1962-06-02,188,334,0,146
"885",1962-06-03,201,305,2,104
"886",1962-06-04,180,357,0,177
"887",1962-06-05,197,337,0,140
"888",1962-06-06,177,368,0,191
"889",1962-06-07,124,324,0,200
"890",1962-06-08,171,312,0,141
"891",1962-06-09,122,336,0,214
"892",1962-06-10,206,350,0,144
"893",1962-06-11,208,349,0,141
"894",1962-06-12,206,336,0,130
"895",1962-06-13,215,300,0,85
"896",1962-06-14,174,304,0,130
"897",1962-06-15,128,299,0,171
"898",1962-06-16,164,309,0,145
"899",1962-06-17,174,280,78,106
"900",1962-06-18,187,255,98,68
"901",1962-06-19,193,216,64,23
"902",1962-06-20,158,335,0,177
"903",1962-06-21,210,346,0,136
"904",1962-06-22,214,334,0,120
"905",1962-06-23,213,301,51,88
"906",1962-06-24,189,309,225,120
"907",1962-06-25,192,270,0,78
"908",1962-06-26,191,287,14,96
"909",1962-06-27,201,273,7,72
"910",1962-06-28,202,289,4,87
"911",1962-06-29,191,308,0,117
"912",1962-06-30,209,326,0,117
"913",1962-07-01,223,329,0,106
"914",1962-07-02,207,324,0,117
"915",1962-07-03,245,346,0,101
"916",1962-07-04,252,351,0,99
"917",1962-07-05,242,344,0,102
"918",1962-07-06,193,352,0,159
"919",1962-07-07,242,327,5,85
"920",1962-07-08,208,266,107,58
"921",1962-07-09,216,355,0,139
"922",1962-07-10,240,388,0,148
"923",1962-07-11,246,365,0,119
"924",1962-07-12,251,337,9,86
"925",1962-07-13,280,389,0,109
"926",1962-07-14,252,345,0,93
"927",1962-07-15,274,338,0,64
"928",1962-07-16,248,339,0,91
"929",1962-07-17,256,356,0,100
"930",1962-07-18,252,381,8,129
"931",1962-07-19,222,316,599,94
"932",1962-07-20,226,366,0,140
"933",1962-07-21,225,369,0,144
"934",1962-07-22,225,321,0,96
"935",1962-07-23,218,312,0,94
"936",1962-07-24,234,314,77,80
"937",1962-07-25,232,310,103,78
"938",1962-07-26,228,311,0,83
"939",1962-07-27,252,299,20,47
"940",1962-07-28,237,321,0,84
"941",1962-07-29,250,359,1,109
"942",1962-07-30,232,358,0,126
"943",1962-07-31,238,306,0,68
"944",1962-08-01,227,304,0,77
"945",1962-08-02,233,317,0,84
"946",1962-08-03,221,354,0,133
"947",1962-08-04,223,349,275,126
"948",1962-08-05,233,292,531,59
"949",1962-08-06,234,305,0,71
"950",1962-08-07,252,324,1,72
"951",1962-08-08,234,314,146,80
"952",1962-08-09,219,311,0,92
"953",1962-08-10,213,306,0,93
"954",1962-08-11,241,314,0,73
"955",1962-08-12,258,331,0,73
"956",1962-08-13,252,355,0,103
"957",1962-08-14,245,320,193,75
"958",1962-08-15,187,254,727,67
"959",1962-08-16,187,234,54,47
"960",1962-08-17,188,217,188,29
"961",1962-08-18,189,220,2,31
"962",1962-08-19,164,284,0,120
"963",1962-08-20,188,306,0,118
"964",1962-08-21,207,336,0,129
"965",1962-08-22,232,329,78,97
"966",1962-08-23,213,328,0,115
"967",1962-08-24,223,304,71,81
"968",1962-08-25,225,290,0,65
"969",1962-08-26,193,263,173,70
"970",1962-08-27,194,319,0,125
"971",1962-08-28,213,305,1,92
"972",1962-08-29,209,314,0,105
"973",1962-08-30,209,269,0,60
"974",1962-08-31,151,304,0,153
"975",1962-09-01,189,296,0,107
"976",1962-09-02,167,309,1,142
"977",1962-09-03,194,304,0,110
"978",1962-09-04,199,306,0,107
"979",1962-09-05,175,298,0,123
"980",1962-09-06,175,294,0,119
"981",1962-09-07,170,307,0,137
"982",1962-09-08,166,334,0,168
"983",1962-09-09,181,334,0,153
"984",1962-09-10,176,337,0,161
"985",1962-09-11,195,269,69,74
"986",1962-09-12,165,282,0,117
"987",1962-09-13,171,304,0,133
"988",1962-09-14,173,288,0,115
"989",1962-09-15,174,229,252,55
"990",1962-09-16,169,285,0,116
"991",1962-09-17,177,316,0,139
"992",1962-09-18,181,264,0,83
"993",1962-09-19,185,308,0,123
"994",1962-09-20,149,334,0,185
"995",1962-09-21,184,293,0,109
"996",1962-09-22,205,314,0,109
"997",1962-09-23,169,206,243,37
"998",1962-09-24,139,170,28,31
"999",1962-09-25,119,143,14,24
"1000",1962-09-26,109,151,7,42
"1001",1962-09-27,125,235,18,110
"1002",1962-09-28,138,192,5,54
"1003",1962-09-29,121,142,141,21
"1004",1962-09-30,114,179,85,65
"1005",1962-10-01,149,203,0,54
"1006",1962-10-02,158,238,0,80
"1007",1962-10-03,145,202,0,57
"1008",1962-10-04,118,219,11,101
"1009",1962-10-05,128,217,0,89
"1010",1962-10-06,154,245,0,91
"1011",1962-10-07,156,196,1,40
"1012",1962-10-08,130,168,60,38
"1013",1962-10-09,143,158,272,15
"1014",1962-10-10,148,226,54,78
"1015",1962-10-11,127,246,0,119
"1016",1962-10-12,125,274,1,149
"1017",1962-10-13,93,177,0,84
"1018",1962-10-14,18,149,0,131
"1019",1962-10-15,45,167,0,122
"1020",1962-10-16,84,198,0,114
"1021",1962-10-17,32,195,0,163
"1022",1962-10-18,60,198,0,138
"1023",1962-10-19,118,159,74,41
"1024",1962-10-20,125,176,12,51
"1025",1962-10-21,87,208,2,121
"1026",1962-10-22,98,243,2,145
"1027",1962-10-23,71,231,0,160
"1028",1962-10-24,68,181,0,113
"1029",1962-10-25,57,224,0,167
"1030",1962-10-26,48,181,0,133
"1031",1962-10-27,43,188,0,145
"1032",1962-10-28,67,201,6,134
"1033",1962-10-29,78,176,0,98
"1034",1962-10-30,66,214,0,148
"1035",1962-10-31,93,192,1,99
"1036",1962-11-01,114,129,190,15
"1037",1962-11-02,88,153,50,65
"1038",1962-11-03,63,114,70,51
"1039",1962-11-04,21,113,0,92
"1040",1962-11-05,15,149,0,134
"1041",1962-11-06,56,188,0,132
"1042",1962-11-07,48,148,0,100
"1043",1962-11-08,83,187,1,104
"1044",1962-11-09,59,149,0,90
"1045",1962-11-10,26,220,0,194
"1046",1962-11-11,45,226,0,181
"1047",1962-11-12,37,220,0,183
"1048",1962-11-13,74,126,0,52
"1049",1962-11-14,80,171,0,91
"1050",1962-11-15,80,130,0,50
"1051",1962-11-16,54,80,50,26
"1052",1962-11-17,62,88,6,26
"1053",1962-11-18,43,79,177,36
"1054",1962-11-19,12,51,165,39
"1055",1962-11-20,10,41,0,31
"1056",1962-11-21,-19,10,92,29
"1057",1962-11-22,-52,16,0,68
"1058",1962-11-23,-3,45,0,48
"1059",1962-11-24,8,35,20,27
"1060",1962-11-25,0,12,19,12
"1061",1962-11-26,3,43,0,40
"1062",1962-11-27,2,75,0,73
"1063",1962-11-28,-6,50,0,56
"1064",1962-11-29,-20,54,0,74
"1065",1962-11-30,-7,45,0,52
"1066",1962-12-01,12,85,0,73
"1067",1962-12-02,0,109,0,109
"1068",1962-12-03,-33,124,0,157
"1069",1962-12-04,0,99,0,99
"1070",1962-12-05,-45,109,0,154
"1071",1962-12-06,-16,109,0,125
"1072",1962-12-07,-28,107,0,135
"1073",1962-12-08,-18,140,0,158
"1074",1962-12-09,-21,155,0,176
"1075",1962-12-10,-1,97,0,98
"1076",1962-12-11,5,38,47,33
"1077",1962-12-12,5,33,21,28
"1078",1962-12-13,31,105,0,74
"1079",1962-12-14,-4,76,0,80
"1080",1962-12-15,-52,61,0,113
"1081",1962-12-16,-37,87,0,124
"1082",1962-12-17,-26,107,0,133
"1083",1962-12-18,-22,99,0,121
"1084",1962-12-19,23,103,0,80
"1085",1962-12-20,-45,108,0,153
"1086",1962-12-21,-31,101,0,132
"1087",1962-12-22,18,132,0,114
"1088",1962-12-23,20,165,0,145
"1089",1962-12-24,6,193,0,187
"1090",1962-12-25,-28,105,0,133
"1091",1962-12-26,-21,71,0,92
"1092",1962-12-27,-30,46,0,76
"1093",1962-12-28,23,63,3,40
"1094",1962-12-29,-15,51,0,66
"1095",1962-12-30,-77,78,0,155
"1096",1962-12-31,-52,19,0,71
"1097",1963-01-01,-51,78,0,129
"1098",1963-01-02,-5,117,0,122
"1099",1963-01-03,23,127,0,104
"1100",1963-01-04,17,73,0,56
"1101",1963-01-05,-32,61,0,93
"1102",1963-01-06,-98,22,0,120
"1103",1963-01-07,-98,54,0,152
"1104",1963-01-08,-89,48,0,137
"1105",1963-01-09,-96,90,0,186
"1106",1963-01-10,-63,11,0,74
"1107",1963-01-11,-103,36,0,139
"1108",1963-01-12,-84,58,0,142
"1109",1963-01-13,-48,63,0,111
"1110",1963-01-14,-32,83,0,115
"1111",1963-01-15,-38,47,0,85
"1112",1963-01-16,-68,101,0,169
"1113",1963-01-17,-18,129,0,147
"1114",1963-01-18,-26,113,0,139
"1115",1963-01-19,-60,71,0,131
"1116",1963-01-20,-36,5,0,41
"1117",1963-01-21,-69,28,0,97
"1118",1963-01-22,-42,58,0,100
"1119",1963-01-23,-72,61,0,133
"1120",1963-01-24,-55,51,0,106
"1121",1963-01-25,-62,61,0,123
"1122",1963-01-26,-37,73,0,110
"1123",1963-01-27,-20,132,0,152
"1124",1963-01-28,-48,90,0,138
"1125",1963-01-29,-27,67,0,94
"1126",1963-01-30,-53,38,0,91
"1127",1963-01-31,-85,56,0,141
"1128",1963-02-01,-94,61,0,155
"1129",1963-02-02,-60,44,0,104
"1130",1963-02-03,-102,45,0,147
"1131",1963-02-04,-97,70,0,167
"1132",1963-02-05,-55,66,0,121
"1133",1963-02-06,-64,59,0,123
"1134",1963-02-07,-27,73,0,100
"1135",1963-02-08,-67,60,0,127
"1136",1963-02-09,-82,95,0,177
"1137",1963-02-10,-37,106,0,143
"1138",1963-02-11,-50,67,0,117
"1139",1963-02-12,-78,83,0,161
"1140",1963-02-13,-48,96,0,144
"1141",1963-02-14,3,103,0,100
"1142",1963-02-15,-51,102,0,153
"1143",1963-02-16,-20,38,0,58
"1144",1963-02-17,-20,51,0,71
"1145",1963-02-18,-64,103,0,167
"1146",1963-02-19,29,107,0,78
"1147",1963-02-20,-26,100,0,126
"1148",1963-02-21,-16,137,0,153
"1149",1963-02-22,-37,153,0,190
"1150",1963-02-23,58,184,0,126
"1151",1963-02-24,-39,137,0,176
"1152",1963-02-25,22,102,0,80
"1153",1963-02-26,-17,71,0,88
"1154",1963-02-27,-54,172,0,226
"1155",1963-02-28,-17,239,0,256
"1156",1963-03-01,-12,262,0,274
"1157",1963-03-02,24,246,2,222
"1158",1963-03-03,16,149,0,133
"1159",1963-03-04,-13,65,48,78
"1160",1963-03-05,-17,88,0,105
"1161",1963-03-06,17,79,15,62
"1162",1963-03-07,7,38,72,31
"1163",1963-03-08,2,27,139,25
"1164",1963-03-09,-10,24,28,34
"1165",1963-03-10,-17,33,0,50
"1166",1963-03-11,-20,88,0,108
"1167",1963-03-12,-10,102,0,112
"1168",1963-03-13,17,97,0,80
"1169",1963-03-14,25,127,0,102
"1170",1963-03-15,15,157,0,142
"1171",1963-03-16,8,193,0,185
"1172",1963-03-17,31,214,0,183
"1173",1963-03-18,104,213,0,109
"1174",1963-03-19,48,249,0,201
"1175",1963-03-20,97,280,0,183
"1176",1963-03-21,100,200,0,100
"1177",1963-03-22,45,141,0,96
"1178",1963-03-23,30,112,0,82
"1179",1963-03-24,-13,133,0,146
"1180",1963-03-25,-3,170,0,173
"1181",1963-03-26,19,147,7,128
"1182",1963-03-27,80,122,51,42
"1183",1963-03-28,52,155,0,103
"1184",1963-03-29,29,231,0,202
"1185",1963-03-30,67,318,0,251
"1186",1963-03-31,77,301,0,224
"1187",1963-04-01,76,158,0,82
"1188",1963-04-02,81,121,0,40
"1189",1963-04-03,85,112,0,27
"1190",1963-04-04,81,119,31,38
"1191",1963-04-05,61,100,18,39
"1192",1963-04-06,25,102,129,77
"1193",1963-04-07,33,94,0,61
"1194",1963-04-08,37,168,0,131
"1195",1963-04-09,23,209,0,186
"1196",1963-04-10,70,256,0,186
"1197",1963-04-11,111,244,0,133
"1198",1963-04-12,69,266,0,197
"1199",1963-04-13,110,221,0,111
"1200",1963-04-14,108,160,24,52
"1201",1963-04-15,104,125,303,21
"1202",1963-04-16,119,181,6,62
"1203",1963-04-17,112,158,1,46
"1204",1963-04-18,94,147,0,53
"1205",1963-04-19,94,126,0,32
"1206",1963-04-20,88,161,0,73
"1207",1963-04-21,97,139,17,42
"1208",1963-04-22,89,159,14,70
"1209",1963-04-23,97,202,0,105
"1210",1963-04-24,78,225,0,147
"1211",1963-04-25,124,226,0,102
"1212",1963-04-26,118,182,4,64
"1213",1963-04-27,118,248,0,130
"1214",1963-04-28,132,226,0,94
"1215",1963-04-29,116,158,12,42
"1216",1963-04-30,107,159,3,52
"1217",1963-05-01,77,206,0,129
"1218",1963-05-02,111,200,0,89
"1219",1963-05-03,112,228,6,116
"1220",1963-05-04,134,247,0,113
"1221",1963-05-05,121,206,19,85
"1222",1963-05-06,80,262,0,182
"1223",1963-05-07,162,280,0,118
"1224",1963-05-08,172,235,0,63
"1225",1963-05-09,99,252,0,153
"1226",1963-05-10,113,275,0,162
"1227",1963-05-11,154,260,0,106
"1228",1963-05-12,147,239,0,92
"1229",1963-05-13,157,204,215,47
"1230",1963-05-14,158,210,18,52
"1231",1963-05-15,101,234,0,133
"1232",1963-05-16,152,254,2,102
"1233",1963-05-17,165,296,0,131
"1234",1963-05-18,208,302,4,94
"1235",1963-05-19,186,247,38,61
"1236",1963-05-20,172,261,15,89
"1237",1963-05-21,189,301,0,112
"1238",1963-05-22,118,261,264,143
"1239",1963-05-23,97,133,91,36
"1240",1963-05-24,118,149,42,31
"1241",1963-05-25,126,149,421,23
"1242",1963-05-26,112,229,277,117
"1243",1963-05-27,136,276,0,140
"1244",1963-05-28,177,212,91,35
"1245",1963-05-29,172,246,4,74
"1246",1963-05-30,160,338,1,178
"1247",1963-05-31,207,264,0,57
"1248",1963-06-01,157,271,0,114
"1249",1963-06-02,191,301,4,110
"1250",1963-06-03,193,271,47,78
"1251",1963-06-04,187,276,168,89
"1252",1963-06-05,183,306,0,123
"1253",1963-06-06,218,311,0,93
"1254",1963-06-07,203,277,537,74
"1255",1963-06-08,166,270,65,104
"1256",1963-06-09,164,304,0,140
"1257",1963-06-10,152,354,0,202
"1258",1963-06-11,172,346,0,174
"1259",1963-06-12,213,329,0,116
"1260",1963-06-13,186,344,0,158
"1261",1963-06-14,215,324,0,109
"1262",1963-06-15,201,334,17,133
"1263",1963-06-16,187,307,0,120
"1264",1963-06-17,185,304,0,119
"1265",1963-06-18,211,334,0,123
"1266",1963-06-19,216,346,0,130
"1267",1963-06-20,218,365,0,147
"1268",1963-06-21,249,342,0,93
"1269",1963-06-22,214,335,3,121
"1270",1963-06-23,197,326,0,129
"1271",1963-06-24,227,358,0,131
"1272",1963-06-25,211,360,0,149
"1273",1963-06-26,239,359,0,120
"1274",1963-06-27,247,348,0,101
"1275",1963-06-28,183,304,464,121
"1276",1963-06-29,200,316,0,116
"1277",1963-06-30,227,341,0,114
"1278",1963-07-01,242,353,22,111
"1279",1963-07-02,243,291,32,48
"1280",1963-07-03,217,288,34,71
"1281",1963-07-04,195,317,0,122
"1282",1963-07-05,209,326,2,117
"1283",1963-07-06,182,285,144,103
"1284",1963-07-07,182,279,6,97
"1285",1963-07-08,211,314,0,103
"1286",1963-07-09,206,266,14,60
"1287",1963-07-10,200,277,0,77
"1288",1963-07-11,203,240,37,37
"1289",1963-07-12,176,315,0,139
"1290",1963-07-13,217,341,0,124
"1291",1963-07-14,265,380,0,115
"1292",1963-07-15,281,338,0,57
"1293",1963-07-16,247,386,0,139
"1294",1963-07-17,229,369,0,140
"1295",1963-07-18,244,355,0,111
"1296",1963-07-19,235,328,0,93
"1297",1963-07-20,229,341,0,112
"1298",1963-07-21,244,359,1,115
"1299",1963-07-22,268,354,0,86
"1300",1963-07-23,288,395,0,107
"1301",1963-07-24,290,392,0,102
"1302",1963-07-25,256,346,33,90
"1303",1963-07-26,248,329,0,81
"1304",1963-07-27,252,355,17,103
"1305",1963-07-28,257,329,0,72
"1306",1963-07-29,234,321,0,87
"1307",1963-07-30,179,326,0,147
"1308",1963-07-31,222,322,0,100
"1309",1963-08-01,234,320,26,86
"1310",1963-08-02,231,261,129,30
"1311",1963-08-03,232,315,231,83
"1312",1963-08-04,248,330,0,82
"1313",1963-08-05,234,324,0,90
"1314",1963-08-06,238,296,0,58
"1315",1963-08-07,242,295,143,53
"1316",1963-08-08,221,264,740,43
"1317",1963-08-09,228,282,10,54
"1318",1963-08-10,235,278,59,43
"1319",1963-08-11,227,298,0,71
"1320",1963-08-12,217,329,0,112
"1321",1963-08-13,233,341,0,108
"1322",1963-08-14,233,336,0,103
"1323",1963-08-15,252,286,0,34
"1324",1963-08-16,233,284,1,51
"1325",1963-08-17,212,328,0,116
"1326",1963-08-18,213,306,0,93
"1327",1963-08-19,238,331,0,93
"1328",1963-08-20,238,315,0,77
"1329",1963-08-21,200,277,784,77
"1330",1963-08-22,186,261,1,75
"1331",1963-08-23,205,241,35,36
"1332",1963-08-24,203,254,87,51
"1333",1963-08-25,205,291,0,86
"1334",1963-08-26,227,298,0,71
"1335",1963-08-27,231,337,0,106
"1336",1963-08-28,239,337,188,98
"1337",1963-08-29,246,311,2,65
"1338",1963-08-30,231,289,120,58
"1339",1963-08-31,227,295,133,68
"1340",1963-09-01,216,244,57,28
"1341",1963-09-02,191,306,0,115
"1342",1963-09-03,189,278,0,89
"1343",1963-09-04,202,264,0,62
"1344",1963-09-05,193,277,0,84
"1345",1963-09-06,194,271,0,77
"1346",1963-09-07,187,223,0,36
"1347",1963-09-08,184,266,1,82
"1348",1963-09-09,201,286,0,85
"1349",1963-09-10,200,281,0,81
"1350",1963-09-11,220,263,2,43
"1351",1963-09-12,210,274,0,64
"1352",1963-09-13,186,280,0,94
"1353",1963-09-14,177,304,0,127
"1354",1963-09-15,204,252,0,48
"1355",1963-09-16,191,226,1,35
"1356",1963-09-17,155,193,54,38
"1357",1963-09-18,146,187,126,41
"1358",1963-09-19,140,173,253,33
"1359",1963-09-20,154,258,0,104
"1360",1963-09-21,168,238,25,70
"1361",1963-09-22,154,250,23,96
"1362",1963-09-23,158,207,37,49
"1363",1963-09-24,161,236,0,75
"1364",1963-09-25,108,280,0,172
"1365",1963-09-26,107,246,0,139
"1366",1963-09-27,105,275,0,170
"1367",1963-09-28,170,237,28,67
"1368",1963-09-29,158,188,73,30
"1369",1963-09-30,146,280,0,134
"1370",1963-10-01,127,254,0,127
"1371",1963-10-02,134,212,0,78
"1372",1963-10-03,137,242,0,105
"1373",1963-10-04,135,195,6,60
"1374",1963-10-05,106,235,0,129
"1375",1963-10-06,90,277,0,187
"1376",1963-10-07,74,251,0,177
"1377",1963-10-08,113,258,0,145
"1378",1963-10-09,114,264,0,150
"1379",1963-10-10,147,250,0,103
"1380",1963-10-11,152,209,0,57
"1381",1963-10-12,148,201,0,53
"1382",1963-10-13,76,237,0,161
"1383",1963-10-14,98,251,0,153
"1384",1963-10-15,128,246,0,118
"1385",1963-10-16,95,187,0,92
"1386",1963-10-17,27,207,0,180
"1387",1963-10-18,44,228,0,184
"1388",1963-10-19,41,240,0,199
"1389",1963-10-20,91,174,0,83
"1390",1963-10-21,30,218,0,188
"1391",1963-10-22,74,239,0,165
"1392",1963-10-23,94,271,0,177
"1393",1963-10-24,99,249,0,150
"1394",1963-10-25,53,195,0,142
"1395",1963-10-26,58,229,0,171
"1396",1963-10-27,93,230,0,137
"1397",1963-10-28,103,239,0,136
"1398",1963-10-29,63,206,0,143
"1399",1963-10-30,43,222,0,179
"1400",1963-10-31,98,180,1,82
"1401",1963-11-01,58,216,0,158
"1402",1963-11-02,56,201,0,145
"1403",1963-11-03,102,140,53,38
"1404",1963-11-04,102,144,4,42
"1405",1963-11-05,127,189,13,62
"1406",1963-11-06,84,191,0,107
"1407",1963-11-07,93,188,1,95
"1408",1963-11-08,12,99,0,87
"1409",1963-11-09,-5,83,39,88
"1410",1963-11-10,16,118,21,102
"1411",1963-11-11,32,170,0,138
"1412",1963-11-12,20,198,0,178
"1413",1963-11-13,38,212,0,174
"1414",1963-11-14,43,143,0,100
"1415",1963-11-15,62,136,0,74
"1416",1963-11-16,60,177,0,117
"1417",1963-11-17,32,177,0,145
"1418",1963-11-18,89,179,0,90
"1419",1963-11-19,48,197,0,149
"1420",1963-11-20,19,220,0,201
"1421",1963-11-21,25,192,0,167
"1422",1963-11-22,54,166,0,112
"1423",1963-11-23,20,195,0,175
"1424",1963-11-24,27,159,0,132
"1425",1963-11-25,-10,97,0,107
"1426",1963-11-26,-7,61,0,68
"1427",1963-11-27,-28,167,0,195
"1428",1963-11-28,-27,86,0,113
"1429",1963-11-29,20,61,0,41
"1430",1963-11-30,-16,44,0,60
"1431",1963-12-01,-23,53,0,76
"1432",1963-12-02,3,38,0,35
"1433",1963-12-03,-4,115,0,119
"1434",1963-12-04,-18,164,0,182
"1435",1963-12-05,-24,123,0,147
"1436",1963-12-06,-9,105,0,114
"1437",1963-12-07,1,57,0,56
"1438",1963-12-08,-44,63,0,107
"1439",1963-12-09,-4,42,41,46
"1440",1963-12-10,-44,73,1,117
"1441",1963-12-11,6,102,0,96
"1442",1963-12-12,-37,117,0,154
"1443",1963-12-13,-8,53,0,61
"1444",1963-12-14,-26,66,0,92
"1445",1963-12-15,-13,45,0,58
"1446",1963-12-16,-14,100,0,114
"1447",1963-12-17,24,114,0,90
"1448",1963-12-18,-58,85,0,143
"1449",1963-12-19,-46,139,0,185
"1450",1963-12-20,-16,88,0,104
"1451",1963-12-21,-42,121,0,163
"1452",1963-12-22,64,139,0,75
"1453",1963-12-23,22,145,0,123
"1454",1963-12-24,-41,72,0,113
"1455",1963-12-25,-95,17,0,112
"1456",1963-12-26,-68,66,0,134
"1457",1963-12-27,-81,114,0,195
"1458",1963-12-28,-33,155,0,188
"1459",1963-12-29,-43,77,0,120
"1460",1963-12-30,-18,100,0,118
"1461",1963-12-31,-28,49,0,77
"1462",1964-01-01,-16,27,0,43
"1463",1964-01-02,-33,66,0,99
"1464",1964-01-03,-71,70,0,141
"1465",1964-01-04,-10,67,0,77
"1466",1964-01-05,-40,78,0,118
"1467",1964-01-06,-15,43,3,58
"1468",1964-01-07,4,26,1,22
"1469",1964-01-08,-3,18,6,21
"1470",1964-01-09,-4,19,0,23
"1471",1964-01-10,-12,21,89,33
"1472",1964-01-11,-12,11,88,23
"1473",1964-01-12,-37,54,0,91
"1474",1964-01-13,-27,67,0,94
"1475",1964-01-14,-39,34,0,73
"1476",1964-01-15,-11,8,0,19
"1477",1964-01-16,-51,49,13,100
"1478",1964-01-17,-8,36,0,44
"1479",1964-01-18,-14,55,0,69
"1480",1964-01-19,-54,58,0,112
"1481",1964-01-20,-29,46,0,75
"1482",1964-01-21,-23,12,0,35
"1483",1964-01-22,-31,20,0,51
"1484",1964-01-23,-52,25,0,77
"1485",1964-01-24,-58,43,0,101
"1486",1964-01-25,-40,35,0,75
"1487",1964-01-26,-30,32,0,62
"1488",1964-01-27,-61,8,67,69
"1489",1964-01-28,-79,71,0,150
"1490",1964-01-29,-6,68,0,74
"1491",1964-01-30,-41,44,0,85
"1492",1964-01-31,-70,21,0,91
"1493",1964-02-01,-64,7,0,71
"1494",1964-02-02,-66,24,0,90
"1495",1964-02-03,-64,21,0,85
"1496",1964-02-04,-26,-3,0,23
"1497",1964-02-05,-38,-11,48,27
"1498",1964-02-06,-34,-5,4,29
"1499",1964-02-07,-42,-25,184,17
"1500",1964-02-08,-54,-29,5,25
"1501",1964-02-09,-86,-22,2,64
"1502",1964-02-10,-100,-12,6,88
"1503",1964-02-11,-108,-33,0,75
"1504",1964-02-12,-102,-19,0,83
"1505",1964-02-13,-64,-25,0,39
"1506",1964-02-14,-47,-24,17,23
"1507",1964-02-15,-74,-20,30,54
"1508",1964-02-16,-125,-14,0,111
"1509",1964-02-17,-147,-19,0,128
"1510",1964-02-18,-120,-25,0,95
"1511",1964-02-19,-107,-15,0,92
"1512",1964-02-20,-86,29,0,115
"1513",1964-02-21,-89,5,0,94
"1514",1964-02-22,-62,-12,0,50
"1515",1964-02-23,-57,-19,0,38
"1516",1964-02-24,-63,-9,0,54
"1517",1964-02-25,-49,24,0,73
"1518",1964-02-26,-33,57,0,90
"1519",1964-02-27,-19,13,0,32
"1520",1964-02-28,-1,77,0,78
"1521",1964-02-29,-2,102,0,104
"1522",1964-03-01,17,68,0,51
"1523",1964-03-02,26,76,0,50
"1524",1964-03-03,39,78,1,39
"1525",1964-03-04,21,146,0,125
"1526",1964-03-05,53,88,17,35
"1527",1964-03-06,48,124,39,76
"1528",1964-03-07,36,98,0,62
"1529",1964-03-08,9,90,0,81
"1530",1964-03-09,13,139,0,126
"1531",1964-03-10,20,176,0,156
"1532",1964-03-11,45,120,0,75
"1533",1964-03-12,19,51,0,32
"1534",1964-03-13,-3,174,1,177
"1535",1964-03-14,32,169,0,137
"1536",1964-03-15,37,149,0,112
"1537",1964-03-16,66,96,0,30
"1538",1964-03-17,22,73,0,51
"1539",1964-03-18,12,50,67,38
"1540",1964-03-19,1,99,65,98
"1541",1964-03-20,-8,95,0,103
"1542",1964-03-21,35,54,15,19
"1543",1964-03-22,0,104,0,104
"1544",1964-03-23,56,84,6,28
"1545",1964-03-24,37,104,2,67
"1546",1964-03-25,2,148,0,146
"1547",1964-03-26,11,205,0,194
"1548",1964-03-27,51,198,0,147
"1549",1964-03-28,78,234,0,156
"1550",1964-03-29,121,241,0,120
"1551",1964-03-30,105,210,0,105
"1552",1964-03-31,61,221,0,160
"1553",1964-04-01,86,162,0,76
"1554",1964-04-02,108,153,0,45
"1555",1964-04-03,91,195,136,104
"1556",1964-04-04,106,173,2,67
"1557",1964-04-05,54,166,178,112
"1558",1964-04-06,27,70,28,43
"1559",1964-04-07,1,81,0,80
"1560",1964-04-08,35,141,0,106
"1561",1964-04-09,51,128,1,77
"1562",1964-04-10,34,173,0,139
"1563",1964-04-11,104,156,0,52
"1564",1964-04-12,115,148,0,33
"1565",1964-04-13,122,144,51,22
"1566",1964-04-14,127,166,21,39
"1567",1964-04-15,112,158,9,46
"1568",1964-04-16,94,112,197,18
"1569",1964-04-17,100,153,0,53
"1570",1964-04-18,132,149,183,17
"1571",1964-04-19,137,160,460,23
"1572",1964-04-20,138,259,388,121
"1573",1964-04-21,159,203,219,44
"1574",1964-04-22,105,269,1,164
"1575",1964-04-23,146,243,0,97
"1576",1964-04-24,130,164,5,34
"1577",1964-04-25,111,207,52,96
"1578",1964-04-26,112,196,0,84
"1579",1964-04-27,121,165,5,44
"1580",1964-04-28,104,176,0,72
"1581",1964-04-29,94,188,0,94
"1582",1964-04-30,121,249,0,128
"1583",1964-05-01,95,225,0,130
"1584",1964-05-02,101,274,0,173
"1585",1964-05-03,156,242,0,86
"1586",1964-05-04,113,277,0,164
"1587",1964-05-05,133,300,0,167
"1588",1964-05-06,153,280,0,127
"1589",1964-05-07,144,282,0,138
"1590",1964-05-08,183,242,11,59
"1591",1964-05-09,137,189,160,52
"1592",1964-05-10,107,256,0,149
"1593",1964-05-11,116,278,0,162
"1594",1964-05-12,126,284,0,158
"1595",1964-05-13,138,270,0,132
"1596",1964-05-14,164,207,1,43
"1597",1964-05-15,165,188,115,23
"1598",1964-05-16,156,173,498,17
"1599",1964-05-17,153,209,0,56
"1600",1964-05-18,148,196,0,48
"1601",1964-05-19,153,216,0,63
"1602",1964-05-20,164,214,26,50
"1603",1964-05-21,159,274,1,115
"1604",1964-05-22,164,278,0,114
"1605",1964-05-23,162,284,0,122
"1606",1964-05-24,166,243,230,77
"1607",1964-05-25,141,254,0,113
"1608",1964-05-26,168,230,24,62
"1609",1964-05-27,142,259,0,117
"1610",1964-05-28,187,269,0,82
"1611",1964-05-29,195,289,4,94
"1612",1964-05-30,178,290,0,112
"1613",1964-05-31,190,257,25,67
"1614",1964-06-01,172,329,0,157
"1615",1964-06-02,135,287,2,152
"1616",1964-06-03,143,306,0,163
"1617",1964-06-04,145,335,0,190
"1618",1964-06-05,175,322,0,147
"1619",1964-06-06,152,346,0,194
"1620",1964-06-07,219,346,0,127
"1621",1964-06-08,197,316,0,119
"1622",1964-06-09,211,294,19,83
"1623",1964-06-10,192,324,15,132
"1624",1964-06-11,198,329,0,131
"1625",1964-06-12,204,365,0,161
"1626",1964-06-13,187,311,21,124
"1627",1964-06-14,182,340,0,158
"1628",1964-06-15,187,317,0,130
"1629",1964-06-16,185,281,24,96
"1630",1964-06-17,188,310,0,122
"1631",1964-06-18,210,287,0,77
"1632",1964-06-19,169,344,0,175
"1633",1964-06-20,202,375,0,173
"1634",1964-06-21,189,360,0,171
"1635",1964-06-22,176,375,0,199
"1636",1964-06-23,233,353,0,120
"1637",1964-06-24,187,326,0,139
"1638",1964-06-25,197,328,0,131
"1639",1964-06-26,218,333,0,115
"1640",1964-06-27,209,355,0,146
"1641",1964-06-28,219,361,0,142
"1642",1964-06-29,223,318,0,95
"1643",1964-06-30,209,291,101,82
"1644",1964-07-01,213,255,18,42
"1645",1964-07-02,203,267,67,64
"1646",1964-07-03,234,335,0,101
"1647",1964-07-04,261,340,28,79
"1648",1964-07-05,243,341,3,98
"1649",1964-07-06,256,359,0,103
"1650",1964-07-07,230,371,0,141
"1651",1964-07-08,283,391,0,108
"1652",1964-07-09,266,398,0,132
"1653",1964-07-10,242,391,0,149
"1654",1964-07-11,255,348,0,93
"1655",1964-07-12,267,364,0,97
"1656",1964-07-13,216,319,5,103
"1657",1964-07-14,207,306,4,99
"1658",1964-07-15,231,353,0,122
"1659",1964-07-16,269,363,0,94
"1660",1964-07-17,232,327,868,95
"1661",1964-07-18,224,299,29,75
"1662",1964-07-19,221,310,0,89
"1663",1964-07-20,241,313,0,72
"1664",1964-07-21,253,353,0,100
"1665",1964-07-22,267,316,1,49
"1666",1964-07-23,217,292,10,75
"1667",1964-07-24,230,292,0,62
"1668",1964-07-25,210,255,122,45
"1669",1964-07-26,203,281,1,78
"1670",1964-07-27,196,256,785,60
"1671",1964-07-28,197,287,11,90
"1672",1964-07-29,202,324,0,122
"1673",1964-07-30,229,316,0,87
"1674",1964-07-31,221,273,65,52
"1675",1964-08-01,204,286,250,82
"1676",1964-08-02,209,305,3,96
"1677",1964-08-03,207,311,0,104
"1678",1964-08-04,228,310,0,82
"1679",1964-08-05,238,339,0,101
"1680",1964-08-06,253,378,0,125
"1681",1964-08-07,258,391,0,133
"1682",1964-08-08,248,335,0,87
"1683",1964-08-09,249,318,1,69
"1684",1964-08-10,243,320,80,77
"1685",1964-08-11,249,305,2,56
"1686",1964-08-12,248,314,317,66
"1687",1964-08-13,250,338,0,88
"1688",1964-08-14,273,351,0,78
"1689",1964-08-15,250,302,0,52
"1690",1964-08-16,230,313,0,83
"1691",1964-08-17,203,267,723,64
"1692",1964-08-18,183,273,0,90
"1693",1964-08-19,197,278,0,81
"1694",1964-08-20,213,284,0,71
"1695",1964-08-21,217,267,0,50
"1696",1964-08-22,192,303,0,111
"1697",1964-08-23,210,299,0,89
"1698",1964-08-24,191,311,0,120
"1699",1964-08-25,211,342,0,131
"1700",1964-08-26,228,341,0,113
"1701",1964-08-27,231,342,0,111
"1702",1964-08-28,221,295,69,74
"1703",1964-08-29,218,305,0,87
"1704",1964-08-30,205,261,286,56
"1705",1964-08-31,186,277,153,91
"1706",1964-09-01,202,238,88,36
"1707",1964-09-02,199,249,263,50
"1708",1964-09-03,215,277,0,62
"1709",1964-09-04,195,267,12,72
"1710",1964-09-05,211,241,11,30
"1711",1964-09-06,190,225,15,35
"1712",1964-09-07,196,229,0,33
"1713",1964-09-08,184,266,7,82
"1714",1964-09-09,168,293,0,125
"1715",1964-09-10,206,259,20,53
"1716",1964-09-11,188,235,21,47
"1717",1964-09-12,212,291,22,79
"1718",1964-09-13,182,229,39,47
"1719",1964-09-14,160,216,24,56
"1720",1964-09-15,181,243,1,62
"1721",1964-09-16,135,237,5,102
"1722",1964-09-17,178,197,261,19
"1723",1964-09-18,164,218,1,54
"1724",1964-09-19,151,231,0,80
"1725",1964-09-20,156,211,0,55
"1726",1964-09-21,155,212,0,57
"1727",1964-09-22,134,178,87,44
"1728",1964-09-23,132,159,109,27
"1729",1964-09-24,136,197,17,61
"1730",1964-09-25,122,256,0,134
"1731",1964-09-26,166,219,10,53
"1732",1964-09-27,149,214,9,65
"1733",1964-09-28,109,239,1,130
"1734",1964-09-29,123,230,0,107
"1735",1964-09-30,128,234,0,106
"1736",1964-10-01,157,231,0,74
"1737",1964-10-02,160,199,82,39
"1738",1964-10-03,146,193,2,47
"1739",1964-10-04,157,173,433,16
"1740",1964-10-05,147,192,1,45
"1741",1964-10-06,94,214,0,120
"1742",1964-10-07,132,234,0,102
"1743",1964-10-08,115,214,0,99
"1744",1964-10-09,116,165,0,49
"1745",1964-10-10,126,160,23,34
"1746",1964-10-11,135,216,0,81
"1747",1964-10-12,157,180,39,23
"1748",1964-10-13,153,192,23,39
"1749",1964-10-14,163,208,1,45
"1750",1964-10-15,177,230,0,53
"1751",1964-10-16,152,208,153,56
"1752",1964-10-17,93,158,12,65
"1753",1964-10-18,45,125,2,80
"1754",1964-10-19,93,138,21,45
"1755",1964-10-20,92,215,76,123
"1756",1964-10-21,122,160,15,38
"1757",1964-10-22,129,177,19,48
"1758",1964-10-23,110,169,0,59
"1759",1964-10-24,111,145,68,34
"1760",1964-10-25,115,133,74,18
"1761",1964-10-26,114,166,0,52
"1762",1964-10-27,80,169,1,89
"1763",1964-10-28,127,139,258,12
"1764",1964-10-29,93,129,4,36
"1765",1964-10-30,75,130,13,55
"1766",1964-10-31,111,188,26,77
"1767",1964-11-01,50,135,0,85
"1768",1964-11-02,62,101,1,39
"1769",1964-11-03,62,84,58,22
"1770",1964-11-04,79,117,0,38
"1771",1964-11-05,82,160,0,78
"1772",1964-11-06,83,169,0,86
"1773",1964-11-07,80,149,0,69
"1774",1964-11-08,72,153,0,81
"1775",1964-11-09,55,174,0,119
"1776",1964-11-10,59,184,0,125
"1777",1964-11-11,55,156,0,101
"1778",1964-11-12,35,122,0,87
"1779",1964-11-13,9,123,0,114
"1780",1964-11-14,36,134,0,98
"1781",1964-11-15,20,126,0,106
"1782",1964-11-16,45,138,0,93
"1783",1964-11-17,75,133,0,58
"1784",1964-11-18,76,153,0,77
"1785",1964-11-19,17,175,0,158
"1786",1964-11-20,47,170,0,123
"1787",1964-11-21,48,135,0,87
"1788",1964-11-22,24,176,0,152
"1789",1964-11-23,73,183,0,110
"1790",1964-11-24,50,162,0,112
"1791",1964-11-25,8,191,1,183
"1792",1964-11-26,9,164,0,155
"1793",1964-11-27,50,209,0,159
"1794",1964-11-28,57,97,37,40
"1795",1964-11-29,54,97,1,43
"1796",1964-11-30,20,64,0,44
"1797",1964-12-01,-23,21,34,44
"1798",1964-12-02,-47,54,17,101
"1799",1964-12-03,-5,65,0,70
"1800",1964-12-04,10,80,0,70
"1801",1964-12-05,-10,109,0,119
"1802",1964-12-06,-16,68,0,84
"1803",1964-12-07,-5,99,0,104
"1804",1964-12-08,-8,50,0,58
"1805",1964-12-09,21,53,0,32
"1806",1964-12-10,6,26,3,20
"1807",1964-12-11,-17,11,0,28
"1808",1964-12-12,-37,35,0,72
"1809",1964-12-13,6,71,0,65
"1810",1964-12-14,-7,92,0,99
"1811",1964-12-15,-14,115,0,129
"1812",1964-12-16,-13,104,0,117
"1813",1964-12-17,-14,59,0,73
"1814",1964-12-18,-32,73,0,105
"1815",1964-12-19,-38,90,0,128
"1816",1964-12-20,-27,139,0,166
"1817",1964-12-21,-12,126,0,138
"1818",1964-12-22,-12,155,0,167
"1819",1964-12-23,-13,94,0,107
"1820",1964-12-24,-8,45,0,53
"1821",1964-12-25,-4,51,0,55
"1822",1964-12-26,-10,134,0,144
"1823",1964-12-27,-10,62,2,72
"1824",1964-12-28,-10,40,0,50
"1825",1964-12-29,-2,98,0,100
"1826",1964-12-30,-21,99,0,120
"1827",1964-12-31,-14,121,0,135
"1828",1965-01-01,-36,46,0,82
"1829",1965-01-02,-15,45,0,60
"1830",1965-01-03,-44,25,1,69
"1831",1965-01-04,-21,26,0,47
"1832",1965-01-05,-46,101,0,147
"1833",1965-01-06,-34,116,0,150
"1834",1965-01-07,10,73,0,63
"1835",1965-01-08,-42,84,0,126
"1836",1965-01-09,-48,112,0,160
"1837",1965-01-10,-19,78,0,97
"1838",1965-01-11,-70,42,0,112
"1839",1965-01-12,-65,42,0,107
"1840",1965-01-13,-44,14,0,58
"1841",1965-01-14,-61,66,0,127
"1842",1965-01-15,-35,104,0,139
"1843",1965-01-16,-49,40,0,89
"1844",1965-01-17,-39,26,0,65
"1845",1965-01-18,-50,62,0,112
"1846",1965-01-19,-39,67,0,106
"1847",1965-01-20,-7,55,0,62
"1848",1965-01-21,-16,30,0,46
"1849",1965-01-22,10,26,0,16
"1850",1965-01-23,-5,23,12,28
"1851",1965-01-24,-19,25,0,44
"1852",1965-01-25,-23,58,0,81
"1853",1965-01-26,-3,124,0,127
"1854",1965-01-27,-13,75,0,88
"1855",1965-01-28,19,48,8,29
"1856",1965-01-29,-24,83,18,107
"1857",1965-01-30,7,77,0,70
"1858",1965-01-31,-1,78,0,79
"1859",1965-02-01,-37,76,0,113
"1860",1965-02-02,-37,61,0,98
"1861",1965-02-03,-38,31,0,69
"1862",1965-02-04,-11,79,0,90
"1863",1965-02-05,-35,63,0,98
"1864",1965-02-06,-27,105,0,132
"1865",1965-02-07,16,111,0,95
"1866",1965-02-08,-24,142,0,166
"1867",1965-02-09,16,123,0,107
"1868",1965-02-10,-34,133,0,167
"1869",1965-02-11,-22,159,0,181
"1870",1965-02-12,-13,120,0,133
"1871",1965-02-13,-21,103,0,124
"1872",1965-02-14,-39,117,0,156
"1873",1965-02-15,32,129,5,97
"1874",1965-02-16,-5,54,89,59
"1875",1965-02-17,31,52,94,21
"1876",1965-02-18,39,61,17,22
"1877",1965-02-19,47,66,22,19
"1878",1965-02-20,21,54,0,33
"1879",1965-02-21,-5,28,0,33
"1880",1965-02-22,-15,36,0,51
"1881",1965-02-23,-16,110,0,126
"1882",1965-02-24,0,101,0,101
"1883",1965-02-25,1,98,0,97
"1884",1965-02-26,-26,20,0,46
"1885",1965-02-27,-26,116,0,142
"1886",1965-02-28,-9,125,0,134
"1887",1965-03-01,0,104,0,104
"1888",1965-03-02,5,118,0,113
"1889",1965-03-03,2,70,0,68
"1890",1965-03-04,-47,73,0,120
"1891",1965-03-05,-28,100,0,128
"1892",1965-03-06,-13,61,0,74
"1893",1965-03-07,-39,116,0,155
"1894",1965-03-08,-2,146,0,148
"1895",1965-03-09,-3,132,0,135
"1896",1965-03-10,-31,201,0,232
"1897",1965-03-11,31,216,0,185
"1898",1965-03-12,55,188,0,133
"1899",1965-03-13,27,259,0,232
"1900",1965-03-14,75,256,0,181
"1901",1965-03-15,53,163,0,110
"1902",1965-03-16,-40,138,0,178
"1903",1965-03-17,-16,179,0,195
"1904",1965-03-18,13,200,0,187
"1905",1965-03-19,57,134,0,77
"1906",1965-03-20,37,76,0,39
"1907",1965-03-21,44,109,0,65
"1908",1965-03-22,61,109,16,48
"1909",1965-03-23,30,157,23,127
"1910",1965-03-24,50,121,0,71
"1911",1965-03-25,36,99,0,63
"1912",1965-03-26,45,114,0,69
"1913",1965-03-27,57,130,0,73
"1914",1965-03-28,14,151,0,137
"1915",1965-03-29,21,183,0,162
"1916",1965-03-30,32,212,0,180
"1917",1965-03-31,58,267,0,209
"1918",1965-04-01,34,185,0,151
"1919",1965-04-02,25,216,0,191
"1920",1965-04-03,56,157,16,101
"1921",1965-04-04,63,109,0,46
"1922",1965-04-05,55,125,0,70
"1923",1965-04-06,4,166,0,162
"1924",1965-04-07,95,157,0,62
"1925",1965-04-08,54,213,0,159
"1926",1965-04-09,88,212,0,124
"1927",1965-04-10,35,186,0,151
"1928",1965-04-11,42,245,0,203
"1929",1965-04-12,93,207,0,114
"1930",1965-04-13,72,249,0,177
"1931",1965-04-14,115,270,0,155
"1932",1965-04-15,146,270,0,124
"1933",1965-04-16,145,282,0,137
"1934",1965-04-17,94,219,0,125
"1935",1965-04-18,61,96,2,35
"1936",1965-04-19,64,155,0,91
"1937",1965-04-20,80,135,31,55
"1938",1965-04-21,67,105,58,38
"1939",1965-04-22,67,145,209,78
"1940",1965-04-23,75,201,0,126
"1941",1965-04-24,113,211,0,98
"1942",1965-04-25,148,193,0,45
"1943",1965-04-26,96,168,0,72
"1944",1965-04-27,42,122,119,80
"1945",1965-04-28,42,135,5,93
"1946",1965-04-29,76,233,0,157
"1947",1965-04-30,93,157,9,64
"1948",1965-05-01,98,129,148,31
"1949",1965-05-02,80,182,10,102
"1950",1965-05-03,92,230,0,138
"1951",1965-05-04,131,294,0,163
"1952",1965-05-05,138,243,15,105
"1953",1965-05-06,98,301,0,203
"1954",1965-05-07,124,329,0,205
"1955",1965-05-08,151,303,0,152
"1956",1965-05-09,188,247,0,59
"1957",1965-05-10,113,264,0,151
"1958",1965-05-11,146,284,0,138
"1959",1965-05-12,174,308,0,134
"1960",1965-05-13,177,234,1,57
"1961",1965-05-14,142,237,1,95
"1962",1965-05-15,176,316,0,140
"1963",1965-05-16,175,301,0,126
"1964",1965-05-17,150,285,0,135
"1965",1965-05-18,171,304,8,133
"1966",1965-05-19,150,338,33,188
"1967",1965-05-20,207,294,0,87
"1968",1965-05-21,151,337,0,186
"1969",1965-05-22,156,358,0,202
"1970",1965-05-23,193,373,0,180
"1971",1965-05-24,165,269,0,104
"1972",1965-05-25,110,303,0,193
"1973",1965-05-26,131,325,0,194
"1974",1965-05-27,155,334,10,179
"1975",1965-05-28,180,320,23,140
"1976",1965-05-29,156,337,0,181
"1977",1965-05-30,186,334,0,148
"1978",1965-05-31,203,334,0,131
"1979",1965-06-01,182,348,0,166
"1980",1965-06-02,167,287,7,120
"1981",1965-06-03,131,269,50,138
"1982",1965-06-04,143,341,0,198
"1983",1965-06-05,203,366,0,163
"1984",1965-06-06,166,376,0,210
"1985",1965-06-07,209,328,0,119
"1986",1965-06-08,210,312,0,102
"1987",1965-06-09,186,275,8,89
"1988",1965-06-10,155,254,0,99
"1989",1965-06-11,170,349,0,179
"1990",1965-06-12,191,335,0,144
"1991",1965-06-13,205,354,0,149
"1992",1965-06-14,209,352,0,143
"1993",1965-06-15,184,324,0,140
"1994",1965-06-16,166,314,0,148
"1995",1965-06-17,156,333,0,177
"1996",1965-06-18,213,309,0,96
"1997",1965-06-19,167,354,0,187
"1998",1965-06-20,200,341,0,141
"1999",1965-06-21,215,368,0,153
"2000",1965-06-22,241,377,0,136
"2001",1965-06-23,232,365,0,133
"2002",1965-06-24,201,330,0,129
"2003",1965-06-25,199,343,0,144
"2004",1965-06-26,203,359,0,156
"2005",1965-06-27,225,376,0,151
"2006",1965-06-28,269,369,0,100
"2007",1965-06-29,243,399,0,156
"2008",1965-06-30,278,354,0,76
"2009",1965-07-01,238,293,2,55
"2010",1965-07-02,228,280,43,52
"2011",1965-07-03,222,362,26,140
"2012",1965-07-04,226,384,0,158
"2013",1965-07-05,200,344,17,144
"2014",1965-07-06,210,364,3,154
"2015",1965-07-07,221,346,0,125
"2016",1965-07-08,212,319,276,107
"2017",1965-07-09,222,249,260,27
"2018",1965-07-10,217,264,8,47
"2019",1965-07-11,219,297,93,78
"2020",1965-07-12,221,268,165,47
"2021",1965-07-13,211,264,31,53
"2022",1965-07-14,210,299,1,89
"2023",1965-07-15,217,290,0,73
"2024",1965-07-16,235,278,68,43
"2025",1965-07-17,235,318,30,83
"2026",1965-07-18,247,344,0,97
"2027",1965-07-19,267,350,5,83
"2028",1965-07-20,256,309,65,53
"2029",1965-07-21,259,286,24,27
"2030",1965-07-22,224,338,9,114
"2031",1965-07-23,241,365,0,124
"2032",1965-07-24,220,342,0,122
"2033",1965-07-25,247,339,0,92
"2034",1965-07-26,238,314,0,76
"2035",1965-07-27,229,329,1,100
"2036",1965-07-28,223,331,0,108
"2037",1965-07-29,232,359,0,127
"2038",1965-07-30,243,358,0,115
"2039",1965-07-31,273,367,0,94
"2040",1965-08-01,250,344,0,94
"2041",1965-08-02,215,334,0,119
"2042",1965-08-03,214,291,10,77
"2043",1965-08-04,200,269,179,69
"2044",1965-08-05,185,294,0,109
"2045",1965-08-06,193,329,18,136
"2046",1965-08-07,202,345,0,143
"2047",1965-08-08,230,347,0,117
"2048",1965-08-09,243,318,0,75
"2049",1965-08-10,218,357,0,139
"2050",1965-08-11,209,365,0,156
"2051",1965-08-12,191,378,0,187
"2052",1965-08-13,217,356,0,139
"2053",1965-08-14,220,324,0,104
"2054",1965-08-15,247,374,0,127
"2055",1965-08-16,206,318,20,112
"2056",1965-08-17,206,233,43,27
"2057",1965-08-18,181,256,136,75
"2058",1965-08-19,152,299,0,147
"2059",1965-08-20,172,295,1,123
"2060",1965-08-21,191,315,0,124
"2061",1965-08-22,199,359,0,160
"2062",1965-08-23,191,396,0,205
"2063",1965-08-24,222,384,0,162
"2064",1965-08-25,190,345,0,155
"2065",1965-08-26,222,337,0,115
"2066",1965-08-27,209,331,0,122
"2067",1965-08-28,234,310,2,76
"2068",1965-08-29,217,289,0,72
"2069",1965-08-30,175,299,0,124
"2070",1965-08-31,211,290,4,79
"2071",1965-09-01,145,302,0,157
"2072",1965-09-02,212,322,0,110
"2073",1965-09-03,212,305,11,93
"2074",1965-09-04,206,272,189,66
"2075",1965-09-05,176,263,273,87
"2076",1965-09-06,167,284,0,117
"2077",1965-09-07,143,284,0,141
"2078",1965-09-08,147,249,0,102
"2079",1965-09-09,111,270,0,159
"2080",1965-09-10,136,286,0,150
"2081",1965-09-11,150,283,0,133
"2082",1965-09-12,181,294,0,113
"2083",1965-09-13,148,319,0,171
"2084",1965-09-14,156,310,45,154
"2085",1965-09-15,158,267,20,109
"2086",1965-09-16,134,306,0,172
"2087",1965-09-17,127,321,0,194
"2088",1965-09-18,126,341,0,215
"2089",1965-09-19,145,338,0,193
"2090",1965-09-20,152,333,0,181
"2091",1965-09-21,152,338,0,186
"2092",1965-09-22,157,340,0,183
"2093",1965-09-23,154,310,0,156
"2094",1965-09-24,151,305,0,154
"2095",1965-09-25,137,299,0,162
"2096",1965-09-26,168,243,0,75
"2097",1965-09-27,107,245,0,138
"2098",1965-09-28,98,261,0,163
"2099",1965-09-29,106,286,0,180
"2100",1965-09-30,118,274,0,156
"2101",1965-10-01,180,238,0,58
"2102",1965-10-02,149,244,0,95
"2103",1965-10-03,171,229,48,58
"2104",1965-10-04,156,205,10,49
"2105",1965-10-05,137,214,0,77
"2106",1965-10-06,138,204,3,66
"2107",1965-10-07,135,225,5,90
"2108",1965-10-08,92,253,0,161
"2109",1965-10-09,110,194,29,84
"2110",1965-10-10,136,170,89,34
"2111",1965-10-11,92,189,3,97
"2112",1965-10-12,130,243,0,113
"2113",1965-10-13,120,224,0,104
"2114",1965-10-14,84,230,0,146
"2115",1965-10-15,48,224,0,176
"2116",1965-10-16,46,229,0,183
"2117",1965-10-17,50,251,0,201
"2118",1965-10-18,51,280,0,229
"2119",1965-10-19,89,286,0,197
"2120",1965-10-20,87,251,0,164
"2121",1965-10-21,101,211,0,110
"2122",1965-10-22,104,229,0,125
"2123",1965-10-23,70,242,0,172
"2124",1965-10-24,78,266,0,188
"2125",1965-10-25,95,260,0,165
"2126",1965-10-26,115,262,0,147
"2127",1965-10-27,91,263,0,172
"2128",1965-10-28,86,272,0,186
"2129",1965-10-29,90,230,71,140
"2130",1965-10-30,130,181,4,51
"2131",1965-10-31,92,213,30,121
"2132",1965-11-01,102,149,547,47
"2133",1965-11-02,99,170,0,71
"2134",1965-11-03,58,151,0,93
"2135",1965-11-04,77,181,1,104
"2136",1965-11-05,38,202,0,164
"2137",1965-11-06,97,185,5,88
"2138",1965-11-07,121,149,132,28
"2139",1965-11-08,60,123,82,63
"2140",1965-11-09,55,180,0,125
"2141",1965-11-10,47,109,1,62
"2142",1965-11-11,40,110,0,70
"2143",1965-11-12,92,143,0,51
"2144",1965-11-13,80,186,0,106
"2145",1965-11-14,43,174,0,131
"2146",1965-11-15,82,NA,0,NA
"2147",1965-11-16,60,151,0,91
"2148",1965-11-17,37,103,0,66
"2149",1965-11-18,67,146,13,79
"2150",1965-11-19,49,194,0,145
"2151",1965-11-20,30,173,0,143
"2152",1965-11-21,4,190,0,186
"2153",1965-11-22,71,185,0,114
"2154",1965-11-23,39,114,2,75
"2155",1965-11-24,27,83,0,56
"2156",1965-11-25,-22,106,0,128
"2157",1965-11-26,-33,124,0,157
"2158",1965-11-27,-9,162,0,171
"2159",1965-11-28,-1,156,0,157
"2160",1965-11-29,40,114,0,74
"2161",1965-11-30,-22,79,0,101
"2162",1965-12-01,-41,93,0,134
"2163",1965-12-02,1,169,0,168
"2164",1965-12-03,34,169,0,135
"2165",1965-12-04,1,86,0,85
"2166",1965-12-05,-10,35,0,45
"2167",1965-12-06,-43,75,0,118
"2168",1965-12-07,19,100,0,81
"2169",1965-12-08,37,144,0,107
"2170",1965-12-09,16,144,0,128
"2171",1965-12-10,86,179,0,93
"2172",1965-12-11,48,148,0,100
"2173",1965-12-12,-18,110,0,128
"2174",1965-12-13,16,141,0,125
"2175",1965-12-14,35,94,0,59
"2176",1965-12-15,-29,60,0,89
"2177",1965-12-16,-69,2,0,71
"2178",1965-12-17,-88,38,0,126
"2179",1965-12-18,-17,59,0,76
"2180",1965-12-19,5,103,0,98
"2181",1965-12-20,-64,173,0,237
"2182",1965-12-21,-30,99,0,129
"2183",1965-12-22,24,94,0,70
"2184",1965-12-23,-21,48,0,69
"2185",1965-12-24,-48,17,0,65
"2186",1965-12-25,-73,40,0,113
"2187",1965-12-26,-40,53,0,93
"2188",1965-12-27,-91,50,0,141
"2189",1965-12-28,-40,82,0,122
"2190",1965-12-29,-65,26,0,91
"2191",1965-12-30,-85,5,0,90
"2192",1965-12-31,-84,28,0,112
"2193",1966-01-01,-88,50,0,138
"2194",1966-01-02,-57,41,0,98
"2195",1966-01-03,-31,100,0,131
"2196",1966-01-04,-36,115,0,151
"2197",1966-01-05,-6,170,0,176
"2198",1966-01-06,6,117,0,111
"2199",1966-01-07,-24,94,0,118
"2200",1966-01-08,-49,127,0,176
"2201",1966-01-09,-29,155,0,184
"2202",1966-01-10,-23,84,0,107
"2203",1966-01-11,-49,47,0,96
"2204",1966-01-12,-33,77,0,110
"2205",1966-01-13,-9,49,0,58
"2206",1966-01-14,-37,89,0,126
"2207",1966-01-15,-71,156,0,227
"2208",1966-01-16,-41,169,0,210
"2209",1966-01-17,-13,59,0,72
"2210",1966-01-18,-73,46,0,119
"2211",1966-01-19,-77,48,0,125
"2212",1966-01-20,-59,-7,0,52
"2213",1966-01-21,-36,18,0,54
"2214",1966-01-22,-22,-3,7,19
"2215",1966-01-23,-27,-3,0,24
"2216",1966-01-24,-21,57,0,78
"2217",1966-01-25,-76,57,0,133
"2218",1966-01-26,-31,3,0,34
"2219",1966-01-27,-66,17,0,83
"2220",1966-01-28,-69,93,0,162
"2221",1966-01-29,-48,67,0,115
"2222",1966-01-30,-63,133,0,196
"2223",1966-01-31,-37,174,0,211
"2224",1966-02-01,-25,134,0,159
"2225",1966-02-02,-23,207,0,230
"2226",1966-02-03,30,141,0,111
"2227",1966-02-04,17,84,0,67
"2228",1966-02-05,-40,81,0,121
"2229",1966-02-06,-71,85,0,156
"2230",1966-02-07,-44,81,0,125
"2231",1966-02-08,-38,144,0,182
"2232",1966-02-09,-6,93,0,99
"2233",1966-02-10,36,128,0,92
"2234",1966-02-11,6,39,0,33
"2235",1966-02-12,-6,121,0,127
"2236",1966-02-13,21,178,0,157
"2237",1966-02-14,-30,194,0,224
"2238",1966-02-15,49,116,0,67
"2239",1966-02-16,-16,174,0,190
"2240",1966-02-17,13,205,0,192
"2241",1966-02-18,-5,129,0,134
"2242",1966-02-19,27,151,0,124
"2243",1966-02-20,-4,84,0,88
"2244",1966-02-21,-65,14,91,79
"2245",1966-02-22,-98,1,0,99
"2246",1966-02-23,-118,32,0,150
"2247",1966-02-24,-73,115,0,188
"2248",1966-02-25,-6,144,0,150
"2249",1966-02-26,1,171,0,170
"2250",1966-02-27,34,221,0,187
"2251",1966-02-28,50,226,0,176
"2252",1966-03-01,27,211,0,184
"2253",1966-03-02,40,243,0,203
"2254",1966-03-03,42,168,0,126
"2255",1966-03-04,19,75,21,56
"2256",1966-03-05,-27,51,57,78
"2257",1966-03-06,-42,-23,172,19
"2258",1966-03-07,-39,-2,78,37
"2259",1966-03-08,-102,37,0,139
"2260",1966-03-09,-17,128,0,145
"2261",1966-03-10,2,142,0,140
"2262",1966-03-11,8,204,0,196
"2263",1966-03-12,46,240,0,194
"2264",1966-03-13,67,208,0,141
"2265",1966-03-14,82,156,0,74
"2266",1966-03-15,89,213,0,124
"2267",1966-03-16,88,193,0,105
"2268",1966-03-17,23,106,39,83
"2269",1966-03-18,34,111,1,77
"2270",1966-03-19,-24,152,0,176
"2271",1966-03-20,14,147,0,133
"2272",1966-03-21,48,134,0,86
"2273",1966-03-22,97,149,0,52
"2274",1966-03-23,2,216,0,214
"2275",1966-03-24,46,156,0,110
"2276",1966-03-25,20,118,0,98
"2277",1966-03-26,4,126,0,122
"2278",1966-03-27,54,128,0,74
"2279",1966-03-28,27,147,0,120
"2280",1966-03-29,26,156,0,130
"2281",1966-03-30,88,130,10,42
"2282",1966-03-31,37,195,1,158
"2283",1966-04-01,73,216,0,143
"2284",1966-04-02,81,237,0,156
"2285",1966-04-03,115,176,0,61
"2286",1966-04-04,10,154,0,144
"2287",1966-04-05,60,168,0,108
"2288",1966-04-06,95,213,0,118
"2289",1966-04-07,55,157,0,102
"2290",1966-04-08,51,183,10,132
"2291",1966-04-09,75,123,36,48
"2292",1966-04-10,26,135,1,109
"2293",1966-04-11,39,197,0,158
"2294",1966-04-12,66,190,0,124
"2295",1966-04-13,79,256,0,177
"2296",1966-04-14,93,262,0,169
"2297",1966-04-15,100,202,0,102
"2298",1966-04-16,23,222,0,199
"2299",1966-04-17,80,228,0,148
"2300",1966-04-18,89,250,0,161
"2301",1966-04-19,105,260,0,155
"2302",1966-04-20,151,254,3,103
"2303",1966-04-21,110,301,0,191
"2304",1966-04-22,123,318,0,195
"2305",1966-04-23,131,236,0,105
"2306",1966-04-24,134,154,191,20
"2307",1966-04-25,136,205,81,69
"2308",1966-04-26,128,244,1,116
"2309",1966-04-27,118,283,0,165
"2310",1966-04-28,185,253,0,68
"2311",1966-04-29,143,220,12,77
"2312",1966-04-30,58,227,0,169
"2313",1966-05-01,132,232,43,100
"2314",1966-05-02,129,253,0,124
"2315",1966-05-03,124,297,0,173
"2316",1966-05-04,109,289,0,180
"2317",1966-05-05,141,344,0,203
"2318",1966-05-06,216,291,0,75
"2319",1966-05-07,105,285,0,180
"2320",1966-05-08,140,350,0,210
"2321",1966-05-09,232,332,0,100
"2322",1966-05-10,203,270,0,67
"2323",1966-05-11,164,267,0,103
"2324",1966-05-12,142,266,0,124
"2325",1966-05-13,181,300,0,119
"2326",1966-05-14,173,215,73,42
"2327",1966-05-15,115,268,0,153
"2328",1966-05-16,162,251,0,89
"2329",1966-05-17,160,246,0,86
"2330",1966-05-18,106,261,0,155
"2331",1966-05-19,85,271,0,186
"2332",1966-05-20,150,295,0,145
"2333",1966-05-21,163,300,0,137
"2334",1966-05-22,153,273,0,120
"2335",1966-05-23,171,280,0,109
"2336",1966-05-24,127,286,0,159
"2337",1966-05-25,176,280,0,104
"2338",1966-05-26,184,251,13,67
"2339",1966-05-27,158,253,98,95
"2340",1966-05-28,159,246,85,87
"2341",1966-05-29,152,287,0,135
"2342",1966-05-30,202,272,0,70
"2343",1966-05-31,158,296,0,138
"2344",1966-06-01,168,311,0,143
"2345",1966-06-02,161,345,0,184
"2346",1966-06-03,196,333,0,137
"2347",1966-06-04,160,365,0,205
"2348",1966-06-05,169,338,0,169
"2349",1966-06-06,186,396,0,210
"2350",1966-06-07,222,386,0,164
"2351",1966-06-08,196,335,2,139
"2352",1966-06-09,159,339,1,180
"2353",1966-06-10,222,350,0,128
"2354",1966-06-11,207,335,0,128
"2355",1966-06-12,222,315,0,93
"2356",1966-06-13,154,311,0,157
"2357",1966-06-14,197,315,0,118
"2358",1966-06-15,215,293,5,78
"2359",1966-06-16,207,330,87,123
"2360",1966-06-17,206,377,4,171
"2361",1966-06-18,212,341,0,129
"2362",1966-06-19,176,400,0,224
"2363",1966-06-20,247,398,0,151
"2364",1966-06-21,245,401,0,156
"2365",1966-06-22,279,414,0,135
"2366",1966-06-23,244,366,0,122
"2367",1966-06-24,215,320,35,105
"2368",1966-06-25,192,329,0,137
"2369",1966-06-26,214,335,0,121
"2370",1966-06-27,219,330,37,111
"2371",1966-06-28,199,236,261,37
"2372",1966-06-29,193,245,2,52
"2373",1966-06-30,179,264,8,85
"2374",1966-07-01,172,296,0,124
"2375",1966-07-02,195,358,0,163
"2376",1966-07-03,223,338,0,115
"2377",1966-07-04,228,299,1,71
"2378",1966-07-05,196,270,99,74
"2379",1966-07-06,193,231,83,38
"2380",1966-07-07,208,320,0,112
"2381",1966-07-08,186,359,0,173
"2382",1966-07-09,242,342,0,100
"2383",1966-07-10,224,364,0,140
"2384",1966-07-11,211,338,0,127
"2385",1966-07-12,226,351,0,125
"2386",1966-07-13,238,350,0,112
"2387",1966-07-14,253,364,39,111
"2388",1966-07-15,271,370,0,99
"2389",1966-07-16,284,384,0,100
"2390",1966-07-17,295,400,0,105
"2391",1966-07-18,291,417,0,126
"2392",1966-07-19,304,430,0,126
"2393",1966-07-20,250,379,0,129
"2394",1966-07-21,219,291,224,72
"2395",1966-07-22,215,252,883,37
"2396",1966-07-23,210,266,114,56
"2397",1966-07-24,230,316,0,86
"2398",1966-07-25,251,300,21,49
"2399",1966-07-26,227,300,1,73
"2400",1966-07-27,241,303,64,62
"2401",1966-07-28,247,337,0,90
"2402",1966-07-29,271,355,0,84
"2403",1966-07-30,272,366,5,94
"2404",1966-07-31,244,305,313,61
"2405",1966-08-01,259,345,0,86
"2406",1966-08-02,260,353,0,93
"2407",1966-08-03,274,365,0,91
"2408",1966-08-04,275,360,0,85
"2409",1966-08-05,268,374,0,106
"2410",1966-08-06,247,330,39,83
"2411",1966-08-07,264,356,0,92
"2412",1966-08-08,261,345,0,84
"2413",1966-08-09,258,377,0,119
"2414",1966-08-10,223,336,317,113
"2415",1966-08-11,237,327,0,90
"2416",1966-08-12,232,331,0,99
"2417",1966-08-13,252,338,0,86
"2418",1966-08-14,241,341,0,100
"2419",1966-08-15,236,346,0,110
"2420",1966-08-16,238,350,0,112
"2421",1966-08-17,259,330,0,71
"2422",1966-08-18,188,334,0,146
"2423",1966-08-19,188,315,0,127
"2424",1966-08-20,162,301,0,139
"2425",1966-08-21,179,291,0,112
"2426",1966-08-22,164,296,0,132
"2427",1966-08-23,187,229,114,42
"2428",1966-08-24,170,295,0,125
"2429",1966-08-25,212,271,128,59
"2430",1966-08-26,193,290,0,97
"2431",1966-08-27,220,321,7,101
"2432",1966-08-28,232,307,0,75
"2433",1966-08-29,241,360,0,119
"2434",1966-08-30,237,367,0,130
"2435",1966-08-31,245,339,0,94
"2436",1966-09-01,165,247,0,82
"2437",1966-09-02,176,220,0,44
"2438",1966-09-03,159,203,3,44
"2439",1966-09-04,160,264,1,104
"2440",1966-09-05,137,277,0,140
"2441",1966-09-06,139,291,0,152
"2442",1966-09-07,142,280,0,138
"2443",1966-09-08,174,262,0,88
"2444",1966-09-09,110,271,0,161
"2445",1966-09-10,135,291,0,156
"2446",1966-09-11,153,240,0,87
"2447",1966-09-12,169,259,0,90
"2448",1966-09-13,188,260,0,72
"2449",1966-09-14,184,244,2,60
"2450",1966-09-15,162,262,0,100
"2451",1966-09-16,122,282,0,160
"2452",1966-09-17,115,288,0,173
"2453",1966-09-18,100,286,0,186
"2454",1966-09-19,150,275,0,125
"2455",1966-09-20,174,249,1,75
"2456",1966-09-21,177,252,10,75
"2457",1966-09-22,151,257,0,106
"2458",1966-09-23,89,286,0,197
"2459",1966-09-24,99,299,0,200
"2460",1966-09-25,101,294,0,193
"2461",1966-09-26,113,314,0,201
"2462",1966-09-27,128,305,0,177
"2463",1966-09-28,116,308,0,192
"2464",1966-09-29,113,320,0,207
"2465",1966-09-30,112,312,0,200
"2466",1966-10-01,144,326,0,182
"2467",1966-10-02,107,315,0,208
"2468",1966-10-03,142,231,0,89
"2469",1966-10-04,148,184,0,36
"2470",1966-10-05,125,154,25,29
"2471",1966-10-06,127,150,135,23
"2472",1966-10-07,113,195,0,82
"2473",1966-10-08,150,202,1,52
"2474",1966-10-09,150,227,0,77
"2475",1966-10-10,153,229,3,76
"2476",1966-10-11,124,274,0,150
"2477",1966-10-12,106,260,0,154
"2478",1966-10-13,146,231,0,85
"2479",1966-10-14,60,214,0,154
"2480",1966-10-15,75,231,0,156
"2481",1966-10-16,45,253,0,208
"2482",1966-10-17,62,247,0,185
"2483",1966-10-18,54,241,0,187
"2484",1966-10-19,48,253,0,205
"2485",1966-10-20,64,265,0,201
"2486",1966-10-21,67,229,0,162
"2487",1966-10-22,69,236,0,167
"2488",1966-10-23,120,156,3,36
"2489",1966-10-24,133,192,0,59
"2490",1966-10-25,84,217,0,133
"2491",1966-10-26,75,224,0,149
"2492",1966-10-27,69,175,0,106
"2493",1966-10-28,32,175,0,143
"2494",1966-10-29,30,214,0,184
"2495",1966-10-30,79,227,0,148
"2496",1966-10-31,116,221,0,105
"2497",1966-11-01,64,221,0,157
"2498",1966-11-02,25,224,0,199
"2499",1966-11-03,20,172,0,152
"2500",1966-11-04,25,240,0,215
"2501",1966-11-05,43,164,0,121
"2502",1966-11-06,32,198,0,166
"2503",1966-11-07,26,251,0,225
"2504",1966-11-08,35,199,0,164
"2505",1966-11-09,63,187,0,124
"2506",1966-11-10,14,201,0,187
"2507",1966-11-11,96,161,39,65
"2508",1966-11-12,101,114,102,13
"2509",1966-11-13,81,110,53,29
"2510",1966-11-14,40,126,0,86
"2511",1966-11-15,6,150,0,144
"2512",1966-11-16,24,166,0,142
"2513",1966-11-17,49,130,0,81
"2514",1966-11-18,-4,180,0,184
"2515",1966-11-19,7,161,0,154
"2516",1966-11-20,31,101,0,70
"2517",1966-11-21,-51,119,0,170
"2518",1966-11-22,-11,148,0,159
"2519",1966-11-23,20,182,0,162
"2520",1966-11-24,33,147,0,114
"2521",1966-11-25,0,101,0,101
"2522",1966-11-26,-21,128,0,149
"2523",1966-11-27,12,166,0,154
"2524",1966-11-28,40,153,0,113
"2525",1966-11-29,-15,110,0,125
"2526",1966-11-30,-59,37,0,96
"2527",1966-12-01,-48,21,0,69
"2528",1966-12-02,-40,62,0,102
"2529",1966-12-03,-68,154,0,222
"2530",1966-12-04,-48,104,0,152
"2531",1966-12-05,-23,60,0,83
"2532",1966-12-06,-59,80,0,139
"2533",1966-12-07,-51,128,0,179
"2534",1966-12-08,-24,90,0,114
"2535",1966-12-09,-60,129,0,189
"2536",1966-12-10,-41,148,0,189
"2537",1966-12-11,-16,150,0,166
"2538",1966-12-12,-44,85,0,129
"2539",1966-12-13,-39,25,0,64
"2540",1966-12-14,-4,26,19,30
"2541",1966-12-15,-3,93,0,96
"2542",1966-12-16,-41,80,0,121
"2543",1966-12-17,6,41,0,35
"2544",1966-12-18,23,63,5,40
"2545",1966-12-19,24,47,1,23
"2546",1966-12-20,-21,29,5,50
"2547",1966-12-21,-35,-20,0,15
"2548",1966-12-22,-50,-28,0,22
"2549",1966-12-23,-35,-16,0,19
"2550",1966-12-24,-50,-20,0,30
"2551",1966-12-25,-66,-4,0,62
"2552",1966-12-26,-84,-14,0,70
"2553",1966-12-27,-124,-7,0,117
"2554",1966-12-28,-116,-22,0,94
"2555",1966-12-29,-124,-22,0,102
"2556",1966-12-30,-38,-12,0,26
"2557",1966-12-31,-95,13,0,108
"2558",1967-01-01,-73,39,0,112
"2559",1967-01-02,-49,25,0,74
"2560",1967-01-03,-59,16,0,75
"2561",1967-01-04,-47,45,0,92
"2562",1967-01-05,-36,29,0,65
"2563",1967-01-06,-90,109,0,199
"2564",1967-01-07,-37,14,0,51
"2565",1967-01-08,-117,18,0,135
"2566",1967-01-09,-92,25,0,117
"2567",1967-01-10,-52,64,0,116
"2568",1967-01-11,-13,56,0,69
"2569",1967-01-12,-31,98,0,129
"2570",1967-01-13,-63,37,0,100
"2571",1967-01-14,-69,-3,0,66
"2572",1967-01-15,-158,-18,0,140
"2573",1967-01-16,-98,72,0,170
"2574",1967-01-17,-114,67,0,181
"2575",1967-01-18,-85,117,0,202
"2576",1967-01-19,-40,106,0,146
"2577",1967-01-20,-66,122,0,188
"2578",1967-01-21,-34,176,0,210
"2579",1967-01-22,1,97,0,96
"2580",1967-01-23,-31,107,0,138
"2581",1967-01-24,-29,159,0,188
"2582",1967-01-25,-56,143,0,199
"2583",1967-01-26,-12,67,66,79
"2584",1967-01-27,5,51,58,46
"2585",1967-01-28,-12,63,0,75
"2586",1967-01-29,-24,32,0,56
"2587",1967-01-30,-37,16,0,53
"2588",1967-01-31,-37,44,0,81
"2589",1967-02-01,-32,56,0,88
"2590",1967-02-02,-41,66,0,107
"2591",1967-02-03,-52,115,0,167
"2592",1967-02-04,-37,145,0,182
"2593",1967-02-05,-41,111,0,152
"2594",1967-02-06,6,84,0,78
"2595",1967-02-07,10,66,0,56
"2596",1967-02-08,-25,26,6,51
"2597",1967-02-09,-23,8,30,31
"2598",1967-02-10,-41,-2,0,39
"2599",1967-02-11,-30,36,0,66
"2600",1967-02-12,-43,29,0,72
"2601",1967-02-13,-27,5,10,32
"2602",1967-02-14,-35,54,0,89
"2603",1967-02-15,-58,86,0,144
"2604",1967-02-16,-37,110,0,147
"2605",1967-02-17,-35,67,0,102
"2606",1967-02-18,2,27,0,25
"2607",1967-02-19,20,39,3,19
"2608",1967-02-20,18,65,32,47
"2609",1967-02-21,11,38,190,27
"2610",1967-02-22,-10,59,7,69
"2611",1967-02-23,-2,39,0,41
"2612",1967-02-24,-14,76,0,90
"2613",1967-02-25,-15,80,0,95
"2614",1967-02-26,-24,120,0,144
"2615",1967-02-27,-36,124,0,160
"2616",1967-02-28,-5,154,0,159
"2617",1967-03-01,12,184,0,172
"2618",1967-03-02,50,192,0,142
"2619",1967-03-03,87,135,0,48
"2620",1967-03-04,-22,89,11,111
"2621",1967-03-05,-36,61,0,97
"2622",1967-03-06,-40,92,0,132
"2623",1967-03-07,-34,120,0,154
"2624",1967-03-08,23,110,0,87
"2625",1967-03-09,27,118,1,91
"2626",1967-03-10,-17,190,0,207
"2627",1967-03-11,39,185,0,146
"2628",1967-03-12,-12,182,0,194
"2629",1967-03-13,20,177,0,157
"2630",1967-03-14,61,125,14,64
"2631",1967-03-15,67,92,15,25
"2632",1967-03-16,50,81,160,31
"2633",1967-03-17,40,120,140,80
"2634",1967-03-18,36,129,0,93
"2635",1967-03-19,46,167,0,121
"2636",1967-03-20,79,142,14,63
"2637",1967-03-21,41,194,0,153
"2638",1967-03-22,20,121,0,101
"2639",1967-03-23,28,159,0,131
"2640",1967-03-24,10,175,0,165
"2641",1967-03-25,36,192,0,156
"2642",1967-03-26,105,184,1,79
"2643",1967-03-27,85,204,0,119
"2644",1967-03-28,70,143,95,73
"2645",1967-03-29,45,81,182,36
"2646",1967-03-30,23,185,1,162
"2647",1967-03-31,76,240,0,164
"2648",1967-04-01,79,231,0,152
"2649",1967-04-02,98,244,0,146
"2650",1967-04-03,109,196,30,87
"2651",1967-04-04,33,203,0,170
"2652",1967-04-05,36,222,0,186
"2653",1967-04-06,92,170,0,78
"2654",1967-04-07,46,135,23,89
"2655",1967-04-08,51,176,4,125
"2656",1967-04-09,64,170,55,106
"2657",1967-04-10,79,131,115,52
"2658",1967-04-11,43,130,2,87
"2659",1967-04-12,75,177,0,102
"2660",1967-04-13,62,200,0,138
"2661",1967-04-14,91,154,11,63
"2662",1967-04-15,75,110,81,35
"2663",1967-04-16,62,140,0,78
"2664",1967-04-17,99,152,8,53
"2665",1967-04-18,106,177,0,71
"2666",1967-04-19,67,226,0,159
"2667",1967-04-20,131,215,0,84
"2668",1967-04-21,126,180,155,54
"2669",1967-04-22,116,178,36,62
"2670",1967-04-23,85,229,0,144
"2671",1967-04-24,65,234,0,169
"2672",1967-04-25,74,224,0,150
"2673",1967-04-26,137,269,0,132
"2674",1967-04-27,89,285,0,196
"2675",1967-04-28,171,274,0,103
"2676",1967-04-29,199,331,0,132
"2677",1967-04-30,204,310,0,106
"2678",1967-05-01,122,294,0,172
"2679",1967-05-02,138,295,0,157
"2680",1967-05-03,165,274,0,109
"2681",1967-05-04,168,235,2,67
"2682",1967-05-05,151,194,3,43
"2683",1967-05-06,131,262,0,131
"2684",1967-05-07,164,253,9,89
"2685",1967-05-08,173,296,0,123
"2686",1967-05-09,125,307,0,182
"2687",1967-05-10,140,310,0,170
"2688",1967-05-11,168,313,0,145
"2689",1967-05-12,149,307,0,158
"2690",1967-05-13,142,291,0,149
"2691",1967-05-14,127,303,0,176
"2692",1967-05-15,134,314,0,180
"2693",1967-05-16,157,329,0,172
"2694",1967-05-17,151,282,0,131
"2695",1967-05-18,165,251,129,86
"2696",1967-05-19,159,220,8,61
"2697",1967-05-20,181,232,1,51
"2698",1967-05-21,172,281,0,109
"2699",1967-05-22,178,335,0,157
"2700",1967-05-23,200,374,0,174
"2701",1967-05-24,179,357,0,178
"2702",1967-05-25,212,330,0,118
"2703",1967-05-26,150,357,0,207
"2704",1967-05-27,146,371,0,225
"2705",1967-05-28,235,322,0,87
"2706",1967-05-29,195,335,0,140
"2707",1967-05-30,212,347,0,135
"2708",1967-05-31,218,408,0,190
"2709",1967-06-01,214,307,0,93
"2710",1967-06-02,200,351,0,151
"2711",1967-06-03,197,357,0,160
"2712",1967-06-04,219,423,0,204
"2713",1967-06-05,211,376,0,165
"2714",1967-06-06,221,420,0,199
"2715",1967-06-07,191,332,0,141
"2716",1967-06-08,156,320,0,164
"2717",1967-06-09,163,330,0,167
"2718",1967-06-10,205,379,0,174
"2719",1967-06-11,198,362,0,164
"2720",1967-06-12,185,371,0,186
"2721",1967-06-13,225,335,2,110
"2722",1967-06-14,203,352,28,149
"2723",1967-06-15,204,352,0,148
"2724",1967-06-16,240,383,0,143
"2725",1967-06-17,245,358,0,113
"2726",1967-06-18,218,380,0,162
"2727",1967-06-19,244,319,0,75
"2728",1967-06-20,232,318,0,86
"2729",1967-06-21,222,286,15,64
"2730",1967-06-22,183,313,0,130
"2731",1967-06-23,202,327,0,125
"2732",1967-06-24,231,375,0,144
"2733",1967-06-25,217,386,0,169
"2734",1967-06-26,195,311,24,116
"2735",1967-06-27,195,290,4,95
"2736",1967-06-28,207,344,0,137
"2737",1967-06-29,210,317,0,107
"2738",1967-06-30,188,287,522,99
"2739",1967-07-01,190,281,220,91
"2740",1967-07-02,219,341,0,122
"2741",1967-07-03,206,327,0,121
"2742",1967-07-04,195,272,42,77
"2743",1967-07-05,177,314,0,137
"2744",1967-07-06,210,297,0,87
"2745",1967-07-07,221,330,0,109
"2746",1967-07-08,215,330,0,115
"2747",1967-07-09,215,307,0,92
"2748",1967-07-10,223,268,140,45
"2749",1967-07-11,219,254,1128,35
"2750",1967-07-12,225,260,14,35
"2751",1967-07-13,234,345,1,111
"2752",1967-07-14,252,374,0,122
"2753",1967-07-15,257,366,0,109
"2754",1967-07-16,276,367,0,91
"2755",1967-07-17,268,346,0,78
"2756",1967-07-18,285,363,0,78
"2757",1967-07-19,272,369,0,97
"2758",1967-07-20,252,325,0,73
"2759",1967-07-21,237,340,0,103
"2760",1967-07-22,234,322,0,88
"2761",1967-07-23,247,297,27,50
"2762",1967-07-24,236,277,125,41
"2763",1967-07-25,234,320,0,86
"2764",1967-07-26,235,318,161,83
"2765",1967-07-27,241,316,144,75
"2766",1967-07-28,254,324,2,70
"2767",1967-07-29,245,322,0,77
"2768",1967-07-30,250,345,0,95
"2769",1967-07-31,260,352,0,92
"2770",1967-08-01,268,358,0,90
"2771",1967-08-02,270,361,0,91
"2772",1967-08-03,270,348,0,78
"2773",1967-08-04,261,361,0,100
"2774",1967-08-05,259,340,0,81
"2775",1967-08-06,245,360,0,115
"2776",1967-08-07,254,374,0,120
"2777",1967-08-08,265,390,0,125
"2778",1967-08-09,275,366,0,91
"2779",1967-08-10,257,357,0,100
"2780",1967-08-11,202,301,0,99
"2781",1967-08-12,208,303,0,95
"2782",1967-08-13,225,310,5,85
"2783",1967-08-14,250,310,0,60
"2784",1967-08-15,227,290,0,63
"2785",1967-08-16,208,303,0,95
"2786",1967-08-17,223,270,561,47
"2787",1967-08-18,220,255,374,35
"2788",1967-08-19,230,283,0,53
"2789",1967-08-20,250,340,1,90
"2790",1967-08-21,254,350,0,96
"2791",1967-08-22,265,344,0,79
"2792",1967-08-23,245,297,0,52
"2793",1967-08-24,222,301,0,79
"2794",1967-08-25,244,349,105,105
"2795",1967-08-26,260,352,0,92
"2796",1967-08-27,261,360,0,99
"2797",1967-08-28,256,365,13,109
"2798",1967-08-29,257,312,4,55
"2799",1967-08-30,231,346,0,115
"2800",1967-08-31,218,296,0,78
"2801",1967-09-01,217,300,11,83
"2802",1967-09-02,208,272,474,64
"2803",1967-09-03,185,220,0,35
"2804",1967-09-04,160,237,14,77
"2805",1967-09-05,199,287,0,88
"2806",1967-09-06,235,307,0,72
"2807",1967-09-07,206,270,0,64
"2808",1967-09-08,212,296,0,84
"2809",1967-09-09,154,270,361,116
"2810",1967-09-10,120,200,36,80
"2811",1967-09-11,95,248,0,153
"2812",1967-09-12,106,260,0,154
"2813",1967-09-13,134,240,0,106
"2814",1967-09-14,137,248,0,111
"2815",1967-09-15,121,230,3,109
"2816",1967-09-16,126,247,0,121
"2817",1967-09-17,133,260,0,127
"2818",1967-09-18,142,225,0,83
"2819",1967-09-19,153,280,0,127
"2820",1967-09-20,139,281,0,142
"2821",1967-09-21,128,298,0,170
"2822",1967-09-22,149,252,0,103
"2823",1967-09-23,136,265,0,129
"2824",1967-09-24,113,274,0,161
"2825",1967-09-25,126,275,0,149
"2826",1967-09-26,162,261,0,99
"2827",1967-09-27,138,246,0,108
"2828",1967-09-28,136,207,4,71
"2829",1967-09-29,98,141,600,43
"2830",1967-09-30,97,154,25,57
"2831",1967-10-01,104,195,0,91
"2832",1967-10-02,73,212,0,139
"2833",1967-10-03,68,217,0,149
"2834",1967-10-04,89,249,0,160
"2835",1967-10-05,99,267,0,168
"2836",1967-10-06,111,263,0,152
"2837",1967-10-07,85,250,0,165
"2838",1967-10-08,118,294,0,176
"2839",1967-10-09,96,240,0,144
"2840",1967-10-10,106,230,0,124
"2841",1967-10-11,148,201,60,53
"2842",1967-10-12,110,211,0,101
"2843",1967-10-13,136,226,0,90
"2844",1967-10-14,82,164,0,82
"2845",1967-10-15,44,175,0,131
"2846",1967-10-16,92,210,0,118
"2847",1967-10-17,61,211,0,150
"2848",1967-10-18,49,228,0,179
"2849",1967-10-19,32,230,0,198
"2850",1967-10-20,68,267,0,199
"2851",1967-10-21,110,249,0,139
"2852",1967-10-22,85,250,0,165
"2853",1967-10-23,61,267,0,206
"2854",1967-10-24,75,210,0,135
"2855",1967-10-25,94,197,0,103
"2856",1967-10-26,68,233,0,165
"2857",1967-10-27,85,223,0,138
"2858",1967-10-28,92,250,0,158
"2859",1967-10-29,98,247,0,149
"2860",1967-10-30,107,166,0,59
"2861",1967-10-31,77,119,17,42
"2862",1967-11-01,76,155,0,79
"2863",1967-11-02,86,123,0,37
"2864",1967-11-03,60,137,0,77
"2865",1967-11-04,35,159,0,124
"2866",1967-11-05,15,200,0,185
"2867",1967-11-06,16,211,0,195
"2868",1967-11-07,62,220,0,158
"2869",1967-11-08,92,166,0,74
"2870",1967-11-09,2,95,114,93
"2871",1967-11-10,0,30,30,30
"2872",1967-11-11,1,116,14,115
"2873",1967-11-12,-29,85,0,114
"2874",1967-11-13,-17,123,0,140
"2875",1967-11-14,12,162,0,150
"2876",1967-11-15,-4,97,0,101
"2877",1967-11-16,-7,135,0,142
"2878",1967-11-17,77,146,0,69
"2879",1967-11-18,46,169,0,123
"2880",1967-11-19,30,95,100,65
"2881",1967-11-20,2,36,0,34
"2882",1967-11-21,-5,28,0,33
"2883",1967-11-22,-3,21,150,24
"2884",1967-11-23,-3,15,10,18
"2885",1967-11-24,5,32,74,27
"2886",1967-11-25,3,42,35,39
"2887",1967-11-26,10,39,1,29
"2888",1967-11-27,-7,24,180,31
"2889",1967-11-28,-43,41,0,84
"2890",1967-11-29,-6,43,0,49
"2891",1967-11-30,-37,24,0,61
"2892",1967-12-01,-56,51,0,107
"2893",1967-12-02,-43,57,0,100
"2894",1967-12-03,-36,69,0,105
"2895",1967-12-04,-35,47,0,82
"2896",1967-12-05,-38,40,0,78
"2897",1967-12-06,-40,33,0,73
"2898",1967-12-07,-48,14,0,62
"2899",1967-12-08,-78,67,0,145
"2900",1967-12-09,-76,25,0,101
"2901",1967-12-10,-55,10,0,65
"2902",1967-12-11,-82,37,0,119
"2903",1967-12-12,-45,44,0,89
"2904",1967-12-13,-12,89,0,101
"2905",1967-12-14,-62,47,0,109
"2906",1967-12-15,-91,84,0,175
"2907",1967-12-16,-26,94,0,120
"2908",1967-12-17,-62,62,0,124
"2909",1967-12-18,-61,79,0,140
"2910",1967-12-19,-38,86,0,124
"2911",1967-12-20,-61,32,0,93
"2912",1967-12-21,-85,30,0,115
"2913",1967-12-22,-70,36,0,106
"2914",1967-12-23,-86,29,0,115
"2915",1967-12-24,-70,27,0,97
"2916",1967-12-25,-47,23,0,70
"2917",1967-12-26,-98,27,0,125
"2918",1967-12-27,-93,16,0,109
"2919",1967-12-28,-102,-4,0,98
"2920",1967-12-29,-89,10,0,99
"2921",1967-12-30,-108,77,0,185
"2922",1967-12-31,-56,85,0,141
"2923",1968-01-01,-60,112,0,172
"2924",1968-01-02,-41,98,0,139
"2925",1968-01-03,-62,123,0,185
"2926",1968-01-04,-72,151,0,223
"2927",1968-01-05,-54,143,0,197
"2928",1968-01-06,-50,134,0,184
"2929",1968-01-07,-41,60,0,101
"2930",1968-01-08,-91,49,0,140
"2931",1968-01-09,-25,21,0,46
"2932",1968-01-10,-73,89,4,162
"2933",1968-01-11,-11,136,0,147
"2934",1968-01-12,-34,100,0,134
"2935",1968-01-13,-56,80,0,136
"2936",1968-01-14,-58,29,0,87
"2937",1968-01-15,-64,68,0,132
"2938",1968-01-16,-50,123,0,173
"2939",1968-01-17,-28,106,0,134
"2940",1968-01-18,-30,24,2,54
"2941",1968-01-19,-50,-22,20,28
"2942",1968-01-20,-51,-16,0,35
"2943",1968-01-21,-48,4,0,52
"2944",1968-01-22,-41,-15,26,26
"2945",1968-01-23,-86,-10,4,76
"2946",1968-01-24,-93,-27,0,66
"2947",1968-01-25,-35,-18,0,17
"2948",1968-01-26,-22,-1,0,21
"2949",1968-01-27,-28,-2,13,26
"2950",1968-01-28,-18,12,0,30
"2951",1968-01-29,-18,4,0,22
"2952",1968-01-30,-29,16,0,45
"2953",1968-01-31,-59,15,0,74
"2954",1968-02-01,-36,-2,0,34
"2955",1968-02-02,-76,54,0,130
"2956",1968-02-03,-66,43,0,109
"2957",1968-02-04,-60,0,0,60
"2958",1968-02-05,-51,20,0,71
"2959",1968-02-06,-50,10,0,60
"2960",1968-02-07,-78,36,0,114
"2961",1968-02-08,-83,24,0,107
"2962",1968-02-09,-72,33,0,105
"2963",1968-02-10,-28,50,0,78
"2964",1968-02-11,-71,44,0,115
"2965",1968-02-12,-29,101,0,130
"2966",1968-02-13,-36,69,0,105
"2967",1968-02-14,-70,72,0,142
"2968",1968-02-15,-53,130,0,183
"2969",1968-02-16,-37,106,0,143
"2970",1968-02-17,-37,63,0,100
"2971",1968-02-18,-52,54,0,106
"2972",1968-02-19,-82,33,0,115
"2973",1968-02-20,-98,60,0,158
"2974",1968-02-21,-97,92,0,189
"2975",1968-02-22,-99,75,0,174
"2976",1968-02-23,-77,47,0,124
"2977",1968-02-24,-79,81,0,160
"2978",1968-02-25,-37,120,0,157
"2979",1968-02-26,-11,167,0,178
"2980",1968-02-27,17,157,0,140
"2981",1968-02-28,9,77,0,68
"2982",1968-02-29,-40,96,0,136
"2983",1968-03-01,-30,86,0,116
"2984",1968-03-02,-54,172,0,226
"2985",1968-03-03,-35,200,0,235
"2986",1968-03-04,50,230,0,180
"2987",1968-03-05,10,145,0,135
"2988",1968-03-06,71,126,0,55
"2989",1968-03-07,60,107,0,47
"2990",1968-03-08,-1,139,0,140
"2991",1968-03-09,-2,148,0,150
"2992",1968-03-10,-10,144,0,154
"2993",1968-03-11,1,134,0,133
"2994",1968-03-12,-45,190,0,235
"2995",1968-03-13,-3,160,0,163
"2996",1968-03-14,-30,185,0,215
"2997",1968-03-15,21,211,0,190
"2998",1968-03-16,22,140,0,118
"2999",1968-03-17,28,168,0,140
"3000",1968-03-18,20,203,0,183
"3001",1968-03-19,68,211,0,143
"3002",1968-03-20,84,182,0,98
"3003",1968-03-21,87,181,0,94
"3004",1968-03-22,78,141,0,63
"3005",1968-03-23,61,146,0,85
"3006",1968-03-24,45,114,0,69
"3007",1968-03-25,-25,147,0,172
"3008",1968-03-26,30,191,0,161
"3009",1968-03-27,15,210,0,195
"3010",1968-03-28,57,143,13,86
"3011",1968-03-29,53,213,4,160
"3012",1968-03-30,36,230,0,194
"3013",1968-03-31,70,222,0,152
"3014",1968-04-01,42,191,0,149
"3015",1968-04-02,75,220,0,145
"3016",1968-04-03,58,266,0,208
"3017",1968-04-04,94,207,0,113
"3018",1968-04-05,38,280,0,242
"3019",1968-04-06,140,285,0,145
"3020",1968-04-07,155,245,0,90
"3021",1968-04-08,135,189,0,54
"3022",1968-04-09,54,144,83,90
"3023",1968-04-10,26,166,44,140
"3024",1968-04-11,62,190,0,128
"3025",1968-04-12,3,207,0,204
"3026",1968-04-13,90,210,0,120
"3027",1968-04-14,65,245,0,180
"3028",1968-04-15,138,227,0,89
"3029",1968-04-16,103,178,0,75
"3030",1968-04-17,109,202,0,93
"3031",1968-04-18,74,216,0,142
"3032",1968-04-19,98,217,0,119
"3033",1968-04-20,100,241,0,141
"3034",1968-04-21,98,255,0,157
"3035",1968-04-22,153,240,0,87
"3036",1968-04-23,106,281,0,175
"3037",1968-04-24,77,241,49,164
"3038",1968-04-25,75,179,30,104
"3039",1968-04-26,46,233,0,187
"3040",1968-04-27,76,245,0,169
"3041",1968-04-28,104,281,0,177
"3042",1968-04-29,126,306,0,180
"3043",1968-04-30,164,292,0,128
"3044",1968-05-01,141,263,3,122
"3045",1968-05-02,80,291,0,211
"3046",1968-05-03,131,266,36,135
"3047",1968-05-04,146,256,22,110
"3048",1968-05-05,125,217,0,92
"3049",1968-05-06,80,132,93,52
"3050",1968-05-07,86,112,74,26
"3051",1968-05-08,89,208,4,119
"3052",1968-05-09,130,198,0,68
"3053",1968-05-10,124,230,0,106
"3054",1968-05-11,108,255,0,147
"3055",1968-05-12,186,272,0,86
"3056",1968-05-13,95,323,0,228
"3057",1968-05-14,125,352,0,227
"3058",1968-05-15,181,320,0,139
"3059",1968-05-16,185,310,0,125
"3060",1968-05-17,162,325,0,163
"3061",1968-05-18,174,315,0,141
"3062",1968-05-19,183,318,18,135
"3063",1968-05-20,174,329,0,155
"3064",1968-05-21,200,350,0,150
"3065",1968-05-22,182,283,0,101
"3066",1968-05-23,157,268,0,111
"3067",1968-05-24,151,277,0,126
"3068",1968-05-25,117,328,0,211
"3069",1968-05-26,134,307,0,173
"3070",1968-05-27,120,275,0,155
"3071",1968-05-28,126,320,0,194
"3072",1968-05-29,126,330,0,204
"3073",1968-05-30,124,332,0,208
"3074",1968-05-31,139,362,0,223
"3075",1968-06-01,175,328,0,153
"3076",1968-06-02,147,360,0,213
"3077",1968-06-03,182,387,0,205
"3078",1968-06-04,217,385,0,168
"3079",1968-06-05,208,390,0,182
"3080",1968-06-06,220,381,0,161
"3081",1968-06-07,252,340,0,88
"3082",1968-06-08,210,324,0,114
"3083",1968-06-09,184,311,0,127
"3084",1968-06-10,188,385,0,197
"3085",1968-06-11,167,405,0,238
"3086",1968-06-12,220,346,0,126
"3087",1968-06-13,194,360,0,166
"3088",1968-06-14,250,331,0,81
"3089",1968-06-15,159,345,0,186
"3090",1968-06-16,199,365,0,166
"3091",1968-06-17,194,382,0,188
"3092",1968-06-18,196,377,0,181
"3093",1968-06-19,235,303,0,68
"3094",1968-06-20,185,287,2,102
"3095",1968-06-21,198,316,0,118
"3096",1968-06-22,174,330,0,156
"3097",1968-06-23,205,330,0,125
"3098",1968-06-24,210,337,0,127
"3099",1968-06-25,207,325,0,118
"3100",1968-06-26,230,295,58,65
"3101",1968-06-27,186,361,0,175
"3102",1968-06-28,224,364,0,140
"3103",1968-06-29,257,356,0,99
"3104",1968-06-30,244,362,1,118
"3105",1968-07-01,238,345,0,107
"3106",1968-07-02,226,376,0,150
"3107",1968-07-03,251,343,0,92
"3108",1968-07-04,202,279,0,77
"3109",1968-07-05,171,356,0,185
"3110",1968-07-06,225,380,0,155
"3111",1968-07-07,210,299,20,89
"3112",1968-07-08,210,310,10,100
"3113",1968-07-09,194,310,0,116
"3114",1968-07-10,192,338,0,146
"3115",1968-07-11,217,351,0,134
"3116",1968-07-12,218,319,250,101
"3117",1968-07-13,207,257,17,50
"3118",1968-07-14,226,307,0,81
"3119",1968-07-15,233,299,0,66
"3120",1968-07-16,221,341,5,120
"3121",1968-07-17,230,345,0,115
"3122",1968-07-18,228,356,0,128
"3123",1968-07-19,226,325,17,99
"3124",1968-07-20,235,299,13,64
"3125",1968-07-21,235,267,159,32
"3126",1968-07-22,227,336,2,109
"3127",1968-07-23,251,355,0,104
"3128",1968-07-24,268,364,0,96
"3129",1968-07-25,251,370,0,119
"3130",1968-07-26,215,360,0,145
"3131",1968-07-27,222,357,0,135
"3132",1968-07-28,214,372,0,158
"3133",1968-07-29,227,329,3,102
"3134",1968-07-30,207,347,0,140
"3135",1968-07-31,226,379,122,153
"3136",1968-08-01,213,357,65,144
"3137",1968-08-02,240,342,0,102
"3138",1968-08-03,209,345,0,136
"3139",1968-08-04,233,345,0,112
"3140",1968-08-05,225,334,0,109
"3141",1968-08-06,206,274,66,68
"3142",1968-08-07,181,304,0,123
"3143",1968-08-08,175,317,0,142
"3144",1968-08-09,186,277,1,91
"3145",1968-08-10,200,264,0,64
"3146",1968-08-11,211,242,277,31
"3147",1968-08-12,186,238,158,52
"3148",1968-08-13,205,272,0,67
"3149",1968-08-14,205,300,0,95
"3150",1968-08-15,186,295,0,109
"3151",1968-08-16,213,332,0,119
"3152",1968-08-17,229,346,0,117
"3153",1968-08-18,245,327,19,82
"3154",1968-08-19,246,305,9,59
"3155",1968-08-20,218,324,1,106
"3156",1968-08-21,213,321,0,108
"3157",1968-08-22,206,269,11,63
"3158",1968-08-23,172,316,0,144
"3159",1968-08-24,200,309,14,109
"3160",1968-08-25,183,233,221,50
"3161",1968-08-26,197,284,17,87
"3162",1968-08-27,211,285,0,74
"3163",1968-08-28,206,290,8,84
"3164",1968-08-29,180,318,0,138
"3165",1968-08-30,183,304,0,121
"3166",1968-08-31,146,285,0,139
"3167",1968-09-01,187,283,0,96
"3168",1968-09-02,190,287,1,97
"3169",1968-09-03,185,295,1,110
"3170",1968-09-04,180,307,0,127
"3171",1968-09-05,175,317,0,142
"3172",1968-09-06,210,292,0,82
"3173",1968-09-07,204,255,1,51
"3174",1968-09-08,194,225,166,31
"3175",1968-09-09,193,270,46,77
"3176",1968-09-10,206,265,33,59
"3177",1968-09-11,190,230,172,40
"3178",1968-09-12,185,231,56,46
"3179",1968-09-13,190,275,0,85
"3180",1968-09-14,170,284,0,114
"3181",1968-09-15,170,284,1,114
"3182",1968-09-16,174,292,0,118
"3183",1968-09-17,187,283,18,96
"3184",1968-09-18,180,223,214,43
"3185",1968-09-19,165,211,119,46
"3186",1968-09-20,135,233,0,98
"3187",1968-09-21,127,203,0,76
"3188",1968-09-22,112,272,0,160
"3189",1968-09-23,122,279,0,157
"3190",1968-09-24,162,274,0,112
"3191",1968-09-25,132,288,0,156
"3192",1968-09-26,124,264,0,140
"3193",1968-09-27,181,275,9,94
"3194",1968-09-28,107,197,0,90
"3195",1968-09-29,50,240,0,190
"3196",1968-09-30,84,239,0,155
"3197",1968-10-01,105,245,0,140
"3198",1968-10-02,147,270,0,123
"3199",1968-10-03,102,283,0,181
"3200",1968-10-04,142,265,0,123
"3201",1968-10-05,158,265,0,107
"3202",1968-10-06,119,236,83,117
"3203",1968-10-07,93,124,145,31
"3204",1968-10-08,80,99,177,19
"3205",1968-10-09,90,141,61,51
"3206",1968-10-10,89,133,54,44
"3207",1968-10-11,75,105,103,30
"3208",1968-10-12,70,86,95,16
"3209",1968-10-13,49,165,0,116
"3210",1968-10-14,51,205,0,154
"3211",1968-10-15,75,289,0,214
"3212",1968-10-16,127,207,0,80
"3213",1968-10-17,76,163,0,87
"3214",1968-10-18,60,182,0,122
"3215",1968-10-19,47,205,0,158
"3216",1968-10-20,80,227,0,147
"3217",1968-10-21,83,243,0,160
"3218",1968-10-22,76,229,0,153
"3219",1968-10-23,104,183,0,79
"3220",1968-10-24,23,209,0,186
"3221",1968-10-25,7,207,0,200
"3222",1968-10-26,32,268,0,236
"3223",1968-10-27,84,214,0,130
"3224",1968-10-28,40,175,0,135
"3225",1968-10-29,45,200,0,155
"3226",1968-10-30,51,215,0,164
"3227",1968-10-31,91,177,7,86
"3228",1968-11-01,110,181,0,71
"3229",1968-11-02,97,207,0,110
"3230",1968-11-03,61,151,93,90
"3231",1968-11-04,39,123,0,84
"3232",1968-11-05,47,187,0,140
"3233",1968-11-06,57,225,0,168
"3234",1968-11-07,57,221,0,164
"3235",1968-11-08,23,121,0,98
"3236",1968-11-09,-63,40,0,103
"3237",1968-11-10,-30,89,0,119
"3238",1968-11-11,-23,130,0,153
"3239",1968-11-12,47,167,0,120
"3240",1968-11-13,14,123,0,109
"3241",1968-11-14,-12,151,0,163
"3242",1968-11-15,-13,165,0,178
"3243",1968-11-16,7,156,0,149
"3244",1968-11-17,36,190,0,154
"3245",1968-11-18,34,212,0,178
"3246",1968-11-19,43,148,0,105
"3247",1968-11-20,44,171,0,127
"3248",1968-11-21,54,145,0,91
"3249",1968-11-22,78,120,2,42
"3250",1968-11-23,92,206,0,114
"3251",1968-11-24,71,147,0,76
"3252",1968-11-25,105,137,0,32
"3253",1968-11-26,78,110,102,32
"3254",1968-11-27,26,116,0,90
"3255",1968-11-28,21,126,0,105
"3256",1968-11-29,-4,139,0,143
"3257",1968-11-30,36,205,0,169
"3258",1968-12-01,0,183,0,183
"3259",1968-12-02,8,195,0,187
"3260",1968-12-03,23,111,0,88
"3261",1968-12-04,83,151,0,68
"3262",1968-12-05,28,112,0,84
"3263",1968-12-06,51,135,0,84
"3264",1968-12-07,50,81,0,31
"3265",1968-12-08,57,106,53,49
"3266",1968-12-09,56,154,0,98
"3267",1968-12-10,57,92,2,35
"3268",1968-12-11,40,71,15,31
"3269",1968-12-12,2,44,0,42
"3270",1968-12-13,1,60,28,59
"3271",1968-12-14,-40,16,0,56
"3272",1968-12-15,-62,25,0,87
"3273",1968-12-16,-66,40,0,106
"3274",1968-12-17,-10,51,0,61
"3275",1968-12-18,-35,89,0,124
"3276",1968-12-19,0,55,0,55
"3277",1968-12-20,-9,68,0,77
"3278",1968-12-21,-26,56,0,82
"3279",1968-12-22,-45,77,0,122
"3280",1968-12-23,-51,123,0,174
"3281",1968-12-24,-43,126,0,169
"3282",1968-12-25,-20,95,0,115
"3283",1968-12-26,-30,66,0,96
"3284",1968-12-27,-24,80,0,104
"3285",1968-12-28,20,48,25,28
"3286",1968-12-29,-20,31,48,51
"3287",1968-12-30,-25,-5,12,20
"3288",1968-12-31,-64,-15,0,49
"3289",1969-01-01,-78,5,0,83
"3290",1969-01-02,-65,-5,0,60
"3291",1969-01-03,-109,-8,0,101
"3292",1969-01-04,-83,35,0,118
"3293",1969-01-05,-68,46,0,114
"3294",1969-01-06,-42,53,0,95
"3295",1969-01-07,-92,35,0,127
"3296",1969-01-08,-85,33,0,118
"3297",1969-01-09,-42,4,0,46
"3298",1969-01-10,-94,35,0,129
"3299",1969-01-11,-51,-5,0,46
"3300",1969-01-12,-110,36,0,146
"3301",1969-01-13,-104,57,0,161
"3302",1969-01-14,-97,43,0,140
"3303",1969-01-15,-111,48,0,159
"3304",1969-01-16,-54,83,0,137
"3305",1969-01-17,-46,135,0,181
"3306",1969-01-18,-47,133,0,180
"3307",1969-01-19,-40,92,0,132
"3308",1969-01-20,-10,13,0,23
"3309",1969-01-21,-54,50,0,104
"3310",1969-01-22,-12,110,0,122
"3311",1969-01-23,-7,33,0,40
"3312",1969-01-24,-52,12,27,64
"3313",1969-01-25,-134,-7,2,127
"3314",1969-01-26,-16,20,0,36
"3315",1969-01-27,-63,-10,47,53
"3316",1969-01-28,-86,-56,62,30
"3317",1969-01-29,-85,-45,0,40
"3318",1969-01-30,-83,-44,0,39
"3319",1969-01-31,-132,-37,0,95
"3320",1969-02-01,-101,-11,0,90
"3321",1969-02-02,-82,-24,1,58
"3322",1969-02-03,-124,3,34,127
"3323",1969-02-04,-62,-7,0,55
"3324",1969-02-05,-90,28,0,118
"3325",1969-02-06,-62,57,0,119
"3326",1969-02-07,7,55,0,48
"3327",1969-02-08,-5,106,0,111
"3328",1969-02-09,-7,125,0,132
"3329",1969-02-10,-16,191,0,207
"3330",1969-02-11,-3,167,0,170
"3331",1969-02-12,45,114,6,69
"3332",1969-02-13,-40,48,149,88
"3333",1969-02-14,-75,-36,0,39
"3334",1969-02-15,-85,-56,28,29
"3335",1969-02-16,-94,-50,1,44
"3336",1969-02-17,-63,-19,0,44
"3337",1969-02-18,-36,-5,0,31
"3338",1969-02-19,-80,-23,24,57
"3339",1969-02-20,-83,-48,8,35
"3340",1969-02-21,-70,-19,0,51
"3341",1969-02-22,-49,-24,0,25
"3342",1969-02-23,-54,-16,5,38
"3343",1969-02-24,-72,-33,0,39
"3344",1969-02-25,-67,-30,22,37
"3345",1969-02-26,-50,-4,4,46
"3346",1969-02-27,-28,85,0,113
"3347",1969-02-28,-21,25,0,46
"3348",1969-03-01,-7,48,0,55
"3349",1969-03-02,-7,35,0,42
"3350",1969-03-03,8,85,0,77
"3351",1969-03-04,-23,65,0,88
"3352",1969-03-05,3,102,0,99
"3353",1969-03-06,5,120,0,115
"3354",1969-03-07,-5,141,0,146
"3355",1969-03-08,15,157,0,142
"3356",1969-03-09,-15,99,0,114
"3357",1969-03-10,-42,6,25,48
"3358",1969-03-11,-53,-14,24,39
"3359",1969-03-12,-50,69,1,119
"3360",1969-03-13,-2,136,0,138
"3361",1969-03-14,-6,187,0,193
"3362",1969-03-15,25,144,0,119
"3363",1969-03-16,-30,130,0,160
"3364",1969-03-17,20,146,0,126
"3365",1969-03-18,35,197,0,162
"3366",1969-03-19,64,214,0,150
"3367",1969-03-20,74,171,0,97
"3368",1969-03-21,18,147,0,129
"3369",1969-03-22,65,124,3,59
"3370",1969-03-23,64,182,0,118
"3371",1969-03-24,30,215,0,185
"3372",1969-03-25,54,266,0,212
"3373",1969-03-26,66,268,0,202
"3374",1969-03-27,76,200,0,124
"3375",1969-03-28,18,82,12,64
"3376",1969-03-29,-4,113,0,117
"3377",1969-03-30,16,136,0,120
"3378",1969-03-31,25,210,0,185
"3379",1969-04-01,57,156,0,99
"3380",1969-04-02,36,88,73,52
"3381",1969-04-03,6,74,13,68
"3382",1969-04-04,0,109,20,109
"3383",1969-04-05,27,157,0,130
"3384",1969-04-06,75,199,0,124
"3385",1969-04-07,104,207,0,103
"3386",1969-04-08,46,257,0,211
"3387",1969-04-09,92,216,0,124
"3388",1969-04-10,58,286,0,228
"3389",1969-04-11,110,276,0,166
"3390",1969-04-12,105,307,0,202
"3391",1969-04-13,185,300,0,115
"3392",1969-04-14,117,244,0,127
"3393",1969-04-15,34,126,98,92
"3394",1969-04-16,33,134,28,101
"3395",1969-04-17,53,174,0,121
"3396",1969-04-18,110,143,30,33
"3397",1969-04-19,95,114,86,19
"3398",1969-04-20,100,240,29,140
"3399",1969-04-21,137,271,0,134
"3400",1969-04-22,137,223,537,86
"3401",1969-04-23,89,196,644,107
"3402",1969-04-24,72,120,27,48
"3403",1969-04-25,55,186,0,131
"3404",1969-04-26,114,233,0,119
"3405",1969-04-27,109,240,0,131
"3406",1969-04-28,130,220,0,90
"3407",1969-04-29,115,289,0,174
"3408",1969-04-30,151,245,0,94
"3409",1969-05-01,93,255,0,162
"3410",1969-05-02,158,216,201,58
"3411",1969-05-03,170,244,23,74
"3412",1969-05-04,176,267,0,91
"3413",1969-05-05,145,222,0,77
"3414",1969-05-06,85,210,0,125
"3415",1969-05-07,121,302,0,181
"3416",1969-05-08,160,317,0,157
"3417",1969-05-09,200,307,0,107
"3418",1969-05-10,170,340,0,170
"3419",1969-05-11,138,172,5,34
"3420",1969-05-12,124,175,0,51
"3421",1969-05-13,124,226,0,102
"3422",1969-05-14,178,255,0,77
"3423",1969-05-15,157,298,0,141
"3424",1969-05-16,169,278,0,109
"3425",1969-05-17,122,342,0,220
"3426",1969-05-18,157,248,0,91
"3427",1969-05-19,152,224,0,72
"3428",1969-05-20,130,287,0,157
"3429",1969-05-21,155,262,0,107
"3430",1969-05-22,161,272,0,111
"3431",1969-05-23,180,284,0,104
"3432",1969-05-24,169,330,0,161
"3433",1969-05-25,160,297,0,137
"3434",1969-05-26,163,254,0,91
"3435",1969-05-27,92,307,0,215
"3436",1969-05-28,188,372,0,184
"3437",1969-05-29,154,292,24,138
"3438",1969-05-30,174,353,0,179
"3439",1969-05-31,198,335,0,137
"3440",1969-06-01,212,340,0,128
"3441",1969-06-02,220,308,0,88
"3442",1969-06-03,195,335,0,140
"3443",1969-06-04,162,293,60,131
"3444",1969-06-05,144,285,1,141
"3445",1969-06-06,145,341,0,196
"3446",1969-06-07,205,304,0,99
"3447",1969-06-08,184,312,0,128
"3448",1969-06-09,167,280,0,113
"3449",1969-06-10,206,308,0,102
"3450",1969-06-11,180,355,0,175
"3451",1969-06-12,152,330,0,178
"3452",1969-06-13,160,317,0,157
"3453",1969-06-14,211,322,0,111
"3454",1969-06-15,217,293,0,76
"3455",1969-06-16,206,320,0,114
"3456",1969-06-17,181,330,0,149
"3457",1969-06-18,173,307,0,134
"3458",1969-06-19,186,325,0,139
"3459",1969-06-20,187,311,0,124
"3460",1969-06-21,181,347,0,166
"3461",1969-06-22,220,385,0,165
"3462",1969-06-23,254,340,0,86
"3463",1969-06-24,238,335,4,97
"3464",1969-06-25,194,375,35,181
"3465",1969-06-26,225,326,10,101
"3466",1969-06-27,235,385,0,150
"3467",1969-06-28,274,377,0,103
"3468",1969-06-29,215,390,0,175
"3469",1969-06-30,262,349,0,87
"3470",1969-07-01,219,322,24,103
"3471",1969-07-02,220,324,0,104
"3472",1969-07-03,200,292,28,92
"3473",1969-07-04,171,327,0,156
"3474",1969-07-05,221,340,0,119
"3475",1969-07-06,244,301,3,57
"3476",1969-07-07,212,307,33,95
"3477",1969-07-08,204,325,0,121
"3478",1969-07-09,225,334,0,109
"3479",1969-07-10,213,333,273,120
"3480",1969-07-11,210,285,0,75
"3481",1969-07-12,222,312,2,90
"3482",1969-07-13,218,345,0,127
"3483",1969-07-14,240,331,0,91
"3484",1969-07-15,200,355,0,155
"3485",1969-07-16,217,362,0,145
"3486",1969-07-17,218,342,0,124
"3487",1969-07-18,226,370,0,144
"3488",1969-07-19,212,325,93,113
"3489",1969-07-20,221,325,4,104
"3490",1969-07-21,243,358,0,115
"3491",1969-07-22,241,337,4,96
"3492",1969-07-23,249,330,19,81
"3493",1969-07-24,241,337,15,96
"3494",1969-07-25,254,384,0,130
"3495",1969-07-26,248,377,0,129
"3496",1969-07-27,274,395,0,121
"3497",1969-07-28,273,368,0,95
"3498",1969-07-29,271,354,0,83
"3499",1969-07-30,259,319,144,60
"3500",1969-07-31,256,342,0,86
"3501",1969-08-01,268,406,0,138
"3502",1969-08-02,235,359,0,124
"3503",1969-08-03,222,311,26,89
"3504",1969-08-04,201,323,0,122
"3505",1969-08-05,195,335,0,140
"3506",1969-08-06,210,341,0,131
"3507",1969-08-07,211,343,0,132
"3508",1969-08-08,246,302,10,56
"3509",1969-08-09,235,302,47,67
"3510",1969-08-10,248,323,0,75
"3511",1969-08-11,225,289,1010,64
"3512",1969-08-12,203,330,0,127
"3513",1969-08-13,227,316,0,89
"3514",1969-08-14,224,323,0,99
"3515",1969-08-15,228,330,0,102
"3516",1969-08-16,248,340,0,92
"3517",1969-08-17,235,308,3,73
"3518",1969-08-18,176,325,0,149
"3519",1969-08-19,193,317,0,124
"3520",1969-08-20,231,307,38,76
"3521",1969-08-21,237,307,8,70
"3522",1969-08-22,194,343,0,149
"3523",1969-08-23,198,341,0,143
"3524",1969-08-24,189,339,0,150
"3525",1969-08-25,177,340,0,163
"3526",1969-08-26,197,331,0,134
"3527",1969-08-27,157,340,0,183
"3528",1969-08-28,193,332,0,139
"3529",1969-08-29,197,307,0,110
"3530",1969-08-30,179,304,0,125
"3531",1969-08-31,189,314,0,125
"3532",1969-09-01,178,305,0,127
"3533",1969-09-02,217,265,484,48
"3534",1969-09-03,160,302,0,142
"3535",1969-09-04,195,243,18,48
"3536",1969-09-05,159,225,39,66
"3537",1969-09-06,176,258,8,82
"3538",1969-09-07,180,256,0,76
"3539",1969-09-08,161,220,126,59
"3540",1969-09-09,169,263,0,94
"3541",1969-09-10,167,286,0,119
"3542",1969-09-11,180,270,12,90
"3543",1969-09-12,172,285,0,113
"3544",1969-09-13,183,297,5,114
"3545",1969-09-14,164,289,0,125
"3546",1969-09-15,165,307,0,142
"3547",1969-09-16,180,314,0,134
"3548",1969-09-17,189,317,0,128
"3549",1969-09-18,178,319,0,141
"3550",1969-09-19,188,277,0,89
"3551",1969-09-20,176,246,0,70
"3552",1969-09-21,171,215,380,44
"3553",1969-09-22,156,184,153,28
"3554",1969-09-23,160,184,575,24
"3555",1969-09-24,177,196,96,19
"3556",1969-09-25,169,180,90,11
"3557",1969-09-26,117,180,169,63
"3558",1969-09-27,98,156,103,58
"3559",1969-09-28,128,177,0,49
"3560",1969-09-29,114,145,144,31
"3561",1969-09-30,103,232,0,129
"3562",1969-10-01,110,226,0,116
"3563",1969-10-02,62,204,0,142
"3564",1969-10-03,100,217,0,117
"3565",1969-10-04,100,210,0,110
"3566",1969-10-05,116,197,0,81
"3567",1969-10-06,121,202,4,81
"3568",1969-10-07,85,242,0,157
"3569",1969-10-08,107,204,0,97
"3570",1969-10-09,45,200,0,155
"3571",1969-10-10,71,257,0,186
"3572",1969-10-11,79,225,0,146
"3573",1969-10-12,105,222,0,117
"3574",1969-10-13,148,202,2,54
"3575",1969-10-14,128,269,0,141
"3576",1969-10-15,127,267,0,140
"3577",1969-10-16,118,244,0,126
"3578",1969-10-17,110,267,0,157
"3579",1969-10-18,124,261,0,137
"3580",1969-10-19,103,184,0,81
"3581",1969-10-20,135,218,0,83
"3582",1969-10-21,117,230,0,113
"3583",1969-10-22,135,173,1,38
"3584",1969-10-23,101,138,119,37
"3585",1969-10-24,92,210,0,118
"3586",1969-10-25,93,208,0,115
"3587",1969-10-26,50,236,0,186
"3588",1969-10-27,66,245,0,179
"3589",1969-10-28,72,240,0,168
"3590",1969-10-29,93,252,0,159
"3591",1969-10-30,120,270,0,150
"3592",1969-10-31,79,203,0,124
"3593",1969-11-01,62,119,0,57
"3594",1969-11-02,37,153,0,116
"3595",1969-11-03,32,117,0,85
"3596",1969-11-04,35,90,0,55
"3597",1969-11-05,-6,134,0,140
"3598",1969-11-06,8,162,0,154
"3599",1969-11-07,18,190,0,172
"3600",1969-11-08,47,249,0,202
"3601",1969-11-09,62,145,0,83
"3602",1969-11-10,-23,147,0,170
"3603",1969-11-11,0,194,0,194
"3604",1969-11-12,19,230,0,211
"3605",1969-11-13,90,225,0,135
"3606",1969-11-14,58,155,5,97
"3607",1969-11-15,3,73,7,70
"3608",1969-11-16,-7,45,0,52
"3609",1969-11-17,-38,96,0,134
"3610",1969-11-18,-42,130,0,172
"3611",1969-11-19,-13,149,0,162
"3612",1969-11-20,2,112,0,110
"3613",1969-11-21,32,93,0,61
"3614",1969-11-22,-22,87,0,109
"3615",1969-11-23,18,123,0,105
"3616",1969-11-24,-19,107,0,126
"3617",1969-11-25,-18,130,0,148
"3618",1969-11-26,-41,170,0,211
"3619",1969-11-27,-2,102,0,104
"3620",1969-11-28,6,63,0,57
"3621",1969-11-29,-14,81,0,95
"3622",1969-11-30,-60,154,0,214
"3623",1969-12-01,-7,108,0,115
"3624",1969-12-02,-24,71,0,95
"3625",1969-12-03,11,114,0,103
"3626",1969-12-04,-28,170,0,198
"3627",1969-12-05,-44,191,0,235
"3628",1969-12-06,-12,82,0,94
"3629",1969-12-07,-2,45,0,47
"3630",1969-12-08,-53,27,0,80
"3631",1969-12-09,-16,75,0,91
"3632",1969-12-10,22,123,0,101
"3633",1969-12-11,-21,137,0,158
"3634",1969-12-12,-36,79,0,115
"3635",1969-12-13,-70,63,0,133
"3636",1969-12-14,-68,71,0,139
"3637",1969-12-15,-64,70,0,134
"3638",1969-12-16,-76,63,0,139
"3639",1969-12-17,-74,87,0,161
"3640",1969-12-18,-63,33,0,96
"3641",1969-12-19,-79,52,0,131
"3642",1969-12-20,-43,114,0,157
"3643",1969-12-21,-46,181,0,227
"3644",1969-12-22,-32,76,0,108
"3645",1969-12-23,-50,85,0,135
"3646",1969-12-24,-55,72,0,127
"3647",1969-12-25,-34,53,0,87
"3648",1969-12-26,-53,27,0,80
"3649",1969-12-27,-118,20,0,138
"3650",1969-12-28,-104,84,0,188
"3651",1969-12-29,-48,53,0,101
"3652",1969-12-30,-87,38,0,125
"3653",1969-12-31,-58,78,0,136
"3654",1970-01-01,-53,53,0,106
"3655",1970-01-02,-58,34,0,92
"3656",1970-01-03,-52,-7,0,45
"3657",1970-01-04,-95,-41,0,54
"3658",1970-01-05,-142,2,0,144
"3659",1970-01-06,-96,28,0,124
"3660",1970-01-07,-62,64,0,126
"3661",1970-01-08,-73,72,0,145
"3662",1970-01-09,-82,78,0,160
"3663",1970-01-10,-53,66,0,119
"3664",1970-01-11,-56,129,0,185
"3665",1970-01-12,-16,82,0,98
"3666",1970-01-13,-65,26,0,91
"3667",1970-01-14,-103,20,0,123
"3668",1970-01-15,-126,-5,0,121
"3669",1970-01-16,-130,19,0,149
"3670",1970-01-17,-65,6,0,71
"3671",1970-01-18,-87,42,0,129
"3672",1970-01-19,-103,77,0,180
"3673",1970-01-20,-97,105,0,202
"3674",1970-01-21,-74,145,0,219
"3675",1970-01-22,-15,52,0,67
"3676",1970-01-23,-71,55,0,126
"3677",1970-01-24,-54,88,0,142
"3678",1970-01-25,-63,118,0,181
"3679",1970-01-26,-53,70,0,123
"3680",1970-01-27,-59,89,0,148
"3681",1970-01-28,-8,86,0,94
"3682",1970-01-29,12,96,0,84
"3683",1970-01-30,-74,70,0,144
"3684",1970-01-31,-67,120,0,187
"3685",1970-02-01,-38,79,0,117
"3686",1970-02-02,13,78,0,65
"3687",1970-02-03,-53,63,0,116
"3688",1970-02-04,-58,66,0,124
"3689",1970-02-05,-66,75,0,141
"3690",1970-02-06,-10,35,0,45
"3691",1970-02-07,-24,132,0,156
"3692",1970-02-08,25,100,0,75
"3693",1970-02-09,-66,86,0,152
"3694",1970-02-10,-29,147,0,176
"3695",1970-02-11,-5,136,0,141
"3696",1970-02-12,-39,203,0,242
"3697",1970-02-13,0,174,0,174
"3698",1970-02-14,35,131,0,96
"3699",1970-02-15,-38,116,0,154
"3700",1970-02-16,-35,189,0,224
"3701",1970-02-17,1,215,0,214
"3702",1970-02-18,45,155,0,110
"3703",1970-02-19,24,88,0,64
"3704",1970-02-20,-4,125,6,129
"3705",1970-02-21,8,75,0,67
"3706",1970-02-22,-25,11,32,36
"3707",1970-02-23,-33,-15,31,18
"3708",1970-02-24,-27,11,34,38
"3709",1970-02-25,-36,-3,0,33
"3710",1970-02-26,-60,35,0,95
"3711",1970-02-27,-18,41,0,59
"3712",1970-02-28,-29,96,0,125
"3713",1970-03-01,4,84,1,80
"3714",1970-03-02,-17,23,47,40
"3715",1970-03-03,-19,95,0,114
"3716",1970-03-04,-13,89,0,102
"3717",1970-03-05,6,107,0,101
"3718",1970-03-06,4,109,0,105
"3719",1970-03-07,-13,139,0,152
"3720",1970-03-08,27,183,0,156
"3721",1970-03-09,0,54,1,54
"3722",1970-03-10,3,81,0,78
"3723",1970-03-11,-8,50,10,58
"3724",1970-03-12,-5,42,32,47
"3725",1970-03-13,-36,52,0,88
"3726",1970-03-14,-8,39,0,47
"3727",1970-03-15,-14,108,0,122
"3728",1970-03-16,6,130,0,124
"3729",1970-03-17,38,142,0,104
"3730",1970-03-18,-38,101,0,139
"3731",1970-03-19,-12,119,0,131
"3732",1970-03-20,30,112,0,82
"3733",1970-03-21,17,95,0,78
"3734",1970-03-22,-55,100,0,155
"3735",1970-03-23,-34,166,0,200
"3736",1970-03-24,36,118,0,82
"3737",1970-03-25,-13,140,0,153
"3738",1970-03-26,9,180,0,171
"3739",1970-03-27,42,229,0,187
"3740",1970-03-28,52,230,0,178
"3741",1970-03-29,97,178,2,81
"3742",1970-03-30,40,159,4,119
"3743",1970-03-31,11,177,0,166
"3744",1970-04-01,32,204,0,172
"3745",1970-04-02,53,264,0,211
"3746",1970-04-03,64,165,0,101
"3747",1970-04-04,-28,164,0,192
"3748",1970-04-05,55,199,0,144
"3749",1970-04-06,80,215,0,135
"3750",1970-04-07,40,156,2,116
"3751",1970-04-08,32,207,0,175
"3752",1970-04-09,60,195,0,135
"3753",1970-04-10,75,174,16,99
"3754",1970-04-11,78,160,0,82
"3755",1970-04-12,60,180,0,120
"3756",1970-04-13,36,222,0,186
"3757",1970-04-14,112,247,0,135
"3758",1970-04-15,125,265,0,140
"3759",1970-04-16,152,225,0,73
"3760",1970-04-17,137,239,3,102
"3761",1970-04-18,95,235,0,140
"3762",1970-04-19,92,276,0,184
"3763",1970-04-20,90,310,0,220
"3764",1970-04-21,104,222,0,118
"3765",1970-04-22,83,166,103,83
"3766",1970-04-23,82,153,111,71
"3767",1970-04-24,65,224,0,159
"3768",1970-04-25,141,232,0,91
"3769",1970-04-26,126,205,0,79
"3770",1970-04-27,94,247,0,153
"3771",1970-04-28,115,261,0,146
"3772",1970-04-29,130,279,0,149
"3773",1970-04-30,130,232,209,102
"3774",1970-05-01,142,250,24,108
"3775",1970-05-02,134,216,0,82
"3776",1970-05-03,125,247,0,122
"3777",1970-05-04,140,257,0,117
"3778",1970-05-05,110,258,0,148
"3779",1970-05-06,133,222,0,89
"3780",1970-05-07,125,245,0,120
"3781",1970-05-08,174,209,267,35
"3782",1970-05-09,177,226,44,49
"3783",1970-05-10,117,230,0,113
"3784",1970-05-11,143,287,0,144
"3785",1970-05-12,161,226,0,65
"3786",1970-05-13,87,230,0,143
"3787",1970-05-14,94,260,0,166
"3788",1970-05-15,118,282,0,164
"3789",1970-05-16,145,305,0,160
"3790",1970-05-17,157,274,0,117
"3791",1970-05-18,168,322,0,154
"3792",1970-05-19,162,293,0,131
"3793",1970-05-20,104,329,0,225
"3794",1970-05-21,167,367,0,200
"3795",1970-05-22,152,317,0,165
"3796",1970-05-23,187,315,0,128
"3797",1970-05-24,196,281,4,85
"3798",1970-05-25,120,336,0,216
"3799",1970-05-26,149,312,0,163
"3800",1970-05-27,127,306,0,179
"3801",1970-05-28,189,277,17,88
"3802",1970-05-29,162,200,46,38
"3803",1970-05-30,164,254,41,90
"3804",1970-05-31,157,228,0,71
"3805",1970-06-01,151,237,0,86
"3806",1970-06-02,152,315,0,163
"3807",1970-06-03,154,323,0,169
"3808",1970-06-04,164,362,0,198
"3809",1970-06-05,188,345,0,157
"3810",1970-06-06,232,285,0,53
"3811",1970-06-07,170,233,118,63
"3812",1970-06-08,170,223,3,53
"3813",1970-06-09,170,255,21,85
"3814",1970-06-10,165,269,11,104
"3815",1970-06-11,152,350,0,198
"3816",1970-06-12,158,325,0,167
"3817",1970-06-13,184,290,76,106
"3818",1970-06-14,157,272,0,115
"3819",1970-06-15,156,308,0,152
"3820",1970-06-16,184,297,0,113
"3821",1970-06-17,186,267,193,81
"3822",1970-06-18,180,250,2,70
"3823",1970-06-19,183,320,0,137
"3824",1970-06-20,207,270,0,63
"3825",1970-06-21,200,316,4,116
"3826",1970-06-22,180,330,0,150
"3827",1970-06-23,206,346,0,140
"3828",1970-06-24,173,343,191,170
"3829",1970-06-25,201,329,0,128
"3830",1970-06-26,207,346,0,139
"3831",1970-06-27,237,345,0,108
"3832",1970-06-28,232,311,0,79
"3833",1970-06-29,190,310,0,120
"3834",1970-06-30,232,361,0,129
"3835",1970-07-01,234,347,0,113
"3836",1970-07-02,219,317,0,98
"3837",1970-07-03,170,330,0,160
"3838",1970-07-04,210,354,0,144
"3839",1970-07-05,234,367,0,133
"3840",1970-07-06,248,367,0,119
"3841",1970-07-07,247,326,0,79
"3842",1970-07-08,212,322,23,110
"3843",1970-07-09,206,284,6,78
"3844",1970-07-10,203,314,0,111
"3845",1970-07-11,196,339,0,143
"3846",1970-07-12,218,326,0,108
"3847",1970-07-13,230,305,0,75
"3848",1970-07-14,206,351,0,145
"3849",1970-07-15,243,356,0,113
"3850",1970-07-16,214,317,392,103
"3851",1970-07-17,206,324,0,118
"3852",1970-07-18,234,369,0,135
"3853",1970-07-19,240,350,1,110
"3854",1970-07-20,226,386,0,160
"3855",1970-07-21,237,343,0,106
"3856",1970-07-22,200,323,50,123
"3857",1970-07-23,240,336,0,96
"3858",1970-07-24,247,321,118,74
"3859",1970-07-25,215,288,935,73
"3860",1970-07-26,235,327,0,92
"3861",1970-07-27,242,332,0,90
"3862",1970-07-28,254,320,14,66
"3863",1970-07-29,237,283,499,46
"3864",1970-07-30,244,325,0,81
"3865",1970-07-31,248,302,44,54
"3866",1970-08-01,240,294,2,54
"3867",1970-08-02,217,307,0,90
"3868",1970-08-03,253,328,0,75
"3869",1970-08-04,225,307,0,82
"3870",1970-08-05,230,270,272,40
"3871",1970-08-06,233,263,55,30
"3872",1970-08-07,232,292,205,60
"3873",1970-08-08,234,345,2,111
"3874",1970-08-09,265,353,0,88
"3875",1970-08-10,262,356,0,94
"3876",1970-08-11,240,357,2,117
"3877",1970-08-12,235,297,22,62
"3878",1970-08-13,208,270,0,62
"3879",1970-08-14,193,281,0,88
"3880",1970-08-15,196,299,0,103
"3881",1970-08-16,223,320,6,97
"3882",1970-08-17,215,259,259,44
"3883",1970-08-18,210,275,7,65
"3884",1970-08-19,218,280,0,62
"3885",1970-08-20,217,300,0,83
"3886",1970-08-21,205,312,0,107
"3887",1970-08-22,204,327,0,123
"3888",1970-08-23,193,320,0,127
"3889",1970-08-24,190,315,0,125
"3890",1970-08-25,186,314,0,128
"3891",1970-08-26,200,314,0,114
"3892",1970-08-27,220,305,0,85
"3893",1970-08-28,211,277,0,66
"3894",1970-08-29,210,250,3,40
"3895",1970-08-30,220,285,0,65
"3896",1970-08-31,216,313,58,97
"3897",1970-09-01,172,354,0,182
"3898",1970-09-02,162,359,0,197
"3899",1970-09-03,190,340,0,150
"3900",1970-09-04,182,295,0,113
"3901",1970-09-05,180,294,0,114
"3902",1970-09-06,212,310,0,98
"3903",1970-09-07,215,280,0,65
"3904",1970-09-08,180,243,3,63
"3905",1970-09-09,134,273,0,139
"3906",1970-09-10,122,235,78,113
"3907",1970-09-11,148,229,25,81
"3908",1970-09-12,114,295,0,181
"3909",1970-09-13,154,299,0,145
"3910",1970-09-14,159,283,0,124
"3911",1970-09-15,177,303,0,126
"3912",1970-09-16,180,247,470,67
"3913",1970-09-17,174,245,59,71
"3914",1970-09-18,158,247,0,89
"3915",1970-09-19,128,262,0,134
"3916",1970-09-20,171,259,0,88
"3917",1970-09-21,187,222,71,35
"3918",1970-09-22,184,240,9,56
"3919",1970-09-23,169,286,0,117
"3920",1970-09-24,192,238,49,46
"3921",1970-09-25,151,207,8,56
"3922",1970-09-26,127,161,39,34
"3923",1970-09-27,115,177,10,62
"3924",1970-09-28,136,211,0,75
"3925",1970-09-29,95,197,0,102
"3926",1970-09-30,68,213,0,145
"3927",1970-10-01,70,238,0,168
"3928",1970-10-02,90,260,0,170
"3929",1970-10-03,90,280,0,190
"3930",1970-10-04,70,283,0,213
"3931",1970-10-05,129,270,0,141
"3932",1970-10-06,94,255,0,161
"3933",1970-10-07,108,268,0,160
"3934",1970-10-08,132,200,0,68
"3935",1970-10-09,125,173,19,48
"3936",1970-10-10,117,197,35,80
"3937",1970-10-11,144,189,114,45
"3938",1970-10-12,108,230,0,122
"3939",1970-10-13,147,190,0,43
"3940",1970-10-14,137,240,0,103
"3941",1970-10-15,145,207,7,62
"3942",1970-10-16,113,224,0,111
"3943",1970-10-17,103,250,0,147
"3944",1970-10-18,107,245,0,138
"3945",1970-10-19,101,224,0,123
"3946",1970-10-20,83,239,0,156
"3947",1970-10-21,124,255,0,131
"3948",1970-10-22,150,249,0,99
"3949",1970-10-23,144,230,0,86
"3950",1970-10-24,131,190,50,59
"3951",1970-10-25,102,157,248,55
"3952",1970-10-26,67,114,0,47
"3953",1970-10-27,25,156,0,131
"3954",1970-10-28,38,158,0,120
"3955",1970-10-29,27,164,0,137
"3956",1970-10-30,-2,163,0,165
"3957",1970-10-31,36,190,0,154
"3958",1970-11-01,20,210,0,190
"3959",1970-11-02,24,235,0,211
"3960",1970-11-03,71,211,0,140
"3961",1970-11-04,56,222,0,166
"3962",1970-11-05,63,226,0,163
"3963",1970-11-06,25,204,0,179
"3964",1970-11-07,53,203,0,150
"3965",1970-11-08,66,201,0,135
"3966",1970-11-09,63,216,0,153
"3967",1970-11-10,52,225,0,173
"3968",1970-11-11,29,205,0,176
"3969",1970-11-12,42,215,0,173
"3970",1970-11-13,67,167,0,100
"3971",1970-11-14,25,71,0,46
"3972",1970-11-15,-60,116,0,176
"3973",1970-11-16,-17,126,0,143
"3974",1970-11-17,34,176,0,142
"3975",1970-11-18,18,179,0,161
"3976",1970-11-19,0,204,0,204
"3977",1970-11-20,21,134,0,113
"3978",1970-11-21,-12,57,3,69
"3979",1970-11-22,-39,38,1,77
"3980",1970-11-23,0,50,0,50
"3981",1970-11-24,-4,30,42,34
"3982",1970-11-25,6,34,0,28
"3983",1970-11-26,-13,89,0,102
"3984",1970-11-27,-34,99,0,133
"3985",1970-11-28,-12,51,0,63
"3986",1970-11-29,-50,11,0,61
"3987",1970-11-30,-35,60,0,95
"3988",1970-12-01,-25,86,0,111
"3989",1970-12-02,-6,106,0,112
"3990",1970-12-03,-42,153,0,195
"3991",1970-12-04,-57,148,0,205
"3992",1970-12-05,-37,103,0,140
"3993",1970-12-06,-47,99,0,146
"3994",1970-12-07,-23,63,0,86
"3995",1970-12-08,-53,82,0,135
"3996",1970-12-09,-54,147,0,201
"3997",1970-12-10,-37,117,0,154
"3998",1970-12-11,3,78,0,75
"3999",1970-12-12,-13,75,0,88
"4000",1970-12-13,-46,61,0,107
"4001",1970-12-14,-58,121,0,179
"4002",1970-12-15,-45,145,0,190
"4003",1970-12-16,-42,128,0,170
"4004",1970-12-17,-2,87,0,89
"4005",1970-12-18,10,55,0,45
"4006",1970-12-19,-13,27,0,40
"4007",1970-12-20,-34,62,0,96
"4008",1970-12-21,-13,35,0,48
"4009",1970-12-22,-20,85,0,105
"4010",1970-12-23,-30,80,0,110
"4011",1970-12-24,-15,45,0,60
"4012",1970-12-25,-68,2,0,70
"4013",1970-12-26,-57,11,0,68
"4014",1970-12-27,-72,36,0,108
"4015",1970-12-28,-55,36,0,91
"4016",1970-12-29,-15,78,0,93
"4017",1970-12-30,-40,93,0,133
"4018",1970-12-31,-48,76,0,124
"4019",1971-01-01,-37,47,0,84
"4020",1971-01-02,-40,90,0,130
"4021",1971-01-03,-49,75,0,124
"4022",1971-01-04,-80,57,0,137
"4023",1971-01-05,-95,66,0,161
"4024",1971-01-06,-53,104,0,157
"4025",1971-01-07,-40,94,0,134
"4026",1971-01-08,-73,86,0,159
"4027",1971-01-09,-51,123,0,174
"4028",1971-01-10,-41,165,0,206
"4029",1971-01-11,-26,80,0,106
"4030",1971-01-12,-55,89,0,144
"4031",1971-01-13,-10,78,0,88
"4032",1971-01-14,-52,99,0,151
"4033",1971-01-15,-40,111,0,151
"4034",1971-01-16,-3,54,0,57
"4035",1971-01-17,18,50,0,32
"4036",1971-01-18,3,43,80,40
"4037",1971-01-19,18,61,14,43
"4038",1971-01-20,-3,26,1,29
"4039",1971-01-21,-42,17,0,59
"4040",1971-01-22,-74,37,0,111
"4041",1971-01-23,-83,60,0,143
"4042",1971-01-24,-16,45,0,61
"4043",1971-01-25,-47,58,0,105
"4044",1971-01-26,-87,46,0,133
"4045",1971-01-27,-56,3,0,59
"4046",1971-01-28,-89,55,0,144
"4047",1971-01-29,-43,20,0,63
"4048",1971-01-30,-53,40,0,93
"4049",1971-01-31,-58,49,0,107
"4050",1971-02-01,-88,80,0,168
"4051",1971-02-02,-55,72,0,127
"4052",1971-02-03,-40,42,0,82
"4053",1971-02-04,-117,15,0,132
"4054",1971-02-05,-94,6,0,100
"4055",1971-02-06,-58,65,0,123
"4056",1971-02-07,-96,62,0,158
"4057",1971-02-08,-70,100,0,170
"4058",1971-02-09,-89,70,0,159
"4059",1971-02-10,-53,54,0,107
"4060",1971-02-11,-20,38,1,58
"4061",1971-02-12,-26,83,0,109
"4062",1971-02-13,6,55,9,49
"4063",1971-02-14,-20,150,0,170
"4064",1971-02-15,-5,186,0,191
"4065",1971-02-16,2,124,0,122
"4066",1971-02-17,-45,40,0,85
"4067",1971-02-18,-36,85,0,121
"4068",1971-02-19,-10,37,143,47
"4069",1971-02-20,-10,11,10,21
"4070",1971-02-21,0,20,12,20
"4071",1971-02-22,12,42,6,30
"4072",1971-02-23,10,63,0,53
"4073",1971-02-24,8,46,0,38
"4074",1971-02-25,-11,104,0,115
"4075",1971-02-26,-3,109,0,112
"4076",1971-02-27,-20,37,26,57
"4077",1971-02-28,-44,-14,24,30
"4078",1971-03-01,-43,-29,95,14
"4079",1971-03-02,-64,31,1,95
"4080",1971-03-03,-12,46,0,58
"4081",1971-03-04,-20,55,0,75
"4082",1971-03-05,-14,42,0,56
"4083",1971-03-06,-6,40,0,46
"4084",1971-03-07,-16,45,0,61
"4085",1971-03-08,-24,105,0,129
"4086",1971-03-09,-3,55,0,58
"4087",1971-03-10,-30,2,32,32
"4088",1971-03-11,-47,26,0,73
"4089",1971-03-12,-2,29,4,31
"4090",1971-03-13,-13,50,0,63
"4091",1971-03-14,4,57,0,53
"4092",1971-03-15,-23,203,0,226
"4093",1971-03-16,-11,138,0,149
"4094",1971-03-17,20,103,2,83
"4095",1971-03-18,5,154,0,149
"4096",1971-03-19,2,217,0,215
"4097",1971-03-20,53,254,0,201
"4098",1971-03-21,74,198,0,124
"4099",1971-03-22,15,184,0,169
"4100",1971-03-23,30,193,0,163
"4101",1971-03-24,5,195,0,190
"4102",1971-03-25,83,263,0,180
"4103",1971-03-26,96,250,0,154
"4104",1971-03-27,95,255,0,160
"4105",1971-03-28,100,286,0,186
"4106",1971-03-29,94,237,0,143
"4107",1971-03-30,60,194,0,134
"4108",1971-03-31,70,270,0,200
"4109",1971-04-01,55,183,0,128
"4110",1971-04-02,70,111,0,41
"4111",1971-04-03,50,105,40,55
"4112",1971-04-04,16,117,0,101
"4113",1971-04-05,68,220,15,152
"4114",1971-04-06,100,163,34,63
"4115",1971-04-07,80,207,6,127
"4116",1971-04-08,90,179,27,89
"4117",1971-04-09,17,195,0,178
"4118",1971-04-10,27,236,0,209
"4119",1971-04-11,81,243,0,162
"4120",1971-04-12,147,223,8,76
"4121",1971-04-13,130,179,80,49
"4122",1971-04-14,83,180,0,97
"4123",1971-04-15,74,174,0,100
"4124",1971-04-16,90,136,24,46
"4125",1971-04-17,78,159,23,81
"4126",1971-04-18,60,201,0,141
"4127",1971-04-19,75,249,0,174
"4128",1971-04-20,109,297,0,188
"4129",1971-04-21,100,320,0,220
"4130",1971-04-22,114,293,0,179
"4131",1971-04-23,75,237,0,162
"4132",1971-04-24,145,195,0,50
"4133",1971-04-25,100,212,0,112
"4134",1971-04-26,105,246,0,141
"4135",1971-04-27,82,270,0,188
"4136",1971-04-28,110,276,0,166
"4137",1971-04-29,122,245,9,123
"4138",1971-04-30,125,281,0,156
"4139",1971-05-01,123,216,0,93
"4140",1971-05-02,85,180,67,95
"4141",1971-05-03,78,139,52,61
"4142",1971-05-04,55,253,1,198
"4143",1971-05-05,113,236,0,123
"4144",1971-05-06,73,281,0,208
"4145",1971-05-07,96,283,0,187
"4146",1971-05-08,89,328,0,239
"4147",1971-05-09,140,328,0,188
"4148",1971-05-10,154,298,0,144
"4149",1971-05-11,162,306,0,144
"4150",1971-05-12,167,299,0,132
"4151",1971-05-13,160,291,0,131
"4152",1971-05-14,148,262,0,114
"4153",1971-05-15,184,300,0,116
"4154",1971-05-16,182,255,0,73
"4155",1971-05-17,140,217,0,77
"4156",1971-05-18,117,266,4,149
"4157",1971-05-19,84,316,0,232
"4158",1971-05-20,125,340,0,215
"4159",1971-05-21,158,333,0,175
"4160",1971-05-22,183,342,0,159
"4161",1971-05-23,181,293,0,112
"4162",1971-05-24,150,325,0,175
"4163",1971-05-25,127,340,0,213
"4164",1971-05-26,234,350,0,116
"4165",1971-05-27,192,305,0,113
"4166",1971-05-28,144,352,0,208
"4167",1971-05-29,148,370,0,222
"4168",1971-05-30,217,371,0,154
"4169",1971-05-31,192,348,0,156
"4170",1971-06-01,196,347,34,151
"4171",1971-06-02,191,287,4,96
"4172",1971-06-03,150,208,104,58
"4173",1971-06-04,114,287,0,173
"4174",1971-06-05,162,344,0,182
"4175",1971-06-06,183,350,0,167
"4176",1971-06-07,213,336,0,123
"4177",1971-06-08,173,297,54,124
"4178",1971-06-09,155,216,608,61
"4179",1971-06-10,173,240,9,67
"4180",1971-06-11,172,214,30,42
"4181",1971-06-12,163,257,0,94
"4182",1971-06-13,192,223,85,31
"4183",1971-06-14,181,285,1,104
"4184",1971-06-15,205,305,0,100
"4185",1971-06-16,198,319,0,121
"4186",1971-06-17,221,298,0,77
"4187",1971-06-18,208,270,17,62
"4188",1971-06-19,185,326,37,141
"4189",1971-06-20,189,370,0,181
"4190",1971-06-21,206,327,0,121
"4191",1971-06-22,207,370,34,163
"4192",1971-06-23,207,331,0,124
"4193",1971-06-24,195,288,0,93
"4194",1971-06-25,196,265,703,69
"4195",1971-06-26,184,305,0,121
"4196",1971-06-27,230,335,0,105
"4197",1971-06-28,238,298,129,60
"4198",1971-06-29,226,307,451,81
"4199",1971-06-30,204,295,5,91
"4200",1971-07-01,224,279,67,55
"4201",1971-07-02,227,315,1,88
"4202",1971-07-03,245,335,0,90
"4203",1971-07-04,230,335,0,105
"4204",1971-07-05,260,337,0,77
"4205",1971-07-06,268,370,0,102
"4206",1971-07-07,233,341,118,108
"4207",1971-07-08,205,326,0,121
"4208",1971-07-09,194,279,141,85
"4209",1971-07-10,183,250,3,67
"4210",1971-07-11,197,314,0,117
"4211",1971-07-12,236,339,0,103
"4212",1971-07-13,258,369,0,111
"4213",1971-07-14,264,376,0,112
"4214",1971-07-15,285,385,0,100
"4215",1971-07-16,277,377,0,100
"4216",1971-07-17,257,384,0,127
"4217",1971-07-18,275,379,0,104
"4218",1971-07-19,276,385,0,109
"4219",1971-07-20,251,345,7,94
"4220",1971-07-21,243,361,1,118
"4221",1971-07-22,260,307,0,47
"4222",1971-07-23,238,306,0,68
"4223",1971-07-24,247,351,0,104
"4224",1971-07-25,275,370,0,95
"4225",1971-07-26,240,372,772,132
"4226",1971-07-27,256,347,0,91
"4227",1971-07-28,257,351,0,94
"4228",1971-07-29,257,333,0,76
"4229",1971-07-30,265,351,0,86
"4230",1971-07-31,245,345,0,100
"4231",1971-08-01,234,305,0,71
"4232",1971-08-02,215,291,45,76
"4233",1971-08-03,218,305,0,87
"4234",1971-08-04,211,306,0,95
"4235",1971-08-05,182,302,0,120
"4236",1971-08-06,189,316,0,127
"4237",1971-08-07,198,322,0,124
"4238",1971-08-08,195,313,0,118
"4239",1971-08-09,235,301,0,66
"4240",1971-08-10,243,313,0,70
"4241",1971-08-11,212,325,0,113
"4242",1971-08-12,223,320,2,97
"4243",1971-08-13,224,314,0,90
"4244",1971-08-14,243,337,0,94
"4245",1971-08-15,264,367,0,103
"4246",1971-08-16,228,302,0,74
"4247",1971-08-17,240,323,0,83
"4248",1971-08-18,235,286,0,51
"4249",1971-08-19,228,311,0,83
"4250",1971-08-20,234,284,0,50
"4251",1971-08-21,204,240,295,36
"4252",1971-08-22,196,287,29,91
"4253",1971-08-23,214,260,0,46
"4254",1971-08-24,193,233,126,40
"4255",1971-08-25,180,272,0,92
"4256",1971-08-26,183,294,0,111
"4257",1971-08-27,200,295,0,95
"4258",1971-08-28,187,289,0,102
"4259",1971-08-29,216,301,0,85
"4260",1971-08-30,199,307,0,108
"4261",1971-08-31,210,330,0,120
"4262",1971-09-01,228,337,0,109
"4263",1971-09-02,236,340,0,104
"4264",1971-09-03,185,277,136,92
"4265",1971-09-04,193,287,10,94
"4266",1971-09-05,180,309,0,129
"4267",1971-09-06,192,299,0,107
"4268",1971-09-07,189,310,0,121
"4269",1971-09-08,196,309,0,113
"4270",1971-09-09,209,250,6,41
"4271",1971-09-10,178,288,1,110
"4272",1971-09-11,160,316,0,156
"4273",1971-09-12,194,300,0,106
"4274",1971-09-13,202,271,0,69
"4275",1971-09-14,161,285,0,124
"4276",1971-09-15,179,283,0,104
"4277",1971-09-16,179,291,0,112
"4278",1971-09-17,164,311,8,147
"4279",1971-09-18,164,241,0,77
"4280",1971-09-19,91,237,0,146
"4281",1971-09-20,80,245,0,165
"4282",1971-09-21,93,263,0,170
"4283",1971-09-22,121,254,21,133
"4284",1971-09-23,156,212,63,56
"4285",1971-09-24,157,246,0,89
"4286",1971-09-25,158,270,0,112
"4287",1971-09-26,122,270,0,148
"4288",1971-09-27,68,277,0,209
"4289",1971-09-28,162,214,12,52
"4290",1971-09-29,148,194,1,46
"4291",1971-09-30,150,228,17,78
"4292",1971-10-01,127,191,28,64
"4293",1971-10-02,120,165,2,45
"4294",1971-10-03,126,184,0,58
"4295",1971-10-04,81,261,0,180
"4296",1971-10-05,122,225,0,103
"4297",1971-10-06,124,265,0,141
"4298",1971-10-07,115,263,0,148
"4299",1971-10-08,135,260,0,125
"4300",1971-10-09,91,260,0,169
"4301",1971-10-10,120,264,0,144
"4302",1971-10-11,43,206,0,163
"4303",1971-10-12,46,252,0,206
"4304",1971-10-13,51,247,0,196
"4305",1971-10-14,92,238,0,146
"4306",1971-10-15,148,249,0,101
"4307",1971-10-16,170,250,0,80
"4308",1971-10-17,112,240,0,128
"4309",1971-10-18,75,241,0,166
"4310",1971-10-19,152,192,0,40
"4311",1971-10-20,104,162,199,58
"4312",1971-10-21,100,152,65,52
"4313",1971-10-22,92,150,0,58
"4314",1971-10-23,102,136,14,34
"4315",1971-10-24,47,162,0,115
"4316",1971-10-25,97,190,0,93
"4317",1971-10-26,30,200,0,170
"4318",1971-10-27,23,170,0,147
"4319",1971-10-28,40,204,0,164
"4320",1971-10-29,40,220,0,180
"4321",1971-10-30,44,260,0,216
"4322",1971-10-31,62,256,0,194
"4323",1971-11-01,101,243,0,142
"4324",1971-11-02,93,226,0,133
"4325",1971-11-03,137,206,1,69
"4326",1971-11-04,128,173,17,45
"4327",1971-11-05,77,130,149,53
"4328",1971-11-06,77,116,1,39
"4329",1971-11-07,78,101,179,23
"4330",1971-11-08,62,80,311,18
"4331",1971-11-09,26,134,2,108
"4332",1971-11-10,28,157,0,129
"4333",1971-11-11,55,167,0,112
"4334",1971-11-12,16,167,0,151
"4335",1971-11-13,57,138,0,81
"4336",1971-11-14,13,150,0,137
"4337",1971-11-15,-3,145,0,148
"4338",1971-11-16,-7,160,0,167
"4339",1971-11-17,0,175,0,175
"4340",1971-11-18,30,190,0,160
"4341",1971-11-19,41,199,0,158
"4342",1971-11-20,20,190,0,170
"4343",1971-11-21,23,153,0,130
"4344",1971-11-22,27,125,0,98
"4345",1971-11-23,0,155,0,155
"4346",1971-11-24,11,170,0,159
"4347",1971-11-25,28,175,0,147
"4348",1971-11-26,38,176,0,138
"4349",1971-11-27,39,168,0,129
"4350",1971-11-28,-10,95,0,105
"4351",1971-11-29,-40,50,0,90
"4352",1971-11-30,-54,102,0,156
"4353",1971-12-01,-35,132,0,167
"4354",1971-12-02,48,136,0,88
"4355",1971-12-03,-17,172,0,189
"4356",1971-12-04,2,156,0,154
"4357",1971-12-05,-22,83,0,105
"4358",1971-12-06,-57,40,0,97
"4359",1971-12-07,-79,50,0,129
"4360",1971-12-08,-63,61,0,124
"4361",1971-12-09,-49,98,0,147
"4362",1971-12-10,-37,88,0,125
"4363",1971-12-11,-47,90,0,137
"4364",1971-12-12,-48,64,0,112
"4365",1971-12-13,-28,116,0,144
"4366",1971-12-14,-41,72,0,113
"4367",1971-12-15,-65,80,0,145
"4368",1971-12-16,-36,129,0,165
"4369",1971-12-17,-31,188,0,219
"4370",1971-12-18,-13,111,0,124
"4371",1971-12-19,-36,-12,0,24
"4372",1971-12-20,-67,-33,0,34
"4373",1971-12-21,-60,-35,0,25
"4374",1971-12-22,-66,-33,50,33
"4375",1971-12-23,-65,-39,7,26
"4376",1971-12-24,-53,8,111,61
"4377",1971-12-25,-59,31,0,90
"4378",1971-12-26,-120,0,0,120
"4379",1971-12-27,-179,-2,0,177
"4380",1971-12-28,-135,7,0,142
"4381",1971-12-29,-94,34,0,128
"4382",1971-12-30,-84,-2,0,82
"4383",1971-12-31,-27,51,0,78
"4384",1972-01-01,-67,30,0,97
"4385",1972-01-02,-57,24,0,81
"4386",1972-01-03,-16,52,0,68
"4387",1972-01-04,-31,45,0,76
"4388",1972-01-05,-36,10,0,46
"4389",1972-01-06,-62,6,0,68
"4390",1972-01-07,-40,11,0,51
"4391",1972-01-08,-21,6,16,27
"4392",1972-01-09,-32,-1,36,31
"4393",1972-01-10,-100,10,0,110
"4394",1972-01-11,-79,10,0,89
"4395",1972-01-12,-38,10,0,48
"4396",1972-01-13,-55,14,0,69
"4397",1972-01-14,-30,18,0,48
"4398",1972-01-15,-55,34,0,89
"4399",1972-01-16,-48,30,0,78
"4400",1972-01-17,-53,35,0,88
"4401",1972-01-18,-44,60,0,104
"4402",1972-01-19,-25,72,0,97
"4403",1972-01-20,-30,143,0,173
"4404",1972-01-21,-28,76,0,104
"4405",1972-01-22,-10,26,0,36
"4406",1972-01-23,-42,10,82,52
"4407",1972-01-24,-66,-37,25,29
"4408",1972-01-25,-62,-20,0,42
"4409",1972-01-26,-92,-15,0,77
"4410",1972-01-27,-95,27,0,122
"4411",1972-01-28,-65,12,0,77
"4412",1972-01-29,-32,57,0,89
"4413",1972-01-30,-31,0,41,31
"4414",1972-01-31,-84,0,0,84
"4415",1972-02-01,-22,26,0,48
"4416",1972-02-02,-51,-19,0,32
"4417",1972-02-03,-53,-27,9,26
"4418",1972-02-04,-114,-14,2,100
"4419",1972-02-05,-31,5,0,36
"4420",1972-02-06,-46,18,0,64
"4421",1972-02-07,-46,12,0,58
"4422",1972-02-08,-49,17,0,66
"4423",1972-02-09,-44,57,0,101
"4424",1972-02-10,-39,74,0,113
"4425",1972-02-11,-40,13,0,53
"4426",1972-02-12,-25,67,0,92
"4427",1972-02-13,-32,62,0,94
"4428",1972-02-14,-14,54,0,68
"4429",1972-02-15,-4,29,52,33
"4430",1972-02-16,-12,23,0,35
"4431",1972-02-17,-2,96,0,98
"4432",1972-02-18,-5,75,0,80
"4433",1972-02-19,-31,30,0,61
"4434",1972-02-20,-48,-10,1,38
"4435",1972-02-21,-56,57,4,113
"4436",1972-02-22,-17,78,0,95
"4437",1972-02-23,-10,74,0,84
"4438",1972-02-24,-18,52,0,70
"4439",1972-02-25,6,75,16,69
"4440",1972-02-26,-1,56,0,57
"4441",1972-02-27,-37,37,0,74
"4442",1972-02-28,-36,110,0,146
"4443",1972-02-29,-44,74,0,118
"4444",1972-03-01,-47,118,0,165
"4445",1972-03-02,-36,96,0,132
"4446",1972-03-03,-46,104,0,150
"4447",1972-03-04,-33,121,0,154
"4448",1972-03-05,-20,160,0,180
"4449",1972-03-06,-14,194,0,208
"4450",1972-03-07,34,111,22,77
"4451",1972-03-08,47,165,5,118
"4452",1972-03-09,30,145,0,115
"4453",1972-03-10,9,91,92,82
"4454",1972-03-11,29,115,0,86
"4455",1972-03-12,8,149,0,141
"4456",1972-03-13,44,155,0,111
"4457",1972-03-14,65,120,0,55
"4458",1972-03-15,61,109,17,48
"4459",1972-03-16,28,170,0,142
"4460",1972-03-17,79,132,0,53
"4461",1972-03-18,74,140,57,66
"4462",1972-03-19,83,130,55,47
"4463",1972-03-20,66,137,0,71
"4464",1972-03-21,14,72,0,58
"4465",1972-03-22,55,69,52,14
"4466",1972-03-23,53,141,2,88
"4467",1972-03-24,32,153,0,121
"4468",1972-03-25,67,192,0,125
"4469",1972-03-26,30,207,0,177
"4470",1972-03-27,50,139,0,89
"4471",1972-03-28,66,164,10,98
"4472",1972-03-29,90,121,42,31
"4473",1972-03-30,31,226,0,195
"4474",1972-03-31,-11,82,0,93
"4475",1972-04-01,15,114,0,99
"4476",1972-04-02,13,135,0,122
"4477",1972-04-03,30,225,0,195
"4478",1972-04-04,52,182,0,130
"4479",1972-04-05,75,144,0,69
"4480",1972-04-06,63,131,0,68
"4481",1972-04-07,53,115,22,62
"4482",1972-04-08,58,134,0,76
"4483",1972-04-09,-9,181,0,190
"4484",1972-04-10,39,218,0,179
"4485",1972-04-11,31,219,0,188
"4486",1972-04-12,92,194,0,102
"4487",1972-04-13,113,211,5,98
"4488",1972-04-14,84,273,0,189
"4489",1972-04-15,117,275,0,158
"4490",1972-04-16,126,332,0,206
"4491",1972-04-17,134,282,0,148
"4492",1972-04-18,155,269,0,114
"4493",1972-04-19,144,251,0,107
"4494",1972-04-20,83,212,0,129
"4495",1972-04-21,116,206,0,90
"4496",1972-04-22,111,165,26,54
"4497",1972-04-23,89,133,46,44
"4498",1972-04-24,101,164,29,63
"4499",1972-04-25,68,257,0,189
"4500",1972-04-26,96,281,0,185
"4501",1972-04-27,107,298,0,191
"4502",1972-04-28,111,324,0,213
"4503",1972-04-29,136,331,0,195
"4504",1972-04-30,133,355,0,222
"4505",1972-05-01,146,236,0,90
"4506",1972-05-02,109,259,0,150
"4507",1972-05-03,156,284,11,128
"4508",1972-05-04,166,297,0,131
"4509",1972-05-05,158,301,0,143
"4510",1972-05-06,157,295,0,138
"4511",1972-05-07,175,249,129,74
"4512",1972-05-08,161,236,58,75
"4513",1972-05-09,140,258,0,118
"4514",1972-05-10,142,282,0,140
"4515",1972-05-11,154,282,0,128
"4516",1972-05-12,147,256,0,109
"4517",1972-05-13,162,284,0,122
"4518",1972-05-14,101,242,1,141
"4519",1972-05-15,31,272,0,241
"4520",1972-05-16,78,285,0,207
"4521",1972-05-17,132,300,0,168
"4522",1972-05-18,163,306,0,143
"4523",1972-05-19,178,310,0,132
"4524",1972-05-20,116,314,0,198
"4525",1972-05-21,170,298,0,128
"4526",1972-05-22,155,228,0,73
"4527",1972-05-23,145,213,0,68
"4528",1972-05-24,137,225,2,88
"4529",1972-05-25,96,277,0,181
"4530",1972-05-26,126,326,0,200
"4531",1972-05-27,174,261,2,87
"4532",1972-05-28,142,206,115,64
"4533",1972-05-29,161,235,107,74
"4534",1972-05-30,147,325,0,178
"4535",1972-05-31,163,315,0,152
"4536",1972-06-01,184,333,0,149
"4537",1972-06-02,173,372,0,199
"4538",1972-06-03,199,348,0,149
"4539",1972-06-04,195,337,0,142
"4540",1972-06-05,164,330,0,166
"4541",1972-06-06,177,322,0,145
"4542",1972-06-07,152,335,0,183
"4543",1972-06-08,197,340,0,143
"4544",1972-06-09,158,375,0,217
"4545",1972-06-10,196,381,0,185
"4546",1972-06-11,214,423,0,209
"4547",1972-06-12,215,357,0,142
"4548",1972-06-13,182,369,0,187
"4549",1972-06-14,259,388,0,129
"4550",1972-06-15,174,368,0,194
"4551",1972-06-16,261,376,0,115
"4552",1972-06-17,214,364,0,150
"4553",1972-06-18,194,310,0,116
"4554",1972-06-19,182,318,262,136
"4555",1972-06-20,229,279,22,50
"4556",1972-06-21,212,284,36,72
"4557",1972-06-22,201,291,200,90
"4558",1972-06-23,209,289,0,80
"4559",1972-06-24,186,294,0,108
"4560",1972-06-25,201,265,32,64
"4561",1972-06-26,187,316,0,129
"4562",1972-06-27,221,277,2,56
"4563",1972-06-28,183,338,0,155
"4564",1972-06-29,223,356,0,133
"4565",1972-06-30,222,337,0,115
"4566",1972-07-01,229,314,124,85
"4567",1972-07-02,215,281,2,66
"4568",1972-07-03,227,300,0,73
"4569",1972-07-04,252,361,4,109
"4570",1972-07-05,245,361,0,116
"4571",1972-07-06,273,371,0,98
"4572",1972-07-07,217,329,48,112
"4573",1972-07-08,192,254,9,62
"4574",1972-07-09,192,216,51,24
"4575",1972-07-10,176,247,0,71
"4576",1972-07-11,184,276,0,92
"4577",1972-07-12,178,307,0,129
"4578",1972-07-13,174,317,0,143
"4579",1972-07-14,185,320,0,135
"4580",1972-07-15,223,343,0,120
"4581",1972-07-16,243,328,0,85
"4582",1972-07-17,237,342,0,105
"4583",1972-07-18,247,355,522,108
"4584",1972-07-19,263,350,0,87
"4585",1972-07-20,277,357,0,80
"4586",1972-07-21,253,338,0,85
"4587",1972-07-22,244,298,0,54
"4588",1972-07-23,241,277,0,36
"4589",1972-07-24,180,318,0,138
"4590",1972-07-25,191,355,0,164
"4591",1972-07-26,206,348,2,142
"4592",1972-07-27,205,369,0,164
"4593",1972-07-28,220,315,0,95
"4594",1972-07-29,195,231,583,36
"4595",1972-07-30,196,242,441,46
"4596",1972-07-31,215,281,371,66
"4597",1972-08-01,233,305,0,72
"4598",1972-08-02,206,317,0,111
"4599",1972-08-03,224,333,0,109
"4600",1972-08-04,244,337,0,93
"4601",1972-08-05,215,294,365,79
"4602",1972-08-06,181,309,0,128
"4603",1972-08-07,200,303,0,103
"4604",1972-08-08,230,328,0,98
"4605",1972-08-09,244,310,0,66
"4606",1972-08-10,243,335,0,92
"4607",1972-08-11,239,342,0,103
"4608",1972-08-12,245,339,0,94
"4609",1972-08-13,230,330,0,100
"4610",1972-08-14,223,319,0,96
"4611",1972-08-15,249,351,0,102
"4612",1972-08-16,247,346,0,99
"4613",1972-08-17,242,311,1,69
"4614",1972-08-18,237,277,7,40
"4615",1972-08-19,190,278,0,88
"4616",1972-08-20,138,287,0,149
"4617",1972-08-21,169,283,0,114
"4618",1972-08-22,192,300,0,108
"4619",1972-08-23,220,310,1,90
"4620",1972-08-24,229,349,0,120
"4621",1972-08-25,199,244,2,45
"4622",1972-08-26,207,285,2,78
"4623",1972-08-27,213,258,57,45
"4624",1972-08-28,192,241,0,49
"4625",1972-08-29,179,269,1,90
"4626",1972-08-30,197,248,0,51
"4627",1972-08-31,157,259,0,102
"4628",1972-09-01,172,217,716,45
"4629",1972-09-02,173,199,187,26
"4630",1972-09-03,123,240,0,117
"4631",1972-09-04,109,257,0,148
"4632",1972-09-05,141,203,211,62
"4633",1972-09-06,150,259,1,109
"4634",1972-09-07,143,266,0,123
"4635",1972-09-08,154,257,0,103
"4636",1972-09-09,135,274,0,139
"4637",1972-09-10,179,262,0,83
"4638",1972-09-11,175,259,0,84
"4639",1972-09-12,158,243,0,85
"4640",1972-09-13,136,279,1,143
"4641",1972-09-14,155,292,0,137
"4642",1972-09-15,165,289,0,124
"4643",1972-09-16,145,316,0,171
"4644",1972-09-17,167,320,0,153
"4645",1972-09-18,191,295,0,104
"4646",1972-09-19,151,303,0,152
"4647",1972-09-20,161,309,0,148
"4648",1972-09-21,183,278,17,95
"4649",1972-09-22,146,197,0,51
"4650",1972-09-23,103,263,0,160
"4651",1972-09-24,113,269,0,156
"4652",1972-09-25,79,273,0,194
"4653",1972-09-26,98,308,0,210
"4654",1972-09-27,168,272,0,104
"4655",1972-09-28,143,249,0,106
"4656",1972-09-29,50,274,0,224
"4657",1972-09-30,106,274,0,168
"4658",1972-10-01,100,234,0,134
"4659",1972-10-02,140,193,270,53
"4660",1972-10-03,91,192,0,101
"4661",1972-10-04,83,267,0,184
"4662",1972-10-05,86,284,0,198
"4663",1972-10-06,157,281,0,124
"4664",1972-10-07,119,259,0,140
"4665",1972-10-08,135,274,1,139
"4666",1972-10-09,159,232,0,73
"4667",1972-10-10,138,202,0,64
"4668",1972-10-11,80,225,0,145
"4669",1972-10-12,98,252,0,154
"4670",1972-10-13,106,281,0,175
"4671",1972-10-14,141,256,0,115
"4672",1972-10-15,77,238,0,161
"4673",1972-10-16,118,172,0,54
"4674",1972-10-17,126,174,0,48
"4675",1972-10-18,133,154,27,21
"4676",1972-10-19,123,156,168,33
"4677",1972-10-20,96,160,115,64
"4678",1972-10-21,53,128,18,75
"4679",1972-10-22,22,169,0,147
"4680",1972-10-23,54,197,0,143
"4681",1972-10-24,65,210,0,145
"4682",1972-10-25,65,222,0,157
"4683",1972-10-26,66,220,0,154
"4684",1972-10-27,38,229,0,191
"4685",1972-10-28,104,245,0,141
"4686",1972-10-29,70,264,0,194
"4687",1972-10-30,77,187,0,110
"4688",1972-10-31,78,179,0,101
"4689",1972-11-01,77,182,0,105
"4690",1972-11-02,62,223,0,161
"4691",1972-11-03,94,199,0,105
"4692",1972-11-04,97,165,8,68
"4693",1972-11-05,67,100,112,33
"4694",1972-11-06,65,168,0,103
"4695",1972-11-07,45,161,0,116
"4696",1972-11-08,75,104,0,29
"4697",1972-11-09,94,128,0,34
"4698",1972-11-10,85,135,0,50
"4699",1972-11-11,63,163,0,100
"4700",1972-11-12,83,184,0,101
"4701",1972-11-13,83,122,48,39
"4702",1972-11-14,77,114,134,37
"4703",1972-11-15,71,94,26,23
"4704",1972-11-16,38,143,0,105
"4705",1972-11-17,17,94,0,77
"4706",1972-11-18,-11,140,0,151
"4707",1972-11-19,13,190,0,177
"4708",1972-11-20,7,136,0,129
"4709",1972-11-21,-44,106,0,150
"4710",1972-11-22,7,137,0,130
"4711",1972-11-23,-16,73,0,89
"4712",1972-11-24,-28,80,0,108
"4713",1972-11-25,-55,117,0,172
"4714",1972-11-26,-6,105,0,111
"4715",1972-11-27,-50,115,0,165
"4716",1972-11-28,3,170,0,167
"4717",1972-11-29,-15,170,0,185
"4718",1972-11-30,-8,118,0,126
"4719",1972-12-01,-43,128,0,171
"4720",1972-12-02,-26,117,0,143
"4721",1972-12-03,-25,167,0,192
"4722",1972-12-04,-18,174,0,192
"4723",1972-12-05,5,134,0,129
"4724",1972-12-06,-14,58,0,72
"4725",1972-12-07,-17,84,0,101
"4726",1972-12-08,-35,87,0,122
"4727",1972-12-09,-9,132,0,141
"4728",1972-12-10,-21,83,0,104
"4729",1972-12-11,-2,95,0,97
"4730",1972-12-12,-59,20,0,79
"4731",1972-12-13,-51,70,0,121
"4732",1972-12-14,-56,93,0,149
"4733",1972-12-15,-52,137,0,189
"4734",1972-12-16,-42,64,0,106
"4735",1972-12-17,-40,32,0,72
"4736",1972-12-18,-58,43,0,101
"4737",1972-12-19,-62,57,0,119
"4738",1972-12-20,-29,18,2,47
"4739",1972-12-21,6,54,0,48
"4740",1972-12-22,0,43,0,43
"4741",1972-12-23,8,26,7,18
"4742",1972-12-24,7,52,2,45
"4743",1972-12-25,-5,95,0,100
"4744",1972-12-26,2,44,0,42
"4745",1972-12-27,2,88,0,86
"4746",1972-12-28,-16,62,0,78
"4747",1972-12-29,-35,47,0,82
"4748",1972-12-30,-62,67,0,129
"4749",1972-12-31,-43,72,0,115
"4750",1973-01-01,5,59,0,54
"4751",1973-01-02,-50,26,0,76
"4752",1973-01-03,-43,47,0,90
"4753",1973-01-04,-85,62,0,147
"4754",1973-01-05,-75,33,0,108
"4755",1973-01-06,-13,73,0,86
"4756",1973-01-07,-37,26,0,63
"4757",1973-01-08,-33,125,0,158
"4758",1973-01-09,-66,72,0,138
"4759",1973-01-10,-44,36,0,80
"4760",1973-01-11,-50,17,0,67
"4761",1973-01-12,-52,46,0,98
"4762",1973-01-13,-14,12,0,26
"4763",1973-01-14,-25,30,0,55
"4764",1973-01-15,-25,33,0,58
"4765",1973-01-16,-33,82,0,115
"4766",1973-01-17,-15,88,0,103
"4767",1973-01-18,-53,88,0,141
"4768",1973-01-19,-57,27,0,84
"4769",1973-01-20,-13,59,0,72
"4770",1973-01-21,-24,20,0,44
"4771",1973-01-22,-2,16,45,18
"4772",1973-01-23,-5,41,134,46
"4773",1973-01-24,-20,59,0,79
"4774",1973-01-25,-48,10,0,58
"4775",1973-01-26,-23,20,0,43
"4776",1973-01-27,-27,35,0,62
"4777",1973-01-28,-33,69,0,102
"4778",1973-01-29,-5,72,0,77
"4779",1973-01-30,-36,113,0,149
"4780",1973-01-31,-28,118,0,146
"4781",1973-02-01,-4,58,0,62
"4782",1973-02-02,-38,6,74,44
"4783",1973-02-03,-86,17,27,103
"4784",1973-02-04,-26,45,0,71
"4785",1973-02-05,5,99,0,94
"4786",1973-02-06,-21,44,0,65
"4787",1973-02-07,-25,2,2,27
"4788",1973-02-08,-16,11,0,27
"4789",1973-02-09,-11,13,14,24
"4790",1973-02-10,-20,13,16,33
"4791",1973-02-11,-27,44,0,71
"4792",1973-02-12,11,61,0,50
"4793",1973-02-13,1,151,0,150
"4794",1973-02-14,-12,183,0,195
"4795",1973-02-15,9,199,0,190
"4796",1973-02-16,46,162,0,116
"4797",1973-02-17,23,102,0,79
"4798",1973-02-18,5,71,0,66
"4799",1973-02-19,-1,62,0,63
"4800",1973-02-20,-26,132,0,158
"4801",1973-02-21,19,168,0,149
"4802",1973-02-22,-8,94,0,102
"4803",1973-02-23,-30,124,0,154
"4804",1973-02-24,-44,46,0,90
"4805",1973-02-25,-1,65,0,66
"4806",1973-02-26,18,72,0,54
"4807",1973-02-27,39,119,0,80
"4808",1973-02-28,52,127,0,75
"4809",1973-03-01,25,67,8,42
"4810",1973-03-02,-5,110,2,115
"4811",1973-03-03,18,152,0,134
"4812",1973-03-04,40,113,0,73
"4813",1973-03-05,13,108,15,95
"4814",1973-03-06,0,48,95,48
"4815",1973-03-07,3,143,0,140
"4816",1973-03-08,15,97,0,82
"4817",1973-03-09,45,62,38,17
"4818",1973-03-10,40,85,0,45
"4819",1973-03-11,49,97,0,48
"4820",1973-03-12,56,125,0,69
"4821",1973-03-13,7,92,0,85
"4822",1973-03-14,23,115,0,92
"4823",1973-03-15,30,173,0,143
"4824",1973-03-16,27,135,0,108
"4825",1973-03-17,11,165,0,154
"4826",1973-03-18,20,220,0,200
"4827",1973-03-19,76,231,0,155
"4828",1973-03-20,78,168,0,90
"4829",1973-03-21,-10,167,0,177
"4830",1973-03-22,56,203,0,147
"4831",1973-03-23,63,220,0,157
"4832",1973-03-24,70,155,0,85
"4833",1973-03-25,37,142,0,105
"4834",1973-03-26,38,211,0,173
"4835",1973-03-27,70,278,0,208
"4836",1973-03-28,107,226,0,119
"4837",1973-03-29,85,178,4,93
"4838",1973-03-30,65,236,0,171
"4839",1973-03-31,103,224,0,121
"4840",1973-04-01,66,183,0,117
"4841",1973-04-02,52,109,0,57
"4842",1973-04-03,23,189,0,166
"4843",1973-04-04,73,190,0,117
"4844",1973-04-05,20,202,0,182
"4845",1973-04-06,82,260,0,178
"4846",1973-04-07,95,254,0,159
"4847",1973-04-08,82,198,0,116
"4848",1973-04-09,107,209,1,102
"4849",1973-04-10,65,170,187,105
"4850",1973-04-11,69,176,60,107
"4851",1973-04-12,59,199,0,140
"4852",1973-04-13,87,175,25,88
"4853",1973-04-14,102,153,32,51
"4854",1973-04-15,65,180,0,115
"4855",1973-04-16,124,181,10,57
"4856",1973-04-17,58,206,0,148
"4857",1973-04-18,90,248,0,158
"4858",1973-04-19,54,283,0,229
"4859",1973-04-20,85,297,0,212
"4860",1973-04-21,110,289,0,179
"4861",1973-04-22,150,245,0,95
"4862",1973-04-23,153,286,1,133
"4863",1973-04-24,152,329,0,177
"4864",1973-04-25,189,259,0,70
"4865",1973-04-26,123,250,7,127
"4866",1973-04-27,154,222,5,68
"4867",1973-04-28,153,252,0,99
"4868",1973-04-29,178,220,25,42
"4869",1973-04-30,152,197,558,45
"4870",1973-05-01,159,251,1,92
"4871",1973-05-02,145,230,32,85
"4872",1973-05-03,129,170,211,41
"4873",1973-05-04,61,217,0,156
"4874",1973-05-05,133,238,0,105
"4875",1973-05-06,150,211,15,61
"4876",1973-05-07,149,207,0,58
"4877",1973-05-08,126,262,0,136
"4878",1973-05-09,122,244,1,122
"4879",1973-05-10,120,239,0,119
"4880",1973-05-11,116,249,0,133
"4881",1973-05-12,125,322,0,197
"4882",1973-05-13,165,239,0,74
"4883",1973-05-14,166,227,1,61
"4884",1973-05-15,168,247,0,79
"4885",1973-05-16,118,273,0,155
"4886",1973-05-17,139,242,2,103
"4887",1973-05-18,134,283,0,149
"4888",1973-05-19,168,246,0,78
"4889",1973-05-20,130,260,0,130
"4890",1973-05-21,99,256,0,157
"4891",1973-05-22,154,274,0,120
"4892",1973-05-23,105,262,0,157
"4893",1973-05-24,113,219,41,106
"4894",1973-05-25,162,240,3,78
"4895",1973-05-26,145,283,1,138
"4896",1973-05-27,170,240,14,70
"4897",1973-05-28,161,266,116,105
"4898",1973-05-29,124,314,0,190
"4899",1973-05-30,185,257,3,72
"4900",1973-05-31,163,307,0,144
"4901",1973-06-01,180,266,0,86
"4902",1973-06-02,170,275,0,105
"4903",1973-06-03,152,305,0,153
"4904",1973-06-04,152,287,73,135
"4905",1973-06-05,129,264,20,135
"4906",1973-06-06,140,357,0,217
"4907",1973-06-07,171,375,0,204
"4908",1973-06-08,221,342,0,121
"4909",1973-06-09,230,352,0,122
"4910",1973-06-10,190,278,162,88
"4911",1973-06-11,157,267,17,110
"4912",1973-06-12,173,267,0,94
"4913",1973-06-13,187,272,0,85
"4914",1973-06-14,195,314,0,119
"4915",1973-06-15,195,296,0,101
"4916",1973-06-16,197,303,0,106
"4917",1973-06-17,228,315,0,87
"4918",1973-06-18,211,323,0,112
"4919",1973-06-19,216,306,0,90
"4920",1973-06-20,227,304,0,77
"4921",1973-06-21,224,354,0,130
"4922",1973-06-22,228,363,0,135
"4923",1973-06-23,235,352,0,117
"4924",1973-06-24,241,348,0,107
"4925",1973-06-25,235,359,0,124
"4926",1973-06-26,205,266,47,61
"4927",1973-06-27,197,283,0,86
"4928",1973-06-28,207,328,0,121
"4929",1973-06-29,208,334,0,126
"4930",1973-06-30,226,331,0,105
"4931",1973-07-01,222,290,259,68
"4932",1973-07-02,172,238,606,66
"4933",1973-07-03,199,302,0,103
"4934",1973-07-04,215,315,0,100
"4935",1973-07-05,222,315,73,93
"4936",1973-07-06,251,306,51,55
"4937",1973-07-07,239,312,34,73
"4938",1973-07-08,227,309,7,82
"4939",1973-07-09,239,330,0,91
"4940",1973-07-10,241,327,0,86
"4941",1973-07-11,206,273,5,67
"4942",1973-07-12,207,321,0,114
"4943",1973-07-13,244,340,0,96
"4944",1973-07-14,242,296,87,54
"4945",1973-07-15,195,266,328,71
"4946",1973-07-16,208,277,0,69
"4947",1973-07-17,201,297,0,96
"4948",1973-07-18,232,313,120,81
"4949",1973-07-19,211,290,513,79
"4950",1973-07-20,206,331,0,125
"4951",1973-07-21,206,328,0,122
"4952",1973-07-22,236,358,0,122
"4953",1973-07-23,206,317,891,111
"4954",1973-07-24,235,329,69,94
"4955",1973-07-25,217,273,173,56
"4956",1973-07-26,226,303,10,77
"4957",1973-07-27,234,323,0,89
"4958",1973-07-28,245,309,402,64
"4959",1973-07-29,240,312,57,72
"4960",1973-07-30,213,321,0,108
"4961",1973-07-31,253,291,0,38
"4962",1973-08-01,226,271,2,45
"4963",1973-08-02,206,345,0,139
"4964",1973-08-03,218,339,0,121
"4965",1973-08-04,237,336,0,99
"4966",1973-08-05,262,345,0,83
"4967",1973-08-06,257,343,0,86
"4968",1973-08-07,259,347,0,88
"4969",1973-08-08,259,356,0,97
"4970",1973-08-09,240,338,0,98
"4971",1973-08-10,242,337,0,95
"4972",1973-08-11,239,344,0,105
"4973",1973-08-12,252,346,0,94
"4974",1973-08-13,231,334,0,103
"4975",1973-08-14,229,329,368,100
"4976",1973-08-15,235,311,0,76
"4977",1973-08-16,231,322,0,91
"4978",1973-08-17,230,338,0,108
"4979",1973-08-18,234,292,0,58
"4980",1973-08-19,240,280,0,40
"4981",1973-08-20,229,316,0,87
"4982",1973-08-21,244,343,0,99
"4983",1973-08-22,246,303,5,57
"4984",1973-08-23,227,296,0,69
"4985",1973-08-24,215,317,0,102
"4986",1973-08-25,222,340,0,118
"4987",1973-08-26,228,340,0,112
"4988",1973-08-27,214,292,147,78
"4989",1973-08-28,156,289,0,133
"4990",1973-08-29,198,285,0,87
"4991",1973-08-30,166,254,391,88
"4992",1973-08-31,166,246,96,80
"4993",1973-09-01,150,276,0,126
"4994",1973-09-02,173,296,0,123
"4995",1973-09-03,186,283,0,97
"4996",1973-09-04,191,254,6,63
"4997",1973-09-05,192,230,308,38
"4998",1973-09-06,176,250,140,74
"4999",1973-09-07,171,236,184,65
"5000",1973-09-08,157,247,2,90
"5001",1973-09-09,190,237,0,47
"5002",1973-09-10,185,254,0,69
"5003",1973-09-11,160,248,0,88
"5004",1973-09-12,166,278,0,112
"5005",1973-09-13,153,264,12,111
"5006",1973-09-14,182,256,10,74
"5007",1973-09-15,172,277,0,105
"5008",1973-09-16,147,277,0,130
"5009",1973-09-17,171,282,0,111
"5010",1973-09-18,155,284,0,129
"5011",1973-09-19,142,292,0,150
"5012",1973-09-20,136,302,0,166
"5013",1973-09-21,152,278,63,126
"5014",1973-09-22,134,309,0,175
"5015",1973-09-23,169,311,0,142
"5016",1973-09-24,192,236,2,44
"5017",1973-09-25,167,250,4,83
"5018",1973-09-26,105,216,0,111
"5019",1973-09-27,74,228,2,154
"5020",1973-09-28,125,174,112,49
"5021",1973-09-29,114,235,0,121
"5022",1973-09-30,113,277,1,164
"5023",1973-10-01,160,204,0,44
"5024",1973-10-02,144,182,20,38
"5025",1973-10-03,136,162,41,26
"5026",1973-10-04,111,146,72,35
"5027",1973-10-05,98,121,261,23
"5028",1973-10-06,105,154,99,49
"5029",1973-10-07,122,181,0,59
"5030",1973-10-08,75,194,0,119
"5031",1973-10-09,96,185,0,89
"5032",1973-10-10,132,217,0,85
"5033",1973-10-11,112,237,0,125
"5034",1973-10-12,135,202,0,67
"5035",1973-10-13,110,164,6,54
"5036",1973-10-14,61,194,0,133
"5037",1973-10-15,70,211,0,141
"5038",1973-10-16,67,227,0,160
"5039",1973-10-17,70,202,0,132
"5040",1973-10-18,72,218,0,146
"5041",1973-10-19,89,192,0,103
"5042",1973-10-20,116,251,0,135
"5043",1973-10-21,114,212,0,98
"5044",1973-10-22,90,208,0,118
"5045",1973-10-23,72,206,0,134
"5046",1973-10-24,13,184,0,171
"5047",1973-10-25,50,202,0,152
"5048",1973-10-26,99,179,0,80
"5049",1973-10-27,44,180,0,136
"5050",1973-10-28,27,209,0,182
"5051",1973-10-29,58,220,0,162
"5052",1973-10-30,74,230,0,156
"5053",1973-10-31,97,184,0,87
"5054",1973-11-01,44,167,0,123
"5055",1973-11-02,74,108,0,34
"5056",1973-11-03,27,172,0,145
"5057",1973-11-04,83,115,12,32
"5058",1973-11-05,71,160,0,89
"5059",1973-11-06,28,198,0,170
"5060",1973-11-07,73,173,0,100
"5061",1973-11-08,52,166,0,114
"5062",1973-11-09,76,149,0,73
"5063",1973-11-10,17,156,0,139
"5064",1973-11-11,41,150,0,109
"5065",1973-11-12,44,163,0,119
"5066",1973-11-13,11,192,0,181
"5067",1973-11-14,39,189,0,150
"5068",1973-11-15,54,193,0,139
"5069",1973-11-16,66,185,0,119
"5070",1973-11-17,5,132,0,127
"5071",1973-11-18,-20,169,0,189
"5072",1973-11-19,29,192,0,163
"5073",1973-11-20,55,202,0,147
"5074",1973-11-21,-14,162,0,176
"5075",1973-11-22,-6,156,0,162
"5076",1973-11-23,40,187,0,147
"5077",1973-11-24,59,148,0,89
"5078",1973-11-25,-49,96,0,145
"5079",1973-11-26,38,169,0,131
"5080",1973-11-27,6,115,0,109
"5081",1973-11-28,-35,138,0,173
"5082",1973-11-29,30,167,0,137
"5083",1973-11-30,35,165,0,130
"5084",1973-12-01,-21,194,0,215
"5085",1973-12-02,31,110,0,79
"5086",1973-12-03,-58,98,0,156
"5087",1973-12-04,-55,48,0,103
"5088",1973-12-05,-55,127,0,182
"5089",1973-12-06,6,139,0,133
"5090",1973-12-07,-38,104,0,142
"5091",1973-12-08,-16,98,0,114
"5092",1973-12-09,-63,123,0,186
"5093",1973-12-10,-40,99,0,139
"5094",1973-12-11,-20,138,0,158
"5095",1973-12-12,-40,98,0,138
"5096",1973-12-13,-37,133,0,170
"5097",1973-12-14,-42,114,0,156
"5098",1973-12-15,3,129,0,126
"5099",1973-12-16,-48,115,0,163
"5100",1973-12-17,-18,127,0,145
"5101",1973-12-18,-19,64,0,83
"5102",1973-12-19,-44,110,0,154
"5103",1973-12-20,-37,113,0,150
"5104",1973-12-21,-25,80,0,105
"5105",1973-12-22,-36,78,0,114
"5106",1973-12-23,-41,44,0,85
"5107",1973-12-24,-118,15,0,133
"5108",1973-12-25,-111,51,0,162
"5109",1973-12-26,-92,106,0,198
"5110",1973-12-27,-3,66,0,69
"5111",1973-12-28,-38,50,0,88
"5112",1973-12-29,-69,87,0,156
"5113",1973-12-30,-15,109,0,124
"5114",1973-12-31,14,111,0,97
"5115",1974-01-01,8,157,0,149
"5116",1974-01-02,-6,147,0,153
"5117",1974-01-03,-55,106,0,161
"5118",1974-01-04,-66,130,0,196
"5119",1974-01-05,-47,96,0,143
"5120",1974-01-06,-52,113,0,165
"5121",1974-01-07,-52,103,0,155
"5122",1974-01-08,-33,57,0,90
"5123",1974-01-09,-7,33,0,40
"5124",1974-01-10,-34,3,2,37
"5125",1974-01-11,-77,22,0,99
"5126",1974-01-12,-93,35,0,128
"5127",1974-01-13,-68,20,0,88
"5128",1974-01-14,-23,36,0,59
"5129",1974-01-15,-52,0,0,52
"5130",1974-01-16,-61,4,0,65
"5131",1974-01-17,-73,43,0,116
"5132",1974-01-18,-68,60,0,128
"5133",1974-01-19,-68,40,1,108
"5134",1974-01-20,-52,45,18,97
"5135",1974-01-21,-66,44,0,110
"5136",1974-01-22,-56,40,0,96
"5137",1974-01-23,-47,-5,0,42
"5138",1974-01-24,-78,7,0,85
"5139",1974-01-25,-23,44,0,67
"5140",1974-01-26,-33,51,0,84
"5141",1974-01-27,-34,10,2,44
"5142",1974-01-28,-58,-25,27,33
"5143",1974-01-29,-65,-20,8,45
"5144",1974-01-30,-90,-14,0,76
"5145",1974-01-31,-73,17,0,90
"5146",1974-02-01,-49,17,0,66
"5147",1974-02-02,-46,7,0,53
"5148",1974-02-03,-12,13,0,25
"5149",1974-02-04,-22,8,83,30
"5150",1974-02-05,-51,-17,2,34
"5151",1974-02-06,-68,-26,1,42
"5152",1974-02-07,-112,14,0,126
"5153",1974-02-08,-33,37,0,70
"5154",1974-02-09,-17,53,0,70
"5155",1974-02-10,-30,56,0,86
"5156",1974-02-11,-51,87,0,138
"5157",1974-02-12,-22,105,0,127
"5158",1974-02-13,1,74,0,73
"5159",1974-02-14,15,114,0,99
"5160",1974-02-15,3,178,0,175
"5161",1974-02-16,20,177,0,157
"5162",1974-02-17,6,195,0,189
"5163",1974-02-18,23,184,0,161
"5164",1974-02-19,23,139,0,116
"5165",1974-02-20,-2,99,0,101
"5166",1974-02-21,55,106,0,51
"5167",1974-02-22,-40,87,17,127
"5168",1974-02-23,-55,-21,1,34
"5169",1974-02-24,-66,-7,23,59
"5170",1974-02-25,-38,27,0,65
"5171",1974-02-26,-23,72,0,95
"5172",1974-02-27,-50,80,0,130
"5173",1974-02-28,10,107,0,97
"5174",1974-03-01,-35,142,0,177
"5175",1974-03-02,14,107,0,93
"5176",1974-03-03,-12,156,0,168
"5177",1974-03-04,20,132,0,112
"5178",1974-03-05,6,103,261,97
"5179",1974-03-06,16,74,111,58
"5180",1974-03-07,4,91,0,87
"5181",1974-03-08,10,98,0,88
"5182",1974-03-09,50,151,0,101
"5183",1974-03-10,10,105,0,95
"5184",1974-03-11,-26,36,0,62
"5185",1974-03-12,-10,52,0,62
"5186",1974-03-13,0,78,0,78
"5187",1974-03-14,2,139,0,137
"5188",1974-03-15,40,160,0,120
"5189",1974-03-16,27,124,0,97
"5190",1974-03-17,40,166,0,126
"5191",1974-03-18,-20,180,0,200
"5192",1974-03-19,20,212,0,192
"5193",1974-03-20,-2,187,0,189
"5194",1974-03-21,-13,109,0,122
"5195",1974-03-22,-3,95,0,98
"5196",1974-03-23,5,135,0,130
"5197",1974-03-24,50,120,0,70
"5198",1974-03-25,57,85,42,28
"5199",1974-03-26,45,144,0,99
"5200",1974-03-27,36,180,0,144
"5201",1974-03-28,28,261,0,233
"5202",1974-03-29,67,265,0,198
"5203",1974-03-30,93,195,0,102
"5204",1974-03-31,76,175,0,99
"5205",1974-04-01,-7,145,0,152
"5206",1974-04-02,13,214,0,201
"5207",1974-04-03,103,291,0,188
"5208",1974-04-04,98,255,0,157
"5209",1974-04-05,91,277,0,186
"5210",1974-04-06,136,245,31,109
"5211",1974-04-07,99,205,14,106
"5212",1974-04-08,76,212,0,136
"5213",1974-04-09,78,242,0,164
"5214",1974-04-10,92,244,0,152
"5215",1974-04-11,100,281,0,181
"5216",1974-04-12,92,197,588,105
"5217",1974-04-13,89,239,0,150
"5218",1974-04-14,118,217,0,99
"5219",1974-04-15,123,232,0,109
"5220",1974-04-16,104,250,0,146
"5221",1974-04-17,144,225,276,81
"5222",1974-04-18,129,192,0,63
"5223",1974-04-19,76,167,0,91
"5224",1974-04-20,109,187,0,78
"5225",1974-04-21,75,256,0,181
"5226",1974-04-22,113,240,0,127
"5227",1974-04-23,156,266,0,110
"5228",1974-04-24,97,258,0,161
"5229",1974-04-25,53,236,0,183
"5230",1974-04-26,66,252,0,186
"5231",1974-04-27,126,227,0,101
"5232",1974-04-28,97,232,0,135
"5233",1974-04-29,143,294,0,151
"5234",1974-04-30,155,253,0,98
"5235",1974-05-01,72,248,0,176
"5236",1974-05-02,123,277,0,154
"5237",1974-05-03,135,293,0,158
"5238",1974-05-04,155,233,0,78
"5239",1974-05-05,122,223,0,101
"5240",1974-05-06,114,225,0,111
"5241",1974-05-07,96,236,0,140
"5242",1974-05-08,151,227,11,76
"5243",1974-05-09,89,264,0,175
"5244",1974-05-10,141,279,0,138
"5245",1974-05-11,113,300,0,187
"5246",1974-05-12,169,246,121,77
"5247",1974-05-13,159,243,24,84
"5248",1974-05-14,146,235,0,89
"5249",1974-05-15,109,284,0,175
"5250",1974-05-16,160,293,0,133
"5251",1974-05-17,189,256,795,67
"5252",1974-05-18,179,232,7,53
"5253",1974-05-19,179,246,26,67
"5254",1974-05-20,183,264,0,81
"5255",1974-05-21,139,230,177,91
"5256",1974-05-22,126,312,0,186
"5257",1974-05-23,168,289,0,121
"5258",1974-05-24,165,354,0,189
"5259",1974-05-25,161,360,0,199
"5260",1974-05-26,158,361,0,203
"5261",1974-05-27,183,332,0,149
"5262",1974-05-28,202,314,0,112
"5263",1974-05-29,170,315,0,145
"5264",1974-05-30,183,300,44,117
"5265",1974-05-31,184,364,0,180
"5266",1974-06-01,150,342,0,192
"5267",1974-06-02,182,353,0,171
"5268",1974-06-03,151,321,0,170
"5269",1974-06-04,152,292,0,140
"5270",1974-06-05,148,290,0,142
"5271",1974-06-06,222,270,0,48
"5272",1974-06-07,162,342,0,180
"5273",1974-06-08,223,359,0,136
"5274",1974-06-09,189,318,409,129
"5275",1974-06-10,160,273,0,113
"5276",1974-06-11,180,284,0,104
"5277",1974-06-12,206,277,0,71
"5278",1974-06-13,177,295,0,118
"5279",1974-06-14,176,301,0,125
"5280",1974-06-15,174,319,0,145
"5281",1974-06-16,224,378,0,154
"5282",1974-06-17,229,334,0,105
"5283",1974-06-18,200,280,0,80
"5284",1974-06-19,191,255,8,64
"5285",1974-06-20,210,357,0,147
"5286",1974-06-21,216,351,0,135
"5287",1974-06-22,184,323,0,139
"5288",1974-06-23,183,338,0,155
"5289",1974-06-24,244,342,0,98
"5290",1974-06-25,219,337,0,118
"5291",1974-06-26,221,326,0,105
"5292",1974-06-27,195,328,0,133
"5293",1974-06-28,181,345,0,164
"5294",1974-06-29,207,300,15,93
"5295",1974-06-30,189,301,0,112
"5296",1974-07-01,187,302,0,115
"5297",1974-07-02,189,306,0,117
"5298",1974-07-03,209,298,9,89
"5299",1974-07-04,205,316,0,111
"5300",1974-07-05,238,325,0,87
"5301",1974-07-06,236,331,0,95
"5302",1974-07-07,240,300,101,60
"5303",1974-07-08,235,330,5,95
"5304",1974-07-09,242,387,7,145
"5305",1974-07-10,225,354,0,129
"5306",1974-07-11,260,334,0,74
"5307",1974-07-12,216,319,0,103
"5308",1974-07-13,184,347,0,163
"5309",1974-07-14,213,333,0,120
"5310",1974-07-15,227,354,0,127
"5311",1974-07-16,234,337,0,103
"5312",1974-07-17,222,318,0,96
"5313",1974-07-18,223,314,0,91
"5314",1974-07-19,214,314,0,100
"5315",1974-07-20,235,322,6,87
"5316",1974-07-21,234,343,0,109
"5317",1974-07-22,265,362,0,97
"5318",1974-07-23,229,327,2,98
"5319",1974-07-24,220,338,324,118
"5320",1974-07-25,253,338,0,85
"5321",1974-07-26,249,310,1,61
"5322",1974-07-27,245,319,74,74
"5323",1974-07-28,245,314,0,69
"5324",1974-07-29,245,325,0,80
"5325",1974-07-30,260,336,0,76
"5326",1974-07-31,238,335,0,97
"5327",1974-08-01,241,307,251,66
"5328",1974-08-02,225,347,0,122
"5329",1974-08-03,227,337,7,110
"5330",1974-08-04,218,266,400,48
"5331",1974-08-05,222,297,0,75
"5332",1974-08-06,233,270,142,37
"5333",1974-08-07,221,310,311,89
"5334",1974-08-08,230,329,35,99
"5335",1974-08-09,244,299,26,55
"5336",1974-08-10,223,303,0,80
"5337",1974-08-11,216,288,0,72
"5338",1974-08-12,210,262,1,52
"5339",1974-08-13,206,262,22,56
"5340",1974-08-14,207,285,0,78
"5341",1974-08-15,195,315,0,120
"5342",1974-08-16,219,316,0,97
"5343",1974-08-17,227,295,0,68
"5344",1974-08-18,215,315,0,100
"5345",1974-08-19,218,320,0,102
"5346",1974-08-20,223,320,0,97
"5347",1974-08-21,219,344,0,125
"5348",1974-08-22,209,288,170,79
"5349",1974-08-23,202,266,0,64
"5350",1974-08-24,156,300,0,144
"5351",1974-08-25,163,325,0,162
"5352",1974-08-26,169,318,0,149
"5353",1974-08-27,202,274,0,72
"5354",1974-08-28,184,254,0,70
"5355",1974-08-29,168,273,0,105
"5356",1974-08-30,148,311,0,163
"5357",1974-08-31,162,341,13,179
"5358",1974-09-01,170,312,125,142
"5359",1974-09-02,181,316,0,135
"5360",1974-09-03,195,338,0,143
"5361",1974-09-04,234,320,7,86
"5362",1974-09-05,222,316,0,94
"5363",1974-09-06,220,280,0,60
"5364",1974-09-07,159,344,0,185
"5365",1974-09-08,151,310,0,159
"5366",1974-09-09,190,249,70,59
"5367",1974-09-10,180,212,159,32
"5368",1974-09-11,172,234,35,62
"5369",1974-09-12,186,213,201,27
"5370",1974-09-13,186,211,340,25
"5371",1974-09-14,157,227,6,70
"5372",1974-09-15,108,253,0,145
"5373",1974-09-16,153,250,0,97
"5374",1974-09-17,143,230,0,87
"5375",1974-09-18,110,240,0,130
"5376",1974-09-19,101,236,0,135
"5377",1974-09-20,130,268,0,138
"5378",1974-09-21,127,309,0,182
"5379",1974-09-22,144,312,0,168
"5380",1974-09-23,144,275,0,131
"5381",1974-09-24,156,308,0,152
"5382",1974-09-25,171,307,0,136
"5383",1974-09-26,156,261,0,105
"5384",1974-09-27,123,300,0,177
"5385",1974-09-28,150,249,0,99
"5386",1974-09-29,125,205,71,80
"5387",1974-09-30,115,136,234,21
"5388",1974-10-01,120,148,106,28
"5389",1974-10-02,136,162,300,26
"5390",1974-10-03,129,190,35,61
"5391",1974-10-04,100,176,1,76
"5392",1974-10-05,92,184,0,92
"5393",1974-10-06,90,206,0,116
"5394",1974-10-07,146,234,28,88
"5395",1974-10-08,118,234,0,116
"5396",1974-10-09,95,180,0,85
"5397",1974-10-10,36,204,0,168
"5398",1974-10-11,76,224,0,148
"5399",1974-10-12,45,224,0,179
"5400",1974-10-13,68,246,0,178
"5401",1974-10-14,125,228,0,103
"5402",1974-10-15,82,165,0,83
"5403",1974-10-16,113,145,75,32
"5404",1974-10-17,125,151,195,26
"5405",1974-10-18,130,206,6,76
"5406",1974-10-19,88,237,0,149
"5407",1974-10-20,77,163,1,86
"5408",1974-10-21,63,217,0,154
"5409",1974-10-22,31,129,0,98
"5410",1974-10-23,-6,169,0,175
"5411",1974-10-24,92,207,0,115
"5412",1974-10-25,116,187,0,71
"5413",1974-10-26,127,156,18,29
"5414",1974-10-27,107,160,2,53
"5415",1974-10-28,90,144,0,54
"5416",1974-10-29,108,173,0,65
"5417",1974-10-30,85,222,0,137
"5418",1974-10-31,56,150,0,94
"5419",1974-11-01,17,154,0,137
"5420",1974-11-02,52,172,0,120
"5421",1974-11-03,85,157,19,72
"5422",1974-11-04,74,210,6,136
"5423",1974-11-05,120,206,0,86
"5424",1974-11-06,90,231,0,141
"5425",1974-11-07,90,229,0,139
"5426",1974-11-08,45,166,65,121
"5427",1974-11-09,36,60,32,24
"5428",1974-11-10,30,50,3,20
"5429",1974-11-11,20,45,10,25
"5430",1974-11-12,-6,47,0,53
"5431",1974-11-13,20,35,30,15
"5432",1974-11-14,15,63,5,48
"5433",1974-11-15,38,57,17,19
"5434",1974-11-16,37,98,13,61
"5435",1974-11-17,46,118,0,72
"5436",1974-11-18,-15,142,0,157
"5437",1974-11-19,16,172,0,156
"5438",1974-11-20,44,175,0,131
"5439",1974-11-21,5,166,0,161
"5440",1974-11-22,33,174,0,141
"5441",1974-11-23,44,158,0,114
"5442",1974-11-24,24,155,0,131
"5443",1974-11-25,44,133,0,89
"5444",1974-11-26,15,117,0,102
"5445",1974-11-27,0,150,0,150
"5446",1974-11-28,2,120,0,118
"5447",1974-11-29,54,102,1,48
"5448",1974-11-30,28,62,260,34
"5449",1974-12-01,28,59,203,31
"5450",1974-12-02,27,60,0,33
"5451",1974-12-03,-14,30,6,44
"5452",1974-12-04,-20,48,0,68
"5453",1974-12-05,-4,53,0,57
"5454",1974-12-06,-50,60,0,110
"5455",1974-12-07,-6,17,2,23
"5456",1974-12-08,-27,28,0,55
"5457",1974-12-09,-25,20,0,45
"5458",1974-12-10,-27,17,0,44
"5459",1974-12-11,-55,21,0,76
"5460",1974-12-12,-26,23,3,49
"5461",1974-12-13,-50,49,1,99
"5462",1974-12-14,-59,19,0,78
"5463",1974-12-15,-39,32,0,71
"5464",1974-12-16,-41,-2,0,39
"5465",1974-12-17,-24,34,0,58
"5466",1974-12-18,-75,45,0,120
"5467",1974-12-19,-41,53,0,94
"5468",1974-12-20,-27,59,0,86
"5469",1974-12-21,-66,81,0,147
"5470",1974-12-22,-58,98,0,156
"5471",1974-12-23,-26,87,0,113
"5472",1974-12-24,-30,75,0,105
"5473",1974-12-25,-50,79,0,129
"5474",1974-12-26,-39,44,0,83
"5475",1974-12-27,0,21,84,21
"5476",1974-12-28,-12,28,5,40
"5477",1974-12-29,-21,31,0,52
"5478",1974-12-30,-17,27,2,44
"5479",1974-12-31,-11,3,248,14
"5480",1975-01-01,-101,9,2,110
"5481",1975-01-02,-122,30,0,152
"5482",1975-01-03,-123,17,0,140
"5483",1975-01-04,-95,52,0,147
"5484",1975-01-05,-84,-6,0,78
"5485",1975-01-06,-84,30,0,114
"5486",1975-01-07,-60,27,0,87
"5487",1975-01-08,-70,13,0,83
"5488",1975-01-09,-69,41,0,110
"5489",1975-01-10,-18,71,0,89
"5490",1975-01-11,-50,94,0,144
"5491",1975-01-12,-11,134,0,145
"5492",1975-01-13,-22,87,0,109
"5493",1975-01-14,-16,73,0,89
"5494",1975-01-15,-4,56,0,60
"5495",1975-01-16,-37,62,0,99
"5496",1975-01-17,-21,62,0,83
"5497",1975-01-18,-18,77,0,95
"5498",1975-01-19,-23,68,0,91
"5499",1975-01-20,-26,57,0,83
"5500",1975-01-21,-13,75,0,88
"5501",1975-01-22,-46,122,0,168
"5502",1975-01-23,-24,127,0,151
"5503",1975-01-24,27,111,0,84
"5504",1975-01-25,-17,61,0,78
"5505",1975-01-26,4,83,0,79
"5506",1975-01-27,-19,102,0,121
"5507",1975-01-28,-38,45,0,83
"5508",1975-01-29,-21,71,0,92
"5509",1975-01-30,-69,54,0,123
"5510",1975-01-31,-33,70,0,103
"5511",1975-02-01,-20,24,37,44
"5512",1975-02-02,-11,19,3,30
"5513",1975-02-03,-11,14,34,25
"5514",1975-02-04,-46,63,0,109
"5515",1975-02-05,5,28,0,23
"5516",1975-02-06,0,39,0,39
"5517",1975-02-07,-21,34,0,55
"5518",1975-02-08,-41,60,0,101
"5519",1975-02-09,-45,83,0,128
"5520",1975-02-10,-10,89,0,99
"5521",1975-02-11,-32,132,0,164
"5522",1975-02-12,17,99,0,82
"5523",1975-02-13,-44,116,0,160
"5524",1975-02-14,6,117,0,111
"5525",1975-02-15,-40,133,0,173
"5526",1975-02-16,-30,166,0,196
"5527",1975-02-17,26,107,0,81
"5528",1975-02-18,-57,122,0,179
"5529",1975-02-19,-40,137,0,177
"5530",1975-02-20,-12,74,0,86
"5531",1975-02-21,-60,104,0,164
"5532",1975-02-22,-66,90,0,156
"5533",1975-02-23,-6,170,0,176
"5534",1975-02-24,-15,225,0,240
"5535",1975-02-25,7,118,0,111
"5536",1975-02-26,-3,95,0,98
"5537",1975-02-27,-44,138,0,182
"5538",1975-02-28,-11,128,0,139
"5539",1975-03-01,31,75,0,44
"5540",1975-03-02,-7,135,0,142
"5541",1975-03-03,45,100,0,55
"5542",1975-03-04,10,82,2,72
"5543",1975-03-05,1,88,21,87
"5544",1975-03-06,5,132,0,127
"5545",1975-03-07,-5,127,0,132
"5546",1975-03-08,49,105,3,56
"5547",1975-03-09,28,150,0,122
"5548",1975-03-10,4,165,0,161
"5549",1975-03-11,58,145,0,87
"5550",1975-03-12,34,104,0,70
"5551",1975-03-13,39,109,0,70
"5552",1975-03-14,17,161,0,144
"5553",1975-03-15,3,193,0,190
"5554",1975-03-16,40,193,0,153
"5555",1975-03-17,28,215,0,187
"5556",1975-03-18,103,220,0,117
"5557",1975-03-19,81,193,0,112
"5558",1975-03-20,-6,176,0,182
"5559",1975-03-21,77,203,0,126
"5560",1975-03-22,75,140,0,65
"5561",1975-03-23,-3,178,0,181
"5562",1975-03-24,25,196,0,171
"5563",1975-03-25,85,148,5,63
"5564",1975-03-26,-8,148,0,156
"5565",1975-03-27,76,175,0,99
"5566",1975-03-28,39,233,0,194
"5567",1975-03-29,112,200,0,88
"5568",1975-03-30,60,162,0,102
"5569",1975-03-31,29,156,0,127
"5570",1975-04-01,15,164,0,149
"5571",1975-04-02,-13,188,0,201
"5572",1975-04-03,79,204,0,125
"5573",1975-04-04,104,176,1,72
"5574",1975-04-05,80,219,0,139
"5575",1975-04-06,49,239,0,190
"5576",1975-04-07,128,198,0,70
"5577",1975-04-08,94,222,0,128
"5578",1975-04-09,121,255,0,134
"5579",1975-04-10,116,208,0,92
"5580",1975-04-11,93,230,0,137
"5581",1975-04-12,79,264,0,185
"5582",1975-04-13,107,245,0,138
"5583",1975-04-14,130,261,0,131
"5584",1975-04-15,110,223,0,113
"5585",1975-04-16,103,215,0,112
"5586",1975-04-17,95,182,261,87
"5587",1975-04-18,91,115,233,24
"5588",1975-04-19,84,110,195,26
"5589",1975-04-20,78,179,35,101
"5590",1975-04-21,95,217,0,122
"5591",1975-04-22,98,193,0,95
"5592",1975-04-23,101,197,0,96
"5593",1975-04-24,130,153,150,23
"5594",1975-04-25,128,180,148,52
"5595",1975-04-26,90,193,0,103
"5596",1975-04-27,114,184,4,70
"5597",1975-04-28,109,253,1,144
"5598",1975-04-29,147,249,0,102
"5599",1975-04-30,139,196,5,57
"5600",1975-05-01,123,209,0,86
"5601",1975-05-02,108,207,4,99
"5602",1975-05-03,115,228,1,113
"5603",1975-05-04,115,226,0,111
"5604",1975-05-05,116,216,0,100
"5605",1975-05-06,79,237,0,158
"5606",1975-05-07,142,232,18,90
"5607",1975-05-08,140,220,0,80
"5608",1975-05-09,140,227,1,87
"5609",1975-05-10,101,249,0,148
"5610",1975-05-11,124,274,0,150
"5611",1975-05-12,147,223,1,76
"5612",1975-05-13,131,280,0,149
"5613",1975-05-14,167,300,0,133
"5614",1975-05-15,180,248,0,68
"5615",1975-05-16,130,267,0,137
"5616",1975-05-17,168,217,6,49
"5617",1975-05-18,147,273,0,126
"5618",1975-05-19,132,282,0,150
"5619",1975-05-20,110,236,0,126
"5620",1975-05-21,105,271,0,166
"5621",1975-05-22,130,300,0,170
"5622",1975-05-23,138,307,0,169
"5623",1975-05-24,152,287,0,135
"5624",1975-05-25,168,295,0,127
"5625",1975-05-26,132,316,0,184
"5626",1975-05-27,193,295,0,102
"5627",1975-05-28,166,325,0,159
"5628",1975-05-29,182,341,0,159
"5629",1975-05-30,132,335,0,203
"5630",1975-05-31,141,367,0,226
"5631",1975-06-01,229,380,1,151
"5632",1975-06-02,186,302,0,116
"5633",1975-06-03,205,311,2,106
"5634",1975-06-04,163,311,0,148
"5635",1975-06-05,212,314,0,102
"5636",1975-06-06,165,358,0,193
"5637",1975-06-07,201,335,0,134
"5638",1975-06-08,182,335,0,153
"5639",1975-06-09,228,331,0,103
"5640",1975-06-10,182,350,0,168
"5641",1975-06-11,225,357,0,132
"5642",1975-06-12,199,337,0,138
"5643",1975-06-13,218,361,0,143
"5644",1975-06-14,248,352,0,104
"5645",1975-06-15,219,301,0,82
"5646",1975-06-16,184,272,2,88
"5647",1975-06-17,163,347,0,184
"5648",1975-06-18,180,385,0,205
"5649",1975-06-19,223,368,0,145
"5650",1975-06-20,238,324,0,86
"5651",1975-06-21,203,294,0,91
"5652",1975-06-22,215,268,92,53
"5653",1975-06-23,204,300,9,96
"5654",1975-06-24,244,312,0,68
"5655",1975-06-25,208,340,0,132
"5656",1975-06-26,208,315,0,107
"5657",1975-06-27,226,347,0,121
"5658",1975-06-28,221,360,0,139
"5659",1975-06-29,220,351,0,131
"5660",1975-06-30,205,300,0,95
"5661",1975-07-01,205,256,0,51
"5662",1975-07-02,212,260,54,48
"5663",1975-07-03,222,267,2,45
"5664",1975-07-04,207,244,36,37
"5665",1975-07-05,217,286,30,69
"5666",1975-07-06,200,333,0,133
"5667",1975-07-07,247,310,0,63
"5668",1975-07-08,218,280,104,62
"5669",1975-07-09,195,225,392,30
"5670",1975-07-10,178,267,12,89
"5671",1975-07-11,215,333,0,118
"5672",1975-07-12,215,346,0,131
"5673",1975-07-13,218,350,0,132
"5674",1975-07-14,216,346,0,130
"5675",1975-07-15,247,348,0,101
"5676",1975-07-16,257,362,0,105
"5677",1975-07-17,247,328,0,81
"5678",1975-07-18,244,346,0,102
"5679",1975-07-19,255,375,0,120
"5680",1975-07-20,270,358,4,88
"5681",1975-07-21,246,289,8,43
"5682",1975-07-22,235,327,0,92
"5683",1975-07-23,237,307,0,70
"5684",1975-07-24,205,315,0,110
"5685",1975-07-25,216,274,12,58
"5686",1975-07-26,195,246,74,51
"5687",1975-07-27,224,296,1,72
"5688",1975-07-28,245,325,0,80
"5689",1975-07-29,264,332,13,68
"5690",1975-07-30,239,308,0,69
"5691",1975-07-31,223,320,0,97
"5692",1975-08-01,233,313,68,80
"5693",1975-08-02,210,314,0,104
"5694",1975-08-03,215,311,0,96
"5695",1975-08-04,223,325,0,102
"5696",1975-08-05,244,277,68,33
"5697",1975-08-06,236,266,804,30
"5698",1975-08-07,238,280,96,42
"5699",1975-08-08,217,298,37,81
"5700",1975-08-09,248,295,8,47
"5701",1975-08-10,242,330,0,88
"5702",1975-08-11,255,323,0,68
"5703",1975-08-12,218,315,0,97
"5704",1975-08-13,219,301,0,82
"5705",1975-08-14,243,283,0,40
"5706",1975-08-15,217,309,0,92
"5707",1975-08-16,203,316,0,113
"5708",1975-08-17,212,318,0,106
"5709",1975-08-18,216,327,0,111
"5710",1975-08-19,227,324,0,97
"5711",1975-08-20,232,327,0,95
"5712",1975-08-21,222,356,0,134
"5713",1975-08-22,224,316,0,92
"5714",1975-08-23,215,315,0,100
"5715",1975-08-24,197,322,0,125
"5716",1975-08-25,193,327,0,134
"5717",1975-08-26,207,342,0,135
"5718",1975-08-27,210,290,0,80
"5719",1975-08-28,186,295,0,109
"5720",1975-08-29,209,335,0,126
"5721",1975-08-30,237,344,0,107
"5722",1975-08-31,248,346,0,98
"5723",1975-09-01,235,304,113,69
"5724",1975-09-02,215,238,230,23
"5725",1975-09-03,195,265,0,70
"5726",1975-09-04,164,235,142,71
"5727",1975-09-05,170,244,9,74
"5728",1975-09-06,205,276,3,71
"5729",1975-09-07,200,263,0,63
"5730",1975-09-08,210,287,2,77
"5731",1975-09-09,209,333,0,124
"5732",1975-09-10,240,310,0,70
"5733",1975-09-11,219,272,1,53
"5734",1975-09-12,184,267,0,83
"5735",1975-09-13,181,234,0,53
"5736",1975-09-14,153,210,40,57
"5737",1975-09-15,111,268,0,157
"5738",1975-09-16,152,280,0,128
"5739",1975-09-17,185,296,0,111
"5740",1975-09-18,203,290,0,87
"5741",1975-09-19,198,255,857,57
"5742",1975-09-20,180,277,0,97
"5743",1975-09-21,168,211,7,43
"5744",1975-09-22,170,215,61,45
"5745",1975-09-23,166,237,21,71
"5746",1975-09-24,185,272,0,87
"5747",1975-09-25,145,264,0,119
"5748",1975-09-26,180,250,7,70
"5749",1975-09-27,194,250,8,56
"5750",1975-09-28,173,218,101,45
"5751",1975-09-29,161,202,118,41
"5752",1975-09-30,148,186,112,38
"5753",1975-10-01,143,175,120,32
"5754",1975-10-02,159,204,65,45
"5755",1975-10-03,156,202,64,46
"5756",1975-10-04,122,256,0,134
"5757",1975-10-05,100,252,0,152
"5758",1975-10-06,133,230,0,97
"5759",1975-10-07,104,245,0,141
"5760",1975-10-08,102,243,0,141
"5761",1975-10-09,128,245,0,117
"5762",1975-10-10,136,207,68,71
"5763",1975-10-11,144,214,20,70
"5764",1975-10-12,144,214,0,70
"5765",1975-10-13,130,194,0,64
"5766",1975-10-14,127,194,1,67
"5767",1975-10-15,93,198,0,105
"5768",1975-10-16,65,214,0,149
"5769",1975-10-17,88,224,0,136
"5770",1975-10-18,85,211,0,126
"5771",1975-10-19,126,226,0,100
"5772",1975-10-20,84,217,0,133
"5773",1975-10-21,122,214,0,92
"5774",1975-10-22,105,202,0,97
"5775",1975-10-23,111,156,0,45
"5776",1975-10-24,93,130,6,37
"5777",1975-10-25,91,120,45,29
"5778",1975-10-26,93,125,60,32
"5779",1975-10-27,111,198,0,87
"5780",1975-10-28,125,185,0,60
"5781",1975-10-29,60,134,0,74
"5782",1975-10-30,-3,126,0,129
"5783",1975-10-31,34,155,0,121
"5784",1975-11-01,48,166,0,118
"5785",1975-11-02,84,150,0,66
"5786",1975-11-03,95,149,0,54
"5787",1975-11-04,100,176,0,76
"5788",1975-11-05,53,177,0,124
"5789",1975-11-06,44,180,2,136
"5790",1975-11-07,101,165,0,64
"5791",1975-11-08,101,143,19,42
"5792",1975-11-09,70,130,0,60
"5793",1975-11-10,63,105,7,42
"5794",1975-11-11,65,115,0,50
"5795",1975-11-12,66,148,0,82
"5796",1975-11-13,18,163,0,145
"5797",1975-11-14,56,150,0,94
"5798",1975-11-15,14,165,0,151
"5799",1975-11-16,20,178,0,158
"5800",1975-11-17,70,148,0,78
"5801",1975-11-18,68,115,2,47
"5802",1975-11-19,-19,103,0,122
"5803",1975-11-20,-13,147,0,160
"5804",1975-11-21,-9,149,0,158
"5805",1975-11-22,1,94,0,93
"5806",1975-11-23,-11,85,0,96
"5807",1975-11-24,-15,151,0,166
"5808",1975-11-25,13,109,0,96
"5809",1975-11-26,15,129,0,114
"5810",1975-11-27,-39,188,0,227
"5811",1975-11-28,5,135,0,130
"5812",1975-11-29,-11,120,0,131
"5813",1975-11-30,-17,134,0,151
"5814",1975-12-01,-16,169,0,185
"5815",1975-12-02,-7,100,0,107
"5816",1975-12-03,42,68,42,26
"5817",1975-12-04,23,76,0,53
"5818",1975-12-05,3,56,63,53
"5819",1975-12-06,-18,5,90,23
"5820",1975-12-07,-36,0,31,36
"5821",1975-12-08,-56,-25,20,31
"5822",1975-12-09,-120,10,2,130
"5823",1975-12-10,-58,-1,0,57
"5824",1975-12-11,-45,-5,0,40
"5825",1975-12-12,-70,-10,0,60
"5826",1975-12-13,-65,-5,0,60
"5827",1975-12-14,-67,-7,0,60
"5828",1975-12-15,-46,32,0,78
"5829",1975-12-16,-63,52,0,115
"5830",1975-12-17,-76,71,0,147
"5831",1975-12-18,-59,65,0,124
"5832",1975-12-19,-10,71,0,81
"5833",1975-12-20,-14,62,0,76
"5834",1975-12-21,-15,79,0,94
"5835",1975-12-22,-56,45,0,101
"5836",1975-12-23,-55,54,0,109
"5837",1975-12-24,-70,101,0,171
"5838",1975-12-25,-54,56,0,110
"5839",1975-12-26,-44,44,0,88
"5840",1975-12-27,-17,53,0,70
"5841",1975-12-28,-26,95,0,121
"5842",1975-12-29,10,90,0,80
"5843",1975-12-30,10,119,0,109
"5844",1975-12-31,-37,147,0,184
"5845",1976-01-01,3,126,0,123
"5846",1976-01-02,-45,112,0,157
"5847",1976-01-03,-11,107,0,118
"5848",1976-01-04,22,74,0,52
"5849",1976-01-05,-8,80,0,88
"5850",1976-01-06,-63,120,0,183
"5851",1976-01-07,9,115,0,106
"5852",1976-01-08,-53,64,0,117
"5853",1976-01-09,-75,47,0,122
"5854",1976-01-10,-38,53,0,91
"5855",1976-01-11,-26,94,0,120
"5856",1976-01-12,-90,125,0,215
"5857",1976-01-13,-5,75,0,80
"5858",1976-01-14,-84,34,0,118
"5859",1976-01-15,-54,34,0,88
"5860",1976-01-16,-55,82,0,137
"5861",1976-01-17,-79,62,0,141
"5862",1976-01-18,-47,84,0,131
"5863",1976-01-19,-65,10,0,75
"5864",1976-01-20,-75,0,0,75
"5865",1976-01-21,-58,32,0,90
"5866",1976-01-22,-45,43,0,88
"5867",1976-01-23,-46,41,0,87
"5868",1976-01-24,-69,75,0,144
"5869",1976-01-25,-55,58,0,113
"5870",1976-01-26,-70,43,0,113
"5871",1976-01-27,-80,16,0,96
"5872",1976-01-28,-54,47,0,101
"5873",1976-01-29,-52,68,0,120
"5874",1976-01-30,-32,106,0,138
"5875",1976-01-31,-47,116,0,163
"5876",1976-02-01,30,128,0,98
"5877",1976-02-02,-24,175,0,199
"5878",1976-02-03,-6,79,0,85
"5879",1976-02-04,-39,57,0,96
"5880",1976-02-05,-68,79,0,147
"5881",1976-02-06,-10,62,0,72
"5882",1976-02-07,-2,74,4,76
"5883",1976-02-08,-42,144,0,186
"5884",1976-02-09,-24,109,0,133
"5885",1976-02-10,-20,80,0,100
"5886",1976-02-11,13,71,75,58
"5887",1976-02-12,5,57,87,52
"5888",1976-02-13,15,56,0,41
"5889",1976-02-14,16,51,19,35
"5890",1976-02-15,-30,26,39,56
"5891",1976-02-16,-57,0,0,57
"5892",1976-02-17,-55,-2,36,53
"5893",1976-02-18,-89,52,0,141
"5894",1976-02-19,-14,53,0,67
"5895",1976-02-20,-31,50,0,81
"5896",1976-02-21,3,81,13,78
"5897",1976-02-22,18,98,0,80
"5898",1976-02-23,10,95,0,85
"5899",1976-02-24,11,107,0,96
"5900",1976-02-25,25,130,0,105
"5901",1976-02-26,-2,121,0,123
"5902",1976-02-27,38,87,54,49
"5903",1976-02-28,25,55,0,30
"5904",1976-02-29,10,49,0,39
"5905",1976-03-01,2,87,0,85
"5906",1976-03-02,-33,99,0,132
"5907",1976-03-03,-16,115,0,131
"5908",1976-03-04,-21,164,0,185
"5909",1976-03-05,36,127,6,91
"5910",1976-03-06,-12,150,0,162
"5911",1976-03-07,33,146,0,113
"5912",1976-03-08,31,196,0,165
"5913",1976-03-09,25,143,0,118
"5914",1976-03-10,28,196,0,168
"5915",1976-03-11,83,140,0,57
"5916",1976-03-12,18,152,0,134
"5917",1976-03-13,31,160,0,129
"5918",1976-03-14,41,193,0,152
"5919",1976-03-15,21,170,26,149
"5920",1976-03-16,60,110,57,50
"5921",1976-03-17,30,144,0,114
"5922",1976-03-18,15,92,4,77
"5923",1976-03-19,-33,86,0,119
"5924",1976-03-20,-17,100,0,117
"5925",1976-03-21,-5,143,0,148
"5926",1976-03-22,-5,142,0,147
"5927",1976-03-23,8,96,0,88
"5928",1976-03-24,41,141,0,100
"5929",1976-03-25,49,94,0,45
"5930",1976-03-26,29,154,0,125
"5931",1976-03-27,25,136,0,111
"5932",1976-03-28,47,110,0,63
"5933",1976-03-29,35,142,0,107
"5934",1976-03-30,41,174,0,133
"5935",1976-03-31,43,205,0,162
"5936",1976-04-01,55,136,0,81
"5937",1976-04-02,50,108,1,58
"5938",1976-04-03,8,137,0,129
"5939",1976-04-04,29,165,0,136
"5940",1976-04-05,55,216,0,161
"5941",1976-04-06,75,160,0,85
"5942",1976-04-07,51,115,44,64
"5943",1976-04-08,50,146,1,96
"5944",1976-04-09,55,147,0,92
"5945",1976-04-10,26,183,0,157
"5946",1976-04-11,57,156,0,99
"5947",1976-04-12,95,172,16,77
"5948",1976-04-13,73,237,0,164
"5949",1976-04-14,57,262,0,205
"5950",1976-04-15,131,272,0,141
"5951",1976-04-16,76,184,0,108
"5952",1976-04-17,100,143,0,43
"5953",1976-04-18,55,130,76,75
"5954",1976-04-19,13,148,44,135
"5955",1976-04-20,45,253,16,208
"5956",1976-04-21,116,263,0,147
"5957",1976-04-22,115,214,34,99
"5958",1976-04-23,68,181,0,113
"5959",1976-04-24,-7,240,0,247
"5960",1976-04-25,128,280,0,152
"5961",1976-04-26,140,292,0,152
"5962",1976-04-27,135,242,42,107
"5963",1976-04-28,130,152,206,22
"5964",1976-04-29,132,204,31,72
"5965",1976-04-30,100,218,0,118
"5966",1976-05-01,133,217,0,84
"5967",1976-05-02,88,230,0,142
"5968",1976-05-03,130,211,0,81
"5969",1976-05-04,70,220,0,150
"5970",1976-05-05,104,234,0,130
"5971",1976-05-06,80,243,0,163
"5972",1976-05-07,72,271,0,199
"5973",1976-05-08,135,241,0,106
"5974",1976-05-09,138,228,0,90
"5975",1976-05-10,154,289,1,135
"5976",1976-05-11,163,296,0,133
"5977",1976-05-12,130,228,0,98
"5978",1976-05-13,99,278,0,179
"5979",1976-05-14,140,290,0,150
"5980",1976-05-15,153,293,0,140
"5981",1976-05-16,70,268,0,198
"5982",1976-05-17,155,242,0,87
"5983",1976-05-18,171,252,0,81
"5984",1976-05-19,107,242,0,135
"5985",1976-05-20,143,294,1,151
"5986",1976-05-21,158,297,0,139
"5987",1976-05-22,173,332,0,159
"5988",1976-05-23,155,346,0,191
"5989",1976-05-24,183,375,0,192
"5990",1976-05-25,215,316,0,101
"5991",1976-05-26,185,285,0,100
"5992",1976-05-27,168,254,0,86
"5993",1976-05-28,153,312,0,159
"5994",1976-05-29,154,300,0,146
"5995",1976-05-30,185,337,0,152
"5996",1976-05-31,190,272,39,82
"5997",1976-06-01,163,289,0,126
"5998",1976-06-02,116,315,0,199
"5999",1976-06-03,190,312,0,122
"6000",1976-06-04,165,315,0,150
"6001",1976-06-05,184,332,0,148
"6002",1976-06-06,190,340,3,150
"6003",1976-06-07,223,295,0,72
"6004",1976-06-08,206,330,0,124
"6005",1976-06-09,200,326,0,126
"6006",1976-06-10,145,356,0,211
"6007",1976-06-11,180,322,0,142
"6008",1976-06-12,159,382,0,223
"6009",1976-06-13,225,330,0,105
"6010",1976-06-14,230,346,0,116
"6011",1976-06-15,189,310,0,121
"6012",1976-06-16,201,271,51,70
"6013",1976-06-17,184,262,0,78
"6014",1976-06-18,187,285,0,98
"6015",1976-06-19,188,277,0,89
"6016",1976-06-20,210,255,13,45
"6017",1976-06-21,213,312,7,99
"6018",1976-06-22,212,325,1,113
"6019",1976-06-23,221,350,12,129
"6020",1976-06-24,211,297,56,86
"6021",1976-06-25,145,327,0,182
"6022",1976-06-26,190,327,0,137
"6023",1976-06-27,187,321,0,134
"6024",1976-06-28,204,278,239,74
"6025",1976-06-29,203,280,361,77
"6026",1976-06-30,192,275,0,83
"6027",1976-07-01,204,254,0,50
"6028",1976-07-02,180,269,0,89
"6029",1976-07-03,172,282,0,110
"6030",1976-07-04,183,305,0,122
"6031",1976-07-05,224,316,0,92
"6032",1976-07-06,193,318,0,125
"6033",1976-07-07,224,322,0,98
"6034",1976-07-08,180,278,105,98
"6035",1976-07-09,151,300,1,149
"6036",1976-07-10,214,326,0,112
"6037",1976-07-11,219,348,0,129
"6038",1976-07-12,197,308,13,111
"6039",1976-07-13,205,327,0,122
"6040",1976-07-14,194,279,117,85
"6041",1976-07-15,188,294,22,106
"6042",1976-07-16,200,318,0,118
"6043",1976-07-17,238,322,0,84
"6044",1976-07-18,225,298,476,73
"6045",1976-07-19,220,265,279,45
"6046",1976-07-20,218,280,30,62
"6047",1976-07-21,219,289,332,70
"6048",1976-07-22,237,327,6,90
"6049",1976-07-23,244,338,0,94
"6050",1976-07-24,254,349,0,95
"6051",1976-07-25,261,317,0,56
"6052",1976-07-26,225,290,295,65
"6053",1976-07-27,213,292,253,79
"6054",1976-07-28,229,317,23,88
"6055",1976-07-29,250,338,0,88
"6056",1976-07-30,250,351,7,101
"6057",1976-07-31,253,328,2,75
"6058",1976-08-01,252,289,22,37
"6059",1976-08-02,238,287,113,49
"6060",1976-08-03,216,307,6,91
"6061",1976-08-04,250,325,0,75
"6062",1976-08-05,226,317,27,91
"6063",1976-08-06,216,268,33,52
"6064",1976-08-07,242,329,0,87
"6065",1976-08-08,236,318,143,82
"6066",1976-08-09,243,305,0,62
"6067",1976-08-10,206,313,0,107
"6068",1976-08-11,197,315,0,118
"6069",1976-08-12,224,275,55,51
"6070",1976-08-13,210,287,0,77
"6071",1976-08-14,200,311,0,111
"6072",1976-08-15,176,324,0,148
"6073",1976-08-16,226,334,0,108
"6074",1976-08-17,225,324,450,99
"6075",1976-08-18,215,275,145,60
"6076",1976-08-19,224,317,0,93
"6077",1976-08-20,247,330,0,83
"6078",1976-08-21,189,298,15,109
"6079",1976-08-22,190,246,19,56
"6080",1976-08-23,170,222,0,52
"6081",1976-08-24,148,178,2,30
"6082",1976-08-25,154,177,173,23
"6083",1976-08-26,154,179,181,25
"6084",1976-08-27,167,227,1,60
"6085",1976-08-28,191,227,0,36
"6086",1976-08-29,180,254,16,74
"6087",1976-08-30,166,335,0,169
"6088",1976-08-31,204,290,2,86
"6089",1976-09-01,183,240,66,57
"6090",1976-09-02,155,282,0,127
"6091",1976-09-03,185,281,0,96
"6092",1976-09-04,190,287,0,97
"6093",1976-09-05,192,287,0,95
"6094",1976-09-06,180,252,471,72
"6095",1976-09-07,140,235,3,95
"6096",1976-09-08,145,282,0,137
"6097",1976-09-09,163,275,0,112
"6098",1976-09-10,145,284,0,139
"6099",1976-09-11,189,236,3,47
"6100",1976-09-12,165,247,0,82
"6101",1976-09-13,131,255,0,124
"6102",1976-09-14,153,259,0,106
"6103",1976-09-15,172,252,3,80
"6104",1976-09-16,170,284,0,114
"6105",1976-09-17,180,287,0,107
"6106",1976-09-18,174,269,3,95
"6107",1976-09-19,166,251,4,85
"6108",1976-09-20,160,267,0,107
"6109",1976-09-21,146,257,0,111
"6110",1976-09-22,109,261,0,152
"6111",1976-09-23,115,276,0,161
"6112",1976-09-24,149,240,0,91
"6113",1976-09-25,117,272,0,155
"6114",1976-09-26,120,295,0,175
"6115",1976-09-27,155,301,0,146
"6116",1976-09-28,144,274,0,130
"6117",1976-09-29,159,258,0,99
"6118",1976-09-30,172,253,15,81
"6119",1976-10-01,146,289,0,143
"6120",1976-10-02,176,283,9,107
"6121",1976-10-03,120,275,0,155
"6122",1976-10-04,129,203,0,74
"6123",1976-10-05,115,163,50,48
"6124",1976-10-06,91,218,0,127
"6125",1976-10-07,127,228,0,101
"6126",1976-10-08,90,232,1,142
"6127",1976-10-09,98,257,0,159
"6128",1976-10-10,105,200,5,95
"6129",1976-10-11,94,138,50,44
"6130",1976-10-12,105,156,0,51
"6131",1976-10-13,99,223,0,124
"6132",1976-10-14,87,252,0,165
"6133",1976-10-15,97,259,0,162
"6134",1976-10-16,112,260,0,148
"6135",1976-10-17,100,273,0,173
"6136",1976-10-18,105,271,0,166
"6137",1976-10-19,123,262,0,139
"6138",1976-10-20,114,305,0,191
"6139",1976-10-21,101,212,0,111
"6140",1976-10-22,111,149,16,38
"6141",1976-10-23,114,167,2,53
"6142",1976-10-24,70,158,0,88
"6143",1976-10-25,40,162,0,122
"6144",1976-10-26,33,200,0,167
"6145",1976-10-27,112,215,15,103
"6146",1976-10-28,45,230,0,185
"6147",1976-10-29,53,234,0,181
"6148",1976-10-30,76,156,0,80
"6149",1976-10-31,-2,150,0,152
"6150",1976-11-01,50,168,0,118
"6151",1976-11-02,115,157,0,42
"6152",1976-11-03,101,164,85,63
"6153",1976-11-04,61,114,0,53
"6154",1976-11-05,54,124,0,70
"6155",1976-11-06,36,150,0,114
"6156",1976-11-07,24,218,0,194
"6157",1976-11-08,74,130,0,56
"6158",1976-11-09,80,110,57,30
"6159",1976-11-10,32,97,127,65
"6160",1976-11-11,-17,43,0,60
"6161",1976-11-12,0,35,12,35
"6162",1976-11-13,-15,57,0,72
"6163",1976-11-14,-62,51,0,113
"6164",1976-11-15,-45,50,0,95
"6165",1976-11-16,-8,54,0,62
"6166",1976-11-17,1,101,0,100
"6167",1976-11-18,-23,147,0,170
"6168",1976-11-19,-4,123,0,127
"6169",1976-11-20,2,92,0,90
"6170",1976-11-21,-26,116,0,142
"6171",1976-11-22,6,87,0,81
"6172",1976-11-23,-35,114,0,149
"6173",1976-11-24,-42,154,0,196
"6174",1976-11-25,33,126,0,93
"6175",1976-11-26,-37,117,0,154
"6176",1976-11-27,-15,97,0,112
"6177",1976-11-28,-24,145,0,169
"6178",1976-11-29,-34,114,0,148
"6179",1976-11-30,9,111,0,102
"6180",1976-12-01,-20,165,0,185
"6181",1976-12-02,-27,144,0,171
"6182",1976-12-03,-5,120,0,125
"6183",1976-12-04,28,74,0,46
"6184",1976-12-05,10,35,0,25
"6185",1976-12-06,1,58,0,57
"6186",1976-12-07,-8,83,0,91
"6187",1976-12-08,-17,42,0,59
"6188",1976-12-09,-8,96,0,104
"6189",1976-12-10,20,101,0,81
"6190",1976-12-11,14,95,0,81
"6191",1976-12-12,-40,84,0,124
"6192",1976-12-13,-17,111,0,128
"6193",1976-12-14,-42,165,0,207
"6194",1976-12-15,0,64,0,64
"6195",1976-12-16,-25,104,0,129
"6196",1976-12-17,-21,166,0,187
"6197",1976-12-18,40,119,0,79
"6198",1976-12-19,-19,143,0,162
"6199",1976-12-20,-27,178,0,205
"6200",1976-12-21,-7,98,0,105
"6201",1976-12-22,-35,76,0,111
"6202",1976-12-23,9,26,0,17
"6203",1976-12-24,3,29,0,26
"6204",1976-12-25,-50,17,1,67
"6205",1976-12-26,-97,-32,0,65
"6206",1976-12-27,-95,-6,0,89
"6207",1976-12-28,-76,-8,0,68
"6208",1976-12-29,-90,33,0,123
"6209",1976-12-30,-63,6,0,69
"6210",1976-12-31,-96,37,0,133
"6211",1977-01-01,-73,-10,0,63
"6212",1977-01-02,-85,-48,1,37
"6213",1977-01-03,-85,-34,0,51
"6214",1977-01-04,-130,7,0,137
"6215",1977-01-05,-103,20,0,123
"6216",1977-01-06,-115,58,0,173
"6217",1977-01-07,-87,34,0,121
"6218",1977-01-08,-91,42,0,133
"6219",1977-01-09,-20,46,0,66
"6220",1977-01-10,-105,46,0,151
"6221",1977-01-11,-66,35,0,101
"6222",1977-01-12,-131,28,0,159
"6223",1977-01-13,-93,23,0,116
"6224",1977-01-14,-67,39,0,106
"6225",1977-01-15,-104,32,0,136
"6226",1977-01-16,-72,37,0,109
"6227",1977-01-17,-75,6,0,81
"6228",1977-01-18,-68,47,0,115
"6229",1977-01-19,-66,20,0,86
"6230",1977-01-20,-80,40,0,120
"6231",1977-01-21,-48,4,0,52
"6232",1977-01-22,-75,77,0,152
"6233",1977-01-23,-50,65,0,115
"6234",1977-01-24,-13,27,0,40
"6235",1977-01-25,-22,9,0,31
"6236",1977-01-26,-50,3,0,53
"6237",1977-01-27,-50,-24,0,26
"6238",1977-01-28,-83,-30,0,53
"6239",1977-01-29,-65,-30,0,35
"6240",1977-01-30,-95,20,0,115
"6241",1977-01-31,-95,40,0,135
"6242",1977-02-01,-80,59,0,139
"6243",1977-02-02,-87,59,0,146
"6244",1977-02-03,-96,80,0,176
"6245",1977-02-04,-85,46,0,131
"6246",1977-02-05,-94,29,0,123
"6247",1977-02-06,-37,31,0,68
"6248",1977-02-07,-54,77,0,131
"6249",1977-02-08,-25,74,0,99
"6250",1977-02-09,-11,114,0,125
"6251",1977-02-10,-35,160,0,195
"6252",1977-02-11,-44,78,0,122
"6253",1977-02-12,-45,35,0,80
"6254",1977-02-13,-24,32,0,56
"6255",1977-02-14,-75,86,0,161
"6256",1977-02-15,-69,51,0,120
"6257",1977-02-16,-100,48,0,148
"6258",1977-02-17,-89,91,0,180
"6259",1977-02-18,-45,113,0,158
"6260",1977-02-19,-20,130,0,150
"6261",1977-02-20,12,80,0,68
"6262",1977-02-21,-62,82,0,144
"6263",1977-02-22,14,138,0,124
"6264",1977-02-23,-16,208,0,224
"6265",1977-02-24,25,223,0,198
"6266",1977-02-25,100,198,0,98
"6267",1977-02-26,40,214,0,174
"6268",1977-02-27,12,236,0,224
"6269",1977-02-28,70,217,0,147
"6270",1977-03-01,57,201,0,144
"6271",1977-03-02,8,93,0,85
"6272",1977-03-03,13,111,0,98
"6273",1977-03-04,-30,145,0,175
"6274",1977-03-05,31,205,0,174
"6275",1977-03-06,70,219,0,149
"6276",1977-03-07,16,249,0,233
"6277",1977-03-08,44,230,0,186
"6278",1977-03-09,30,151,0,121
"6279",1977-03-10,-5,147,0,152
"6280",1977-03-11,4,194,0,190
"6281",1977-03-12,78,137,4,59
"6282",1977-03-13,54,228,0,174
"6283",1977-03-14,105,169,0,64
"6284",1977-03-15,50,150,3,100
"6285",1977-03-16,85,162,12,77
"6286",1977-03-17,44,135,37,91
"6287",1977-03-18,73,139,0,66
"6288",1977-03-19,26,171,0,145
"6289",1977-03-20,73,195,0,122
"6290",1977-03-21,84,157,0,73
"6291",1977-03-22,25,165,0,140
"6292",1977-03-23,41,90,3,49
"6293",1977-03-24,-5,164,0,169
"6294",1977-03-25,12,246,0,234
"6295",1977-03-26,107,232,0,125
"6296",1977-03-27,53,185,0,132
"6297",1977-03-28,66,150,0,84
"6298",1977-03-29,55,162,2,107
"6299",1977-03-30,51,205,0,154
"6300",1977-03-31,34,241,0,207
"6301",1977-04-01,59,246,0,187
"6302",1977-04-02,50,240,0,190
"6303",1977-04-03,142,240,0,98
"6304",1977-04-04,79,184,1,105
"6305",1977-04-05,102,149,23,47
"6306",1977-04-06,90,147,1,57
"6307",1977-04-07,54,163,20,109
"6308",1977-04-08,95,240,0,145
"6309",1977-04-09,85,213,0,128
"6310",1977-04-10,77,262,0,185
"6311",1977-04-11,122,253,0,131
"6312",1977-04-12,133,259,0,126
"6313",1977-04-13,117,231,0,114
"6314",1977-04-14,143,199,11,56
"6315",1977-04-15,93,302,0,209
"6316",1977-04-16,141,241,36,100
"6317",1977-04-17,87,175,0,88
"6318",1977-04-18,75,193,0,118
"6319",1977-04-19,127,283,0,156
"6320",1977-04-20,70,312,0,242
"6321",1977-04-21,145,292,0,147
"6322",1977-04-22,117,281,0,164
"6323",1977-04-23,149,235,474,86
"6324",1977-04-24,135,232,0,97
"6325",1977-04-25,125,234,0,109
"6326",1977-04-26,115,195,74,80
"6327",1977-04-27,111,220,24,109
"6328",1977-04-28,94,210,0,116
"6329",1977-04-29,70,229,0,159
"6330",1977-04-30,133,183,23,50
"6331",1977-05-01,111,235,3,124
"6332",1977-05-02,139,248,0,109
"6333",1977-05-03,150,231,0,81
"6334",1977-05-04,102,181,0,79
"6335",1977-05-05,83,300,1,217
"6336",1977-05-06,164,223,0,59
"6337",1977-05-07,106,253,0,147
"6338",1977-05-08,158,225,0,67
"6339",1977-05-09,92,230,0,138
"6340",1977-05-10,133,206,0,73
"6341",1977-05-11,97,263,0,166
"6342",1977-05-12,150,275,0,125
"6343",1977-05-13,100,252,171,152
"6344",1977-05-14,50,189,0,139
"6345",1977-05-15,65,203,0,138
"6346",1977-05-16,103,239,0,136
"6347",1977-05-17,105,262,0,157
"6348",1977-05-18,155,214,0,59
"6349",1977-05-19,138,230,0,92
"6350",1977-05-20,136,225,18,89
"6351",1977-05-21,106,273,0,167
"6352",1977-05-22,150,263,0,113
"6353",1977-05-23,155,213,14,58
"6354",1977-05-24,130,306,0,176
"6355",1977-05-25,167,298,0,131
"6356",1977-05-26,179,273,0,94
"6357",1977-05-27,194,293,0,99
"6358",1977-05-28,165,268,8,103
"6359",1977-05-29,150,302,0,152
"6360",1977-05-30,200,296,1,96
"6361",1977-05-31,213,282,0,69
"6362",1977-06-01,183,336,0,153
"6363",1977-06-02,199,302,0,103
"6364",1977-06-03,132,325,0,193
"6365",1977-06-04,159,346,0,187
"6366",1977-06-05,159,320,0,161
"6367",1977-06-06,170,336,28,166
"6368",1977-06-07,167,364,0,197
"6369",1977-06-08,235,356,0,121
"6370",1977-06-09,190,353,0,163
"6371",1977-06-10,211,286,20,75
"6372",1977-06-11,127,357,0,230
"6373",1977-06-12,178,391,0,213
"6374",1977-06-13,195,343,0,148
"6375",1977-06-14,188,305,40,117
"6376",1977-06-15,182,289,4,107
"6377",1977-06-16,185,312,0,127
"6378",1977-06-17,195,328,0,133
"6379",1977-06-18,213,312,0,99
"6380",1977-06-19,175,326,0,151
"6381",1977-06-20,174,335,0,161
"6382",1977-06-21,235,335,0,100
"6383",1977-06-22,215,343,0,128
"6384",1977-06-23,203,323,0,120
"6385",1977-06-24,190,315,93,125
"6386",1977-06-25,203,272,50,69
"6387",1977-06-26,202,289,327,87
"6388",1977-06-27,225,318,104,93
"6389",1977-06-28,220,354,1,134
"6390",1977-06-29,220,349,0,129
"6391",1977-06-30,216,356,0,140
"6392",1977-07-01,257,379,0,122
"6393",1977-07-02,237,343,195,106
"6394",1977-07-03,229,329,0,100
"6395",1977-07-04,225,331,0,106
"6396",1977-07-05,240,342,80,102
"6397",1977-07-06,240,331,0,91
"6398",1977-07-07,242,363,0,121
"6399",1977-07-08,240,325,469,85
"6400",1977-07-09,245,342,0,97
"6401",1977-07-10,204,310,1312,106
"6402",1977-07-11,195,285,61,90
"6403",1977-07-12,226,335,0,109
"6404",1977-07-13,220,343,9,123
"6405",1977-07-14,196,311,0,115
"6406",1977-07-15,226,341,257,115
"6407",1977-07-16,220,307,1,87
"6408",1977-07-17,235,309,0,74
"6409",1977-07-18,234,296,20,62
"6410",1977-07-19,212,273,74,61
"6411",1977-07-20,206,293,3,87
"6412",1977-07-21,220,312,0,92
"6413",1977-07-22,245,322,0,77
"6414",1977-07-23,253,306,3,53
"6415",1977-07-24,215,349,0,134
"6416",1977-07-25,215,317,182,102
"6417",1977-07-26,228,275,292,47
"6418",1977-07-27,220,290,160,70
"6419",1977-07-28,242,300,39,58
"6420",1977-07-29,252,320,14,68
"6421",1977-07-30,249,337,20,88
"6422",1977-07-31,240,340,84,100
"6423",1977-08-01,246,322,60,76
"6424",1977-08-02,242,332,0,90
"6425",1977-08-03,259,368,0,109
"6426",1977-08-04,236,306,223,70
"6427",1977-08-05,265,342,0,77
"6428",1977-08-06,275,348,0,73
"6429",1977-08-07,254,295,0,41
"6430",1977-08-08,251,297,0,46
"6431",1977-08-09,222,280,10,58
"6432",1977-08-10,208,300,16,92
"6433",1977-08-11,215,317,1,102
"6434",1977-08-12,218,277,2,59
"6435",1977-08-13,184,294,1,110
"6436",1977-08-14,214,267,5,53
"6437",1977-08-15,174,296,0,122
"6438",1977-08-16,184,309,1,125
"6439",1977-08-17,180,292,0,112
"6440",1977-08-18,175,290,0,115
"6441",1977-08-19,190,288,0,98
"6442",1977-08-20,179,280,0,101
"6443",1977-08-21,180,293,0,113
"6444",1977-08-22,198,260,310,62
"6445",1977-08-23,185,287,0,102
"6446",1977-08-24,190,293,0,103
"6447",1977-08-25,175,306,0,131
"6448",1977-08-26,184,312,0,128
"6449",1977-08-27,185,317,0,132
"6450",1977-08-28,205,310,0,105
"6451",1977-08-29,190,302,0,112
"6452",1977-08-30,190,305,0,115
"6453",1977-08-31,185,297,0,112
"6454",1977-09-01,195,300,0,105
"6455",1977-09-02,190,311,0,121
"6456",1977-09-03,210,322,0,112
"6457",1977-09-04,215,332,0,117
"6458",1977-09-05,215,331,0,116
"6459",1977-09-06,179,276,79,97
"6460",1977-09-07,177,235,68,58
"6461",1977-09-08,145,288,1,143
"6462",1977-09-09,156,298,0,142
"6463",1977-09-10,168,267,0,99
"6464",1977-09-11,166,265,0,99
"6465",1977-09-12,160,213,11,53
"6466",1977-09-13,143,221,22,78
"6467",1977-09-14,175,213,0,38
"6468",1977-09-15,163,195,27,32
"6469",1977-09-16,169,248,0,79
"6470",1977-09-17,176,220,15,44
"6471",1977-09-18,170,312,0,142
"6472",1977-09-19,170,246,0,76
"6473",1977-09-20,102,212,0,110
"6474",1977-09-21,94,263,1,169
"6475",1977-09-22,117,259,0,142
"6476",1977-09-23,92,260,0,168
"6477",1977-09-24,102,270,0,168
"6478",1977-09-25,124,313,0,189
"6479",1977-09-26,143,267,0,124
"6480",1977-09-27,142,275,0,133
"6481",1977-09-28,156,295,0,139
"6482",1977-09-29,160,354,0,194
"6483",1977-09-30,137,322,0,185
"6484",1977-10-01,161,338,0,177
"6485",1977-10-02,193,263,0,70
"6486",1977-10-03,140,273,0,133
"6487",1977-10-04,150,245,0,95
"6488",1977-10-05,129,200,50,71
"6489",1977-10-06,119,150,79,31
"6490",1977-10-07,81,206,0,125
"6491",1977-10-08,85,255,0,170
"6492",1977-10-09,110,230,0,120
"6493",1977-10-10,62,183,0,121
"6494",1977-10-11,59,196,0,137
"6495",1977-10-12,75,272,0,197
"6496",1977-10-13,97,282,0,185
"6497",1977-10-14,142,305,0,163
"6498",1977-10-15,140,195,0,55
"6499",1977-10-16,114,183,0,69
"6500",1977-10-17,95,230,0,135
"6501",1977-10-18,83,247,0,164
"6502",1977-10-19,101,278,0,177
"6503",1977-10-20,118,282,0,164
"6504",1977-10-21,142,275,0,133
"6505",1977-10-22,158,234,10,76
"6506",1977-10-23,106,274,0,168
"6507",1977-10-24,103,224,0,121
"6508",1977-10-25,101,233,0,132
"6509",1977-10-26,114,177,12,63
"6510",1977-10-27,109,157,99,48
"6511",1977-10-28,105,124,421,19
"6512",1977-10-29,103,167,15,64
"6513",1977-10-30,97,161,0,64
"6514",1977-10-31,106,185,21,79
"6515",1977-11-01,73,152,1,79
"6516",1977-11-02,46,152,1,106
"6517",1977-11-03,70,164,0,94
"6518",1977-11-04,60,177,0,117
"6519",1977-11-05,110,142,130,32
"6520",1977-11-06,90,142,46,52
"6521",1977-11-07,83,117,0,34
"6522",1977-11-08,10,151,1,141
"6523",1977-11-09,53,102,0,49
"6524",1977-11-10,6,131,1,125
"6525",1977-11-11,6,133,0,127
"6526",1977-11-12,49,122,0,73
"6527",1977-11-13,14,145,0,131
"6528",1977-11-14,15,137,0,122
"6529",1977-11-15,63,160,0,97
"6530",1977-11-16,41,158,0,117
"6531",1977-11-17,35,155,0,120
"6532",1977-11-18,-4,159,0,163
"6533",1977-11-19,21,133,0,112
"6534",1977-11-20,38,168,0,130
"6535",1977-11-21,24,162,0,138
"6536",1977-11-22,-10,145,0,155
"6537",1977-11-23,-9,158,0,167
"6538",1977-11-24,30,150,0,120
"6539",1977-11-25,-7,112,0,119
"6540",1977-11-26,27,126,0,99
"6541",1977-11-27,-17,90,0,107
"6542",1977-11-28,-35,108,0,143
"6543",1977-11-29,-25,106,0,131
"6544",1977-11-30,-9,142,0,151
"6545",1977-12-01,7,133,0,126
"6546",1977-12-02,-35,167,0,202
"6547",1977-12-03,11,195,0,184
"6548",1977-12-04,43,181,0,138
"6549",1977-12-05,-5,124,0,129
"6550",1977-12-06,-14,72,0,86
"6551",1977-12-07,-15,124,0,139
"6552",1977-12-08,44,143,0,99
"6553",1977-12-09,-16,184,0,200
"6554",1977-12-10,-7,89,0,96
"6555",1977-12-11,30,52,0,22
"6556",1977-12-12,-7,56,0,63
"6557",1977-12-13,-16,40,10,56
"6558",1977-12-14,26,40,19,14
"6559",1977-12-15,31,89,8,58
"6560",1977-12-16,30,95,6,65
"6561",1977-12-17,-37,136,0,173
"6562",1977-12-18,-15,75,0,90
"6563",1977-12-19,-23,87,0,110
"6564",1977-12-20,-27,67,0,94
"6565",1977-12-21,9,47,0,38
"6566",1977-12-22,1,65,0,64
"6567",1977-12-23,6,108,0,102
"6568",1977-12-24,-4,60,0,64
"6569",1977-12-25,-72,28,0,100
"6570",1977-12-26,-50,28,0,78
"6571",1977-12-27,-7,13,0,20
"6572",1977-12-28,-9,27,0,36
"6573",1977-12-29,-55,40,0,95
"6574",1977-12-30,5,22,1,17
"6575",1977-12-31,-33,90,0,123
"6576",1978-01-01,-7,42,0,49
"6577",1978-01-02,-74,56,0,130
"6578",1978-01-03,-49,78,0,127
"6579",1978-01-04,-20,60,0,80
"6580",1978-01-05,-9,106,0,115
"6581",1978-01-06,8,146,0,138
"6582",1978-01-07,12,119,0,107
"6583",1978-01-08,13,71,0,58
"6584",1978-01-09,-21,67,0,88
"6585",1978-01-10,-84,75,0,159
"6586",1978-01-11,-45,129,0,174
"6587",1978-01-12,-55,124,0,179
"6588",1978-01-13,-48,86,0,134
"6589",1978-01-14,-5,81,0,86
"6590",1978-01-15,-35,40,0,75
"6591",1978-01-16,-56,21,0,77
"6592",1978-01-17,-61,33,0,94
"6593",1978-01-18,-55,61,0,116
"6594",1978-01-19,-43,96,0,139
"6595",1978-01-20,6,59,0,53
"6596",1978-01-21,-62,110,0,172
"6597",1978-01-22,-45,126,0,171
"6598",1978-01-23,-35,87,0,122
"6599",1978-01-24,-68,100,0,168
"6600",1978-01-25,-46,121,0,167
"6601",1978-01-26,41,156,0,115
"6602",1978-01-27,-4,76,0,80
"6603",1978-01-28,-55,18,0,73
"6604",1978-01-29,-49,50,0,99
"6605",1978-01-30,-62,47,0,109
"6606",1978-01-31,-57,76,0,133
"6607",1978-02-01,-79,59,0,138
"6608",1978-02-02,-29,103,0,132
"6609",1978-02-03,-25,132,0,157
"6610",1978-02-04,-55,107,0,162
"6611",1978-02-05,11,70,0,59
"6612",1978-02-06,-12,19,0,31
"6613",1978-02-07,-5,9,65,14
"6614",1978-02-08,-21,1,9,22
"6615",1978-02-09,-38,-9,48,29
"6616",1978-02-10,-63,-36,0,27
"6617",1978-02-11,-66,-11,0,55
"6618",1978-02-12,-40,31,0,71
"6619",1978-02-13,-30,60,0,90
"6620",1978-02-14,-41,9,0,50
"6621",1978-02-15,-37,-7,1,30
"6622",1978-02-16,-59,17,0,76
"6623",1978-02-17,-36,52,0,88
"6624",1978-02-18,-61,91,0,152
"6625",1978-02-19,1,80,0,79
"6626",1978-02-20,-5,129,0,134
"6627",1978-02-21,-3,148,0,151
"6628",1978-02-22,-9,157,0,166
"6629",1978-02-23,-4,174,0,178
"6630",1978-02-24,21,175,0,154
"6631",1978-02-25,9,123,0,114
"6632",1978-02-26,27,163,0,136
"6633",1978-02-27,-4,225,0,229
"6634",1978-02-28,-19,147,0,166
"6635",1978-03-01,-39,80,0,119
"6636",1978-03-02,-9,155,0,164
"6637",1978-03-03,75,140,6,65
"6638",1978-03-04,-10,156,0,166
"6639",1978-03-05,39,174,0,135
"6640",1978-03-06,43,145,0,102
"6641",1978-03-07,55,163,0,108
"6642",1978-03-08,56,117,87,61
"6643",1978-03-09,57,136,21,79
"6644",1978-03-10,-10,80,0,90
"6645",1978-03-11,-14,107,0,121
"6646",1978-03-12,-29,91,0,120
"6647",1978-03-13,9,80,0,71
"6648",1978-03-14,19,136,0,117
"6649",1978-03-15,1,153,0,152
"6650",1978-03-16,26,155,0,129
"6651",1978-03-17,11,143,0,132
"6652",1978-03-18,57,168,0,111
"6653",1978-03-19,3,118,53,115
"6654",1978-03-20,1,45,40,44
"6655",1978-03-21,6,150,0,144
"6656",1978-03-22,10,126,5,116
"6657",1978-03-23,8,150,0,142
"6658",1978-03-24,26,191,0,165
"6659",1978-03-25,56,218,0,162
"6660",1978-03-26,96,191,0,95
"6661",1978-03-27,48,232,0,184
"6662",1978-03-28,64,170,0,106
"6663",1978-03-29,58,133,5,75
"6664",1978-03-30,29,103,1,74
"6665",1978-03-31,36,120,0,84
"6666",1978-04-01,48,215,0,167
"6667",1978-04-02,36,180,0,144
"6668",1978-04-03,53,199,0,146
"6669",1978-04-04,46,255,0,209
"6670",1978-04-05,140,232,0,92
"6671",1978-04-06,18,216,0,198
"6672",1978-04-07,93,241,0,148
"6673",1978-04-08,75,277,0,202
"6674",1978-04-09,107,299,0,192
"6675",1978-04-10,95,262,0,167
"6676",1978-04-11,77,218,0,141
"6677",1978-04-12,83,335,0,252
"6678",1978-04-13,151,324,0,173
"6679",1978-04-14,158,331,0,173
"6680",1978-04-15,86,167,123,81
"6681",1978-04-16,80,177,0,97
"6682",1978-04-17,69,164,0,95
"6683",1978-04-18,82,245,0,163
"6684",1978-04-19,110,214,0,104
"6685",1978-04-20,57,136,88,79
"6686",1978-04-21,17,172,0,155
"6687",1978-04-22,47,177,0,130
"6688",1978-04-23,56,270,0,214
"6689",1978-04-24,87,260,0,173
"6690",1978-04-25,117,270,0,153
"6691",1978-04-26,163,287,0,124
"6692",1978-04-27,157,262,0,105
"6693",1978-04-28,147,307,0,160
"6694",1978-04-29,178,281,0,103
"6695",1978-04-30,149,256,6,107
"6696",1978-05-01,115,296,1,181
"6697",1978-05-02,167,286,0,119
"6698",1978-05-03,121,268,0,147
"6699",1978-05-04,106,271,0,165
"6700",1978-05-05,120,265,0,145
"6701",1978-05-06,156,267,0,111
"6702",1978-05-07,160,265,0,105
"6703",1978-05-08,176,255,56,79
"6704",1978-05-09,105,233,0,128
"6705",1978-05-10,120,270,0,150
"6706",1978-05-11,84,306,0,222
"6707",1978-05-12,142,305,0,163
"6708",1978-05-13,157,312,0,155
"6709",1978-05-14,167,310,0,143
"6710",1978-05-15,182,295,0,113
"6711",1978-05-16,143,240,0,97
"6712",1978-05-17,150,250,6,100
"6713",1978-05-18,137,287,79,150
"6714",1978-05-19,123,283,0,160
"6715",1978-05-20,140,337,0,197
"6716",1978-05-21,175,336,0,161
"6717",1978-05-22,149,340,0,191
"6718",1978-05-23,155,341,0,186
"6719",1978-05-24,171,280,0,109
"6720",1978-05-25,151,315,0,164
"6721",1978-05-26,205,322,0,117
"6722",1978-05-27,215,318,0,103
"6723",1978-05-28,189,315,0,126
"6724",1978-05-29,150,286,58,136
"6725",1978-05-30,116,177,140,61
"6726",1978-05-31,118,226,26,108
"6727",1978-06-01,127,266,0,139
"6728",1978-06-02,159,288,0,129
"6729",1978-06-03,145,327,0,182
"6730",1978-06-04,175,367,0,192
"6731",1978-06-05,186,324,0,138
"6732",1978-06-06,177,354,0,177
"6733",1978-06-07,224,350,0,126
"6734",1978-06-08,212,306,2,94
"6735",1978-06-09,186,360,0,174
"6736",1978-06-10,188,405,0,217
"6737",1978-06-11,215,397,0,182
"6738",1978-06-12,190,375,0,185
"6739",1978-06-13,202,328,32,126
"6740",1978-06-14,178,283,22,105
"6741",1978-06-15,195,361,0,166
"6742",1978-06-16,205,314,1,109
"6743",1978-06-17,204,326,0,122
"6744",1978-06-18,176,359,0,183
"6745",1978-06-19,213,352,0,139
"6746",1978-06-20,197,327,9,130
"6747",1978-06-21,200,358,0,158
"6748",1978-06-22,230,374,0,144
"6749",1978-06-23,205,343,0,138
"6750",1978-06-24,220,308,113,88
"6751",1978-06-25,210,235,119,25
"6752",1978-06-26,215,292,0,77
"6753",1978-06-27,235,330,0,95
"6754",1978-06-28,264,359,3,95
"6755",1978-06-29,236,382,13,146
"6756",1978-06-30,255,400,0,145
"6757",1978-07-01,243,372,3,129
"6758",1978-07-02,230,317,1894,87
"6759",1978-07-03,229,306,15,77
"6760",1978-07-04,233,319,250,86
"6761",1978-07-05,192,302,106,110
"6762",1978-07-06,218,328,0,110
"6763",1978-07-07,230,346,0,116
"6764",1978-07-08,272,369,0,97
"6765",1978-07-09,267,350,4,83
"6766",1978-07-10,235,282,132,47
"6767",1978-07-11,240,282,334,42
"6768",1978-07-12,230,294,5,64
"6769",1978-07-13,240,301,0,61
"6770",1978-07-14,225,279,346,54
"6771",1978-07-15,224,258,4,34
"6772",1978-07-16,219,299,0,80
"6773",1978-07-17,223,300,0,77
"6774",1978-07-18,206,298,0,92
"6775",1978-07-19,210,312,0,102
"6776",1978-07-20,230,322,0,92
"6777",1978-07-21,235,334,0,99
"6778",1978-07-22,240,334,0,94
"6779",1978-07-23,244,324,30,80
"6780",1978-07-24,238,313,30,75
"6781",1978-07-25,233,321,0,88
"6782",1978-07-26,252,317,1,65
"6783",1978-07-27,244,324,0,80
"6784",1978-07-28,250,327,1,77
"6785",1978-07-29,237,291,0,54
"6786",1978-07-30,197,306,0,109
"6787",1978-07-31,210,330,0,120
"6788",1978-08-01,234,370,0,136
"6789",1978-08-02,223,380,0,157
"6790",1978-08-03,235,376,0,141
"6791",1978-08-04,238,383,0,145
"6792",1978-08-05,239,362,0,123
"6793",1978-08-06,242,357,0,115
"6794",1978-08-07,233,305,0,72
"6795",1978-08-08,236,320,0,84
"6796",1978-08-09,245,335,0,90
"6797",1978-08-10,238,289,3,51
"6798",1978-08-11,215,290,15,75
"6799",1978-08-12,194,301,0,107
"6800",1978-08-13,183,290,0,107
"6801",1978-08-14,215,300,0,85
"6802",1978-08-15,221,297,0,76
"6803",1978-08-16,225,325,0,100
"6804",1978-08-17,217,325,0,108
"6805",1978-08-18,225,372,0,147
"6806",1978-08-19,191,387,0,196
"6807",1978-08-20,229,350,0,121
"6808",1978-08-21,234,357,0,123
"6809",1978-08-22,204,316,6,112
"6810",1978-08-23,220,332,14,112
"6811",1978-08-24,248,333,19,85
"6812",1978-08-25,237,280,422,43
"6813",1978-08-26,239,328,0,89
"6814",1978-08-27,223,313,0,90
"6815",1978-08-28,213,293,0,80
"6816",1978-08-29,194,236,1,42
"6817",1978-08-30,174,225,9,51
"6818",1978-08-31,190,284,6,94
"6819",1978-09-01,175,213,0,38
"6820",1978-09-02,183,263,0,80
"6821",1978-09-03,196,249,0,53
"6822",1978-09-04,170,211,0,41
"6823",1978-09-05,172,223,0,51
"6824",1978-09-06,193,301,1,108
"6825",1978-09-07,190,281,0,91
"6826",1978-09-08,164,254,62,90
"6827",1978-09-09,160,261,6,101
"6828",1978-09-10,114,261,1,147
"6829",1978-09-11,126,255,0,129
"6830",1978-09-12,141,250,0,109
"6831",1978-09-13,141,282,0,141
"6832",1978-09-14,151,291,0,140
"6833",1978-09-15,166,306,0,140
"6834",1978-09-16,187,311,5,124
"6835",1978-09-17,203,245,113,42
"6836",1978-09-18,138,227,0,89
"6837",1978-09-19,81,268,0,187
"6838",1978-09-20,93,263,0,170
"6839",1978-09-21,153,285,0,132
"6840",1978-09-22,143,303,0,160
"6841",1978-09-23,124,322,0,198
"6842",1978-09-24,137,336,0,199
"6843",1978-09-25,138,338,0,200
"6844",1978-09-26,152,290,0,138
"6845",1978-09-27,143,300,0,157
"6846",1978-09-28,163,304,0,141
"6847",1978-09-29,160,305,0,145
"6848",1978-09-30,184,314,0,130
"6849",1978-10-01,118,280,0,162
"6850",1978-10-02,155,300,0,145
"6851",1978-10-03,102,241,66,139
"6852",1978-10-04,105,221,17,116
"6853",1978-10-05,90,244,1,154
"6854",1978-10-06,102,236,0,134
"6855",1978-10-07,106,245,0,139
"6856",1978-10-08,129,250,0,121
"6857",1978-10-09,90,242,0,152
"6858",1978-10-10,111,245,0,134
"6859",1978-10-11,91,245,0,154
"6860",1978-10-12,82,245,0,163
"6861",1978-10-13,88,247,0,159
"6862",1978-10-14,129,258,0,129
"6863",1978-10-15,93,216,0,123
"6864",1978-10-16,57,230,0,173
"6865",1978-10-17,99,239,0,140
"6866",1978-10-18,75,233,0,158
"6867",1978-10-19,130,224,1,94
"6868",1978-10-20,82,207,0,125
"6869",1978-10-21,103,154,1,51
"6870",1978-10-22,112,193,3,81
"6871",1978-10-23,86,235,0,149
"6872",1978-10-24,82,252,0,170
"6873",1978-10-25,93,246,0,153
"6874",1978-10-26,62,190,282,128
"6875",1978-10-27,43,94,7,51
"6876",1978-10-28,25,108,1,83
"6877",1978-10-29,16,175,0,159
"6878",1978-10-30,7,202,0,195
"6879",1978-10-31,48,181,0,133
"6880",1978-11-01,31,164,0,133
"6881",1978-11-02,85,139,0,54
"6882",1978-11-03,29,173,0,144
"6883",1978-11-04,75,152,0,77
"6884",1978-11-05,40,186,0,146
"6885",1978-11-06,35,183,0,148
"6886",1978-11-07,33,182,4,149
"6887",1978-11-08,78,178,3,100
"6888",1978-11-09,82,145,181,63
"6889",1978-11-10,64,85,46,21
"6890",1978-11-11,45,103,0,58
"6891",1978-11-12,80,122,0,42
"6892",1978-11-13,25,155,1,130
"6893",1978-11-14,69,178,0,109
"6894",1978-11-15,35,116,0,81
"6895",1978-11-16,70,141,47,71
"6896",1978-11-17,37,157,1,120
"6897",1978-11-18,57,120,0,63
"6898",1978-11-19,4,99,0,95
"6899",1978-11-20,-1,87,0,88
"6900",1978-11-21,38,100,0,62
"6901",1978-11-22,-5,125,0,130
"6902",1978-11-23,-11,137,0,148
"6903",1978-11-24,13,102,1,89
"6904",1978-11-25,28,147,0,119
"6905",1978-11-26,59,142,0,83
"6906",1978-11-27,-16,75,0,91
"6907",1978-11-28,-56,95,0,151
"6908",1978-11-29,-47,136,0,183
"6909",1978-11-30,-27,135,0,162
"6910",1978-12-01,2,96,0,94
"6911",1978-12-02,-55,100,0,155
"6912",1978-12-03,-17,113,0,130
"6913",1978-12-04,19,132,0,113
"6914",1978-12-05,-30,165,0,195
"6915",1978-12-06,-30,136,0,166
"6916",1978-12-07,-11,143,0,154
"6917",1978-12-08,16,171,0,155
"6918",1978-12-09,5,150,0,145
"6919",1978-12-10,10,109,0,99
"6920",1978-12-11,-34,136,0,170
"6921",1978-12-12,-2,162,0,164
"6922",1978-12-13,-8,145,0,153
"6923",1978-12-14,-62,80,0,142
"6924",1978-12-15,-29,126,0,155
"6925",1978-12-16,2,127,0,125
"6926",1978-12-17,-17,62,0,79
"6927",1978-12-18,0,50,0,50
"6928",1978-12-19,-35,1,21,36
"6929",1978-12-20,-66,-34,31,32
"6930",1978-12-21,-74,-20,0,54
"6931",1978-12-22,-94,16,0,110
"6932",1978-12-23,-75,56,0,131
"6933",1978-12-24,-38,62,0,100
"6934",1978-12-25,-34,47,0,81
"6935",1978-12-26,12,82,0,70
"6936",1978-12-27,-3,100,0,103
"6937",1978-12-28,-20,35,0,55
"6938",1978-12-29,-47,2,0,49
"6939",1978-12-30,-26,7,0,33
"6940",1978-12-31,-56,2,0,58
"6941",1979-01-01,-39,55,0,94
"6942",1979-01-02,-40,107,0,147
"6943",1979-01-03,-33,156,0,189
"6944",1979-01-04,-15,163,0,178
"6945",1979-01-05,-41,116,0,157
"6946",1979-01-06,-23,167,0,190
"6947",1979-01-07,35,188,0,153
"6948",1979-01-08,-7,210,0,217
"6949",1979-01-09,-7,60,0,67
"6950",1979-01-10,-41,35,0,76
"6951",1979-01-11,-60,10,44,70
"6952",1979-01-12,-100,-23,13,77
"6953",1979-01-13,-92,-7,0,85
"6954",1979-01-14,-76,7,0,83
"6955",1979-01-15,-47,16,0,63
"6956",1979-01-16,-85,51,0,136
"6957",1979-01-17,-32,33,0,65
"6958",1979-01-18,-28,34,0,62
"6959",1979-01-19,-60,72,0,132
"6960",1979-01-20,23,90,0,67
"6961",1979-01-21,-38,62,0,100
"6962",1979-01-22,-52,121,0,173
"6963",1979-01-23,-23,135,0,158
"6964",1979-01-24,-18,130,0,148
"6965",1979-01-25,-24,165,0,189
"6966",1979-01-26,-15,169,0,184
"6967",1979-01-27,-15,92,0,107
"6968",1979-01-28,-58,-12,101,46
"6969",1979-01-29,-67,-20,0,47
"6970",1979-01-30,-80,-31,16,49
"6971",1979-01-31,-120,-17,0,103
"6972",1979-02-01,-65,-17,0,48
"6973",1979-02-02,-32,47,0,79
"6974",1979-02-03,-37,23,0,60
"6975",1979-02-04,-38,-1,0,37
"6976",1979-02-05,-37,113,0,150
"6977",1979-02-06,-13,154,0,167
"6978",1979-02-07,3,118,0,115
"6979",1979-02-08,-26,64,0,90
"6980",1979-02-09,-18,146,0,164
"6981",1979-02-10,15,164,0,149
"6982",1979-02-11,-8,168,0,176
"6983",1979-02-12,-8,208,0,216
"6984",1979-02-13,10,128,0,118
"6985",1979-02-14,9,60,0,51
"6986",1979-02-15,-59,158,0,217
"6987",1979-02-16,30,127,0,97
"6988",1979-02-17,-36,123,0,159
"6989",1979-02-18,-45,208,0,253
"6990",1979-02-19,69,197,0,128
"6991",1979-02-20,34,210,0,176
"6992",1979-02-21,-17,147,87,164
"6993",1979-02-22,-30,-14,46,16
"6994",1979-02-23,-22,39,0,61
"6995",1979-02-24,-6,43,0,49
"6996",1979-02-25,21,130,0,109
"6997",1979-02-26,13,126,0,113
"6998",1979-02-27,-5,124,0,129
"6999",1979-02-28,-37,82,0,119
"7000",1979-03-01,-34,73,0,107
"7001",1979-03-02,8,100,0,92
"7002",1979-03-03,-13,129,0,142
"7003",1979-03-04,-2,135,0,137
"7004",1979-03-05,35,160,0,125
"7005",1979-03-06,26,164,0,138
"7006",1979-03-07,39,143,0,104
"7007",1979-03-08,27,117,0,90
"7008",1979-03-09,77,118,0,41
"7009",1979-03-10,12,110,5,98
"7010",1979-03-11,7,56,0,49
"7011",1979-03-12,-27,121,0,148
"7012",1979-03-13,-10,135,0,145
"7013",1979-03-14,50,135,0,85
"7014",1979-03-15,-3,156,0,159
"7015",1979-03-16,25,160,0,135
"7016",1979-03-17,13,115,0,102
"7017",1979-03-18,33,177,0,144
"7018",1979-03-19,28,215,0,187
"7019",1979-03-20,42,196,0,154
"7020",1979-03-21,58,215,0,157
"7021",1979-03-22,2,135,7,133
"7022",1979-03-23,-14,117,34,131
"7023",1979-03-24,-10,177,0,187
"7024",1979-03-25,44,195,0,151
"7025",1979-03-26,20,207,0,187
"7026",1979-03-27,85,255,0,170
"7027",1979-03-28,117,249,0,132
"7028",1979-03-29,51,180,286,129
"7029",1979-03-30,29,123,13,94
"7030",1979-03-31,52,97,131,45
"7031",1979-04-01,44,147,45,103
"7032",1979-04-02,39,136,5,97
"7033",1979-04-03,42,139,0,97
"7034",1979-04-04,37,156,0,119
"7035",1979-04-05,39,141,0,102
"7036",1979-04-06,80,111,101,31
"7037",1979-04-07,70,167,61,97
"7038",1979-04-08,113,181,0,68
"7039",1979-04-09,45,176,0,131
"7040",1979-04-10,65,236,0,171
"7041",1979-04-11,101,241,0,140
"7042",1979-04-12,35,203,258,168
"7043",1979-04-13,54,145,0,91
"7044",1979-04-14,65,168,0,103
"7045",1979-04-15,83,256,0,173
"7046",1979-04-16,92,190,0,98
"7047",1979-04-17,88,168,0,80
"7048",1979-04-18,84,173,0,89
"7049",1979-04-19,90,214,0,124
"7050",1979-04-20,126,208,0,82
"7051",1979-04-21,122,245,0,123
"7052",1979-04-22,161,275,4,114
"7053",1979-04-23,172,240,326,68
"7054",1979-04-24,114,236,0,122
"7055",1979-04-25,59,210,96,151
"7056",1979-04-26,34,138,0,104
"7057",1979-04-27,92,153,2,61
"7058",1979-04-28,91,187,0,96
"7059",1979-04-29,115,226,0,111
"7060",1979-04-30,123,206,0,83
"7061",1979-05-01,110,222,0,112
"7062",1979-05-02,70,242,0,172
"7063",1979-05-03,127,261,0,134
"7064",1979-05-04,124,243,0,119
"7065",1979-05-05,111,210,0,99
"7066",1979-05-06,92,199,24,107
"7067",1979-05-07,42,220,0,178
"7068",1979-05-08,74,222,0,148
"7069",1979-05-09,92,215,0,123
"7070",1979-05-10,88,274,0,186
"7071",1979-05-11,134,221,12,87
"7072",1979-05-12,124,152,100,28
"7073",1979-05-13,120,215,0,95
"7074",1979-05-14,114,222,0,108
"7075",1979-05-15,137,211,4,74
"7076",1979-05-16,135,232,0,97
"7077",1979-05-17,73,252,0,179
"7078",1979-05-18,127,286,0,159
"7079",1979-05-19,115,307,0,192
"7080",1979-05-20,168,292,0,124
"7081",1979-05-21,135,303,0,168
"7082",1979-05-22,146,330,0,184
"7083",1979-05-23,187,296,0,109
"7084",1979-05-24,128,342,0,214
"7085",1979-05-25,122,314,0,192
"7086",1979-05-26,146,296,0,150
"7087",1979-05-27,140,320,0,180
"7088",1979-05-28,151,325,0,174
"7089",1979-05-29,126,316,0,190
"7090",1979-05-30,131,328,0,197
"7091",1979-05-31,155,331,0,176
"7092",1979-06-01,204,275,32,71
"7093",1979-06-02,160,360,0,200
"7094",1979-06-03,200,298,0,98
"7095",1979-06-04,216,264,27,48
"7096",1979-06-05,201,331,0,130
"7097",1979-06-06,167,320,0,153
"7098",1979-06-07,160,372,0,212
"7099",1979-06-08,222,372,0,150
"7100",1979-06-09,178,347,0,169
"7101",1979-06-10,207,301,0,94
"7102",1979-06-11,137,316,0,179
"7103",1979-06-12,192,367,0,175
"7104",1979-06-13,193,396,0,203
"7105",1979-06-14,248,383,0,135
"7106",1979-06-15,239,366,0,127
"7107",1979-06-16,206,363,0,157
"7108",1979-06-17,210,367,0,157
"7109",1979-06-18,209,313,63,104
"7110",1979-06-19,187,265,98,78
"7111",1979-06-20,189,245,0,56
"7112",1979-06-21,154,363,0,209
"7113",1979-06-22,188,363,0,175
"7114",1979-06-23,199,306,11,107
"7115",1979-06-24,178,349,0,171
"7116",1979-06-25,246,394,0,148
"7117",1979-06-26,225,357,10,132
"7118",1979-06-27,215,345,0,130
"7119",1979-06-28,238,357,0,119
"7120",1979-06-29,205,350,2,145
"7121",1979-06-30,215,316,1,101
"7122",1979-07-01,219,324,0,105
"7123",1979-07-02,227,294,197,67
"7124",1979-07-03,184,229,106,45
"7125",1979-07-04,176,199,289,23
"7126",1979-07-05,182,265,0,83
"7127",1979-07-06,218,320,0,102
"7128",1979-07-07,230,350,0,120
"7129",1979-07-08,224,321,62,97
"7130",1979-07-09,202,256,125,54
"7131",1979-07-10,198,322,0,124
"7132",1979-07-11,230,335,0,105
"7133",1979-07-12,236,306,270,70
"7134",1979-07-13,223,334,0,111
"7135",1979-07-14,235,362,0,127
"7136",1979-07-15,223,306,97,83
"7137",1979-07-16,200,334,0,134
"7138",1979-07-17,252,305,0,53
"7139",1979-07-18,231,320,0,89
"7140",1979-07-19,214,316,56,102
"7141",1979-07-20,217,302,0,85
"7142",1979-07-21,240,312,0,72
"7143",1979-07-22,216,304,37,88
"7144",1979-07-23,232,333,0,101
"7145",1979-07-24,237,305,87,68
"7146",1979-07-25,248,310,0,62
"7147",1979-07-26,246,314,15,68
"7148",1979-07-27,253,336,5,83
"7149",1979-07-28,261,358,0,97
"7150",1979-07-29,259,357,0,98
"7151",1979-07-30,243,312,0,69
"7152",1979-07-31,220,264,259,44
"7153",1979-08-01,234,289,0,55
"7154",1979-08-02,245,297,0,52
"7155",1979-08-03,234,301,15,67
"7156",1979-08-04,250,345,0,95
"7157",1979-08-05,241,373,0,132
"7158",1979-08-06,233,340,309,107
"7159",1979-08-07,216,306,1,90
"7160",1979-08-08,259,336,0,77
"7161",1979-08-09,269,342,0,73
"7162",1979-08-10,260,351,0,91
"7163",1979-08-11,260,353,0,93
"7164",1979-08-12,244,344,262,100
"7165",1979-08-13,237,295,300,58
"7166",1979-08-14,230,295,14,65
"7167",1979-08-15,232,301,0,69
"7168",1979-08-16,210,295,25,85
"7169",1979-08-17,210,309,0,99
"7170",1979-08-18,205,324,0,119
"7171",1979-08-19,196,319,0,123
"7172",1979-08-20,231,330,0,99
"7173",1979-08-21,209,303,0,94
"7174",1979-08-22,211,306,0,95
"7175",1979-08-23,217,296,0,79
"7176",1979-08-24,221,302,5,81
"7177",1979-08-25,215,332,0,117
"7178",1979-08-26,209,318,41,109
"7179",1979-08-27,186,265,0,79
"7180",1979-08-28,158,267,0,109
"7181",1979-08-29,132,218,175,86
"7182",1979-08-30,151,207,0,56
"7183",1979-08-31,192,244,77,52
"7184",1979-09-01,168,277,0,109
"7185",1979-09-02,115,274,0,159
"7186",1979-09-03,174,235,0,61
"7187",1979-09-04,149,251,0,102
"7188",1979-09-05,164,246,0,82
"7189",1979-09-06,173,292,0,119
"7190",1979-09-07,171,304,0,133
"7191",1979-09-08,162,283,44,121
"7192",1979-09-09,178,287,0,109
"7193",1979-09-10,172,307,0,135
"7194",1979-09-11,167,302,0,135
"7195",1979-09-12,202,294,40,92
"7196",1979-09-13,185,237,231,52
"7197",1979-09-14,165,231,111,66
"7198",1979-09-15,153,179,184,26
"7199",1979-09-16,147,175,79,28
"7200",1979-09-17,138,243,0,105
"7201",1979-09-18,135,254,0,119
"7202",1979-09-19,191,242,13,51
"7203",1979-09-20,164,219,19,55
"7204",1979-09-21,149,248,38,99
"7205",1979-09-22,167,215,9,48
"7206",1979-09-23,142,171,178,29
"7207",1979-09-24,135,225,6,90
"7208",1979-09-25,114,257,0,143
"7209",1979-09-26,148,206,0,58
"7210",1979-09-27,93,211,0,118
"7211",1979-09-28,123,188,6,65
"7212",1979-09-29,144,256,0,112
"7213",1979-09-30,121,269,0,148
"7214",1979-10-01,146,263,0,117
"7215",1979-10-02,94,254,47,160
"7216",1979-10-03,116,246,0,130
"7217",1979-10-04,113,259,0,146
"7218",1979-10-05,82,226,0,144
"7219",1979-10-06,100,264,39,164
"7220",1979-10-07,75,257,0,182
"7221",1979-10-08,108,265,0,157
"7222",1979-10-09,90,278,0,188
"7223",1979-10-10,102,292,0,190
"7224",1979-10-11,102,213,0,111
"7225",1979-10-12,92,251,0,159
"7226",1979-10-13,145,251,0,106
"7227",1979-10-14,110,254,0,144
"7228",1979-10-15,97,250,0,153
"7229",1979-10-16,92,243,0,151
"7230",1979-10-17,153,213,0,60
"7231",1979-10-18,82,235,0,153
"7232",1979-10-19,84,277,0,193
"7233",1979-10-20,118,207,0,89
"7234",1979-10-21,20,199,0,179
"7235",1979-10-22,45,239,0,194
"7236",1979-10-23,96,289,0,193
"7237",1979-10-24,99,246,0,147
"7238",1979-10-25,86,257,0,171
"7239",1979-10-26,46,269,0,223
"7240",1979-10-27,78,292,0,214
"7241",1979-10-28,90,301,0,211
"7242",1979-10-29,87,233,0,146
"7243",1979-10-30,78,282,0,204
"7244",1979-10-31,83,218,0,135
"7245",1979-11-01,68,246,0,178
"7246",1979-11-02,92,211,0,119
"7247",1979-11-03,61,203,0,142
"7248",1979-11-04,98,208,0,110
"7249",1979-11-05,16,177,0,161
"7250",1979-11-06,47,227,0,180
"7251",1979-11-07,65,226,0,161
"7252",1979-11-08,44,208,0,164
"7253",1979-11-09,63,175,0,112
"7254",1979-11-10,68,149,0,81
"7255",1979-11-11,50,126,0,76
"7256",1979-11-12,18,117,0,99
"7257",1979-11-13,-62,131,0,193
"7258",1979-11-14,21,160,0,139
"7259",1979-11-15,17,163,0,146
"7260",1979-11-16,12,115,0,103
"7261",1979-11-17,0,77,31,77
"7262",1979-11-18,-25,60,0,85
"7263",1979-11-19,-42,132,0,174
"7264",1979-11-20,-32,132,0,164
"7265",1979-11-21,50,93,0,43
"7266",1979-11-22,12,80,0,68
"7267",1979-11-23,-51,129,0,180
"7268",1979-11-24,-42,136,0,178
"7269",1979-11-25,-8,110,0,118
"7270",1979-11-26,-28,127,0,155
"7271",1979-11-27,23,147,0,124
"7272",1979-11-28,6,100,0,94
"7273",1979-11-29,-38,86,0,124
"7274",1979-11-30,-40,118,0,158
"7275",1979-12-01,-28,122,0,150
"7276",1979-12-02,38,105,0,67
"7277",1979-12-03,30,70,20,40
"7278",1979-12-04,16,73,1,57
"7279",1979-12-05,5,82,1,77
"7280",1979-12-06,-3,81,1,84
"7281",1979-12-07,-18,161,1,179
"7282",1979-12-08,-32,123,0,155
"7283",1979-12-09,4,160,0,156
"7284",1979-12-10,-28,99,0,127
"7285",1979-12-11,24,61,0,37
"7286",1979-12-12,2,45,0,43
"7287",1979-12-13,-50,102,0,152
"7288",1979-12-14,-35,115,0,150
"7289",1979-12-15,-52,78,0,130
"7290",1979-12-16,-9,92,0,101
"7291",1979-12-17,-24,113,0,137
"7292",1979-12-18,43,83,124,40
"7293",1979-12-19,9,147,1,138
"7294",1979-12-20,11,65,37,54
"7295",1979-12-21,5,92,12,87
"7296",1979-12-22,-17,48,3,65
"7297",1979-12-23,-18,23,0,41
"7298",1979-12-24,-34,34,7,68
"7299",1979-12-25,-44,76,0,120
"7300",1979-12-26,-2,69,0,71
"7301",1979-12-27,-12,72,0,84
"7302",1979-12-28,-32,115,0,147
"7303",1979-12-29,-24,120,0,144
"7304",1979-12-30,0,130,0,130
"7305",1979-12-31,-18,37,0,55
"7306",1980-01-01,-36,-6,23,30
"7307",1980-01-02,-65,51,0,116
"7308",1980-01-03,5,39,0,34
"7309",1980-01-04,-30,47,0,77
"7310",1980-01-05,-40,79,0,119
"7311",1980-01-06,17,58,0,41
"7312",1980-01-07,-58,100,0,158
"7313",1980-01-08,-45,84,0,129
"7314",1980-01-09,-57,42,0,99
"7315",1980-01-10,-44,8,0,52
"7316",1980-01-11,-51,15,0,66
"7317",1980-01-12,-31,68,0,99
"7318",1980-01-13,-70,88,0,158
"7319",1980-01-14,-40,91,0,131
"7320",1980-01-15,-55,107,0,162
"7321",1980-01-16,-38,95,0,133
"7322",1980-01-17,-55,31,0,86
"7323",1980-01-18,-58,-1,0,57
"7324",1980-01-19,-63,56,0,119
"7325",1980-01-20,-72,100,0,172
"7326",1980-01-21,-53,103,0,156
"7327",1980-01-22,-52,97,0,149
"7328",1980-01-23,-37,107,0,144
"7329",1980-01-24,-50,68,0,118
"7330",1980-01-25,-52,107,0,159
"7331",1980-01-26,-29,108,0,137
"7332",1980-01-27,-8,39,47,47
"7333",1980-01-28,-4,23,30,27
"7334",1980-01-29,-35,7,0,42
"7335",1980-01-30,-104,-22,0,82
"7336",1980-01-31,-82,-17,0,65
"7337",1980-02-01,-57,19,0,76
"7338",1980-02-02,-57,33,0,90
"7339",1980-02-03,-65,25,0,90
"7340",1980-02-04,-48,-15,0,33
"7341",1980-02-05,-104,27,0,131
"7342",1980-02-06,-90,3,0,93
"7343",1980-02-07,-77,19,0,96
"7344",1980-02-08,-84,36,0,120
"7345",1980-02-09,-120,63,0,183
"7346",1980-02-10,-47,86,0,133
"7347",1980-02-11,-42,66,0,108
"7348",1980-02-12,-55,110,0,165
"7349",1980-02-13,-30,30,0,60
"7350",1980-02-14,-74,58,0,132
"7351",1980-02-15,-49,71,0,120
"7352",1980-02-16,-12,106,0,118
"7353",1980-02-17,16,53,1,37
"7354",1980-02-18,-7,134,2,141
"7355",1980-02-19,-32,106,0,138
"7356",1980-02-20,-2,66,0,68
"7357",1980-02-21,-40,102,0,142
"7358",1980-02-22,-31,130,0,161
"7359",1980-02-23,-16,152,0,168
"7360",1980-02-24,2,142,0,140
"7361",1980-02-25,52,140,0,88
"7362",1980-02-26,57,102,0,45
"7363",1980-02-27,0,166,0,166
"7364",1980-02-28,-23,181,0,204
"7365",1980-02-29,43,161,0,118
"7366",1980-03-01,5,112,0,107
"7367",1980-03-02,51,89,0,38
"7368",1980-03-03,9,98,0,89
"7369",1980-03-04,18,83,18,65
"7370",1980-03-05,19,105,0,86
"7371",1980-03-06,22,131,0,109
"7372",1980-03-07,39,102,1,63
"7373",1980-03-08,57,87,73,30
"7374",1980-03-09,33,76,0,43
"7375",1980-03-10,-5,58,5,63
"7376",1980-03-11,-18,27,0,45
"7377",1980-03-12,-1,25,0,26
"7378",1980-03-13,9,66,6,57
"7379",1980-03-14,4,102,0,98
"7380",1980-03-15,3,127,0,124
"7381",1980-03-16,5,145,0,140
"7382",1980-03-17,12,179,0,167
"7383",1980-03-18,41,130,0,89
"7384",1980-03-19,44,169,0,125
"7385",1980-03-20,59,87,0,28
"7386",1980-03-21,-2,66,93,68
"7387",1980-03-22,-8,69,10,77
"7388",1980-03-23,24,74,0,50
"7389",1980-03-24,-15,101,0,116
"7390",1980-03-25,5,138,0,133
"7391",1980-03-26,-6,174,0,180
"7392",1980-03-27,25,193,0,168
"7393",1980-03-28,92,172,0,80
"7394",1980-03-29,58,186,0,128
"7395",1980-03-30,95,156,28,61
"7396",1980-03-31,77,154,14,77
"7397",1980-04-01,18,212,0,194
"7398",1980-04-02,53,237,0,184
"7399",1980-04-03,123,238,0,115
"7400",1980-04-04,114,192,3,78
"7401",1980-04-05,49,163,125,114
"7402",1980-04-06,34,119,0,85
"7403",1980-04-07,91,170,0,79
"7404",1980-04-08,92,158,0,66
"7405",1980-04-09,79,123,1,44
"7406",1980-04-10,26,190,0,164
"7407",1980-04-11,114,162,50,48
"7408",1980-04-12,106,154,1,48
"7409",1980-04-13,55,108,71,53
"7410",1980-04-14,18,148,0,130
"7411",1980-04-15,89,187,0,98
"7412",1980-04-16,22,227,0,205
"7413",1980-04-17,103,254,0,151
"7414",1980-04-18,105,346,0,241
"7415",1980-04-19,164,277,0,113
"7416",1980-04-20,51,218,21,167
"7417",1980-04-21,104,174,56,70
"7418",1980-04-22,91,169,0,78
"7419",1980-04-23,104,166,0,62
"7420",1980-04-24,78,147,52,69
"7421",1980-04-25,56,170,0,114
"7422",1980-04-26,68,178,0,110
"7423",1980-04-27,57,224,0,167
"7424",1980-04-28,80,248,0,168
"7425",1980-04-29,116,249,0,133
"7426",1980-04-30,118,285,0,167
"7427",1980-05-01,159,289,0,130
"7428",1980-05-02,139,290,0,151
"7429",1980-05-03,167,285,0,118
"7430",1980-05-04,163,243,2,80
"7431",1980-05-05,83,287,0,204
"7432",1980-05-06,124,210,2,86
"7433",1980-05-07,93,231,0,138
"7434",1980-05-08,139,231,0,92
"7435",1980-05-09,79,279,0,200
"7436",1980-05-10,141,279,0,138
"7437",1980-05-11,155,226,9,71
"7438",1980-05-12,128,314,0,186
"7439",1980-05-13,155,309,80,154
"7440",1980-05-14,182,248,415,66
"7441",1980-05-15,109,254,0,145
"7442",1980-05-16,94,204,0,110
"7443",1980-05-17,82,242,0,160
"7444",1980-05-18,146,216,0,70
"7445",1980-05-19,122,250,0,128
"7446",1980-05-20,144,280,0,136
"7447",1980-05-21,149,299,0,150
"7448",1980-05-22,160,280,0,120
"7449",1980-05-23,163,312,0,149
"7450",1980-05-24,214,295,1,81
"7451",1980-05-25,169,260,0,91
"7452",1980-05-26,93,292,0,199
"7453",1980-05-27,176,342,0,166
"7454",1980-05-28,146,350,0,204
"7455",1980-05-29,186,350,0,164
"7456",1980-05-30,205,342,0,137
"7457",1980-05-31,190,286,102,96
"7458",1980-06-01,162,195,418,33
"7459",1980-06-02,103,292,0,189
"7460",1980-06-03,133,325,0,192
"7461",1980-06-04,207,327,0,120
"7462",1980-06-05,196,315,0,119
"7463",1980-06-06,212,276,144,64
"7464",1980-06-07,182,347,0,165
"7465",1980-06-08,207,350,0,143
"7466",1980-06-09,214,297,7,83
"7467",1980-06-10,167,271,0,104
"7468",1980-06-11,190,300,0,110
"7469",1980-06-12,175,344,0,169
"7470",1980-06-13,200,343,0,143
"7471",1980-06-14,215,352,0,137
"7472",1980-06-15,253,344,10,91
"7473",1980-06-16,202,253,362,51
"7474",1980-06-17,203,299,2,96
"7475",1980-06-18,195,265,5,70
"7476",1980-06-19,205,275,2,70
"7477",1980-06-20,186,280,0,94
"7478",1980-06-21,202,315,0,113
"7479",1980-06-22,195,317,0,122
"7480",1980-06-23,210,285,0,75
"7481",1980-06-24,199,235,106,36
"7482",1980-06-25,177,305,0,128
"7483",1980-06-26,212,298,0,86
"7484",1980-06-27,212,326,0,114
"7485",1980-06-28,246,352,0,106
"7486",1980-06-29,271,345,0,74
"7487",1980-06-30,226,301,10,75
"7488",1980-07-01,216,278,260,62
"7489",1980-07-02,213,274,25,61
"7490",1980-07-03,193,221,270,28
"7491",1980-07-04,189,292,0,103
"7492",1980-07-05,207,340,0,133
"7493",1980-07-06,205,344,0,139
"7494",1980-07-07,214,320,0,106
"7495",1980-07-08,220,301,0,81
"7496",1980-07-09,220,309,0,89
"7497",1980-07-10,236,268,3,32
"7498",1980-07-11,206,310,0,104
"7499",1980-07-12,212,267,19,55
"7500",1980-07-13,203,262,14,59
"7501",1980-07-14,183,324,0,141
"7502",1980-07-15,224,343,0,119
"7503",1980-07-16,237,306,0,69
"7504",1980-07-17,236,310,0,74
"7505",1980-07-18,214,330,0,116
"7506",1980-07-19,239,326,0,87
"7507",1980-07-20,220,316,0,96
"7508",1980-07-21,217,343,0,126
"7509",1980-07-22,224,365,0,141
"7510",1980-07-23,231,376,0,145
"7511",1980-07-24,270,406,0,136
"7512",1980-07-25,256,337,77,81
"7513",1980-07-26,225,368,0,143
"7514",1980-07-27,237,352,252,115
"7515",1980-07-28,222,259,3,37
"7516",1980-07-29,216,251,170,35
"7517",1980-07-30,208,282,29,74
"7518",1980-07-31,217,292,13,75
"7519",1980-08-01,202,302,0,100
"7520",1980-08-02,200,297,0,97
"7521",1980-08-03,218,299,0,81
"7522",1980-08-04,216,290,25,74
"7523",1980-08-05,213,298,0,85
"7524",1980-08-06,193,302,0,109
"7525",1980-08-07,201,300,0,99
"7526",1980-08-08,219,296,0,77
"7527",1980-08-09,197,307,0,110
"7528",1980-08-10,209,322,0,113
"7529",1980-08-11,217,293,1,76
"7530",1980-08-12,196,324,0,128
"7531",1980-08-13,197,327,0,130
"7532",1980-08-14,211,317,6,106
"7533",1980-08-15,198,295,60,97
"7534",1980-08-16,209,287,0,78
"7535",1980-08-17,201,300,0,99
"7536",1980-08-18,206,291,0,85
"7537",1980-08-19,216,293,228,77
"7538",1980-08-20,211,283,0,72
"7539",1980-08-21,206,304,0,98
"7540",1980-08-22,213,305,0,92
"7541",1980-08-23,228,280,24,52
"7542",1980-08-24,196,243,105,47
"7543",1980-08-25,192,287,0,95
"7544",1980-08-26,200,300,0,100
"7545",1980-08-27,212,294,118,82
"7546",1980-08-28,210,280,12,70
"7547",1980-08-29,182,298,0,116
"7548",1980-08-30,212,335,0,123
"7549",1980-08-31,180,317,41,137
"7550",1980-09-01,185,344,0,159
"7551",1980-09-02,192,307,0,115
"7552",1980-09-03,200,312,369,112
"7553",1980-09-04,193,238,221,45
"7554",1980-09-05,172,258,0,86
"7555",1980-09-06,163,301,0,138
"7556",1980-09-07,183,266,0,83
"7557",1980-09-08,187,228,0,41
"7558",1980-09-09,176,262,0,86
"7559",1980-09-10,144,282,0,138
"7560",1980-09-11,165,332,0,167
"7561",1980-09-12,167,310,0,143
"7562",1980-09-13,180,261,0,81
"7563",1980-09-14,188,265,8,77
"7564",1980-09-15,185,236,2,51
"7565",1980-09-16,179,240,0,61
"7566",1980-09-17,105,266,0,161
"7567",1980-09-18,172,270,0,98
"7568",1980-09-19,126,301,0,175
"7569",1980-09-20,152,223,0,71
"7570",1980-09-21,165,246,0,81
"7571",1980-09-22,141,230,0,89
"7572",1980-09-23,114,245,0,131
"7573",1980-09-24,117,292,0,175
"7574",1980-09-25,136,299,0,163
"7575",1980-09-26,112,237,0,125
"7576",1980-09-27,115,278,0,163
"7577",1980-09-28,167,269,0,102
"7578",1980-09-29,114,275,0,161
"7579",1980-09-30,127,262,0,135
"7580",1980-10-01,147,280,0,133
"7581",1980-10-02,170,272,0,102
"7582",1980-10-03,158,245,0,87
"7583",1980-10-04,159,221,3,62
"7584",1980-10-05,160,231,2,71
"7585",1980-10-06,129,306,0,177
"7586",1980-10-07,119,346,0,227
"7587",1980-10-08,142,246,12,104
"7588",1980-10-09,111,145,635,34
"7589",1980-10-10,117,206,25,89
"7590",1980-10-11,134,169,0,35
"7591",1980-10-12,146,160,286,14
"7592",1980-10-13,118,199,0,81
"7593",1980-10-14,129,213,0,84
"7594",1980-10-15,144,206,2,62
"7595",1980-10-16,105,241,2,136
"7596",1980-10-17,124,204,0,80
"7597",1980-10-18,91,246,0,155
"7598",1980-10-19,103,213,0,110
"7599",1980-10-20,139,174,0,35
"7600",1980-10-21,111,148,6,37
"7601",1980-10-22,108,164,0,56
"7602",1980-10-23,101,181,0,80
"7603",1980-10-24,109,207,0,98
"7604",1980-10-25,69,158,0,89
"7605",1980-10-26,59,203,0,144
"7606",1980-10-27,21,217,0,196
"7607",1980-10-28,44,240,0,196
"7608",1980-10-29,38,186,0,148
"7609",1980-10-30,92,141,51,49
"7610",1980-10-31,36,137,52,101
"7611",1980-11-01,79,169,0,90
"7612",1980-11-02,29,193,0,164
"7613",1980-11-03,71,140,14,69
"7614",1980-11-04,41,222,0,181
"7615",1980-11-05,59,238,0,179
"7616",1980-11-06,77,236,0,159
"7617",1980-11-07,102,171,0,69
"7618",1980-11-08,12,108,0,96
"7619",1980-11-09,61,212,0,151
"7620",1980-11-10,26,240,0,214
"7621",1980-11-11,43,237,0,194
"7622",1980-11-12,83,149,0,66
"7623",1980-11-13,-14,135,0,149
"7624",1980-11-14,0,156,0,156
"7625",1980-11-15,38,134,0,96
"7626",1980-11-16,19,199,0,180
"7627",1980-11-17,34,155,0,121
"7628",1980-11-18,56,155,0,99
"7629",1980-11-19,44,117,0,73
"7630",1980-11-20,80,161,0,81
"7631",1980-11-21,73,148,0,75
"7632",1980-11-22,75,158,0,83
"7633",1980-11-23,82,135,1,53
"7634",1980-11-24,7,135,0,128
"7635",1980-11-25,-23,150,0,173
"7636",1980-11-26,76,147,0,71
"7637",1980-11-27,26,128,0,102
"7638",1980-11-28,4,167,0,163
"7639",1980-11-29,50,181,0,131
"7640",1980-11-30,75,173,0,98
"7641",1980-12-01,11,168,0,157
"7642",1980-12-02,9,115,0,106
"7643",1980-12-03,10,99,0,89
"7644",1980-12-04,-66,114,0,180
"7645",1980-12-05,3,153,0,150
"7646",1980-12-06,-21,156,0,177
"7647",1980-12-07,-29,132,0,161
"7648",1980-12-08,-23,135,0,158
"7649",1980-12-09,-24,120,0,144
"7650",1980-12-10,1,156,0,155
"7651",1980-12-11,9,115,0,106
"7652",1980-12-12,-59,88,0,147
"7653",1980-12-13,-65,13,0,78
"7654",1980-12-14,-57,92,0,149
"7655",1980-12-15,-36,22,0,58
"7656",1980-12-16,-55,82,0,137
"7657",1980-12-17,-35,94,0,129
"7658",1980-12-18,-30,55,0,85
"7659",1980-12-19,-59,92,0,151
"7660",1980-12-20,-8,94,0,102
"7661",1980-12-21,-44,128,0,172
"7662",1980-12-22,11,98,0,87
"7663",1980-12-23,-43,55,0,98
"7664",1980-12-24,-68,29,0,97
"7665",1980-12-25,-54,36,0,90
"7666",1980-12-26,-93,38,0,131
"7667",1980-12-27,-59,31,0,90
"7668",1980-12-28,-88,30,0,118
"7669",1980-12-29,-92,60,0,152
"7670",1980-12-30,-77,60,0,137
"7671",1980-12-31,-77,153,0,230
"7672",1981-01-01,-59,102,0,161
"7673",1981-01-02,-104,39,0,143
"7674",1981-01-03,-86,52,0,138
"7675",1981-01-04,-94,6,0,100
"7676",1981-01-05,-31,-2,0,29
"7677",1981-01-06,-41,11,4,52
"7678",1981-01-07,-22,68,0,90
"7679",1981-01-08,-38,94,0,132
"7680",1981-01-09,-14,62,3,76
"7681",1981-01-10,-35,69,0,104
"7682",1981-01-11,17,103,0,86
"7683",1981-01-12,4,120,0,116
"7684",1981-01-13,-23,129,0,152
"7685",1981-01-14,-41,81,0,122
"7686",1981-01-15,-49,9,0,58
"7687",1981-01-16,-84,36,0,120
"7688",1981-01-17,-54,73,0,127
"7689",1981-01-18,-44,48,0,92
"7690",1981-01-19,-53,30,0,83
"7691",1981-01-20,-36,-5,62,31
"7692",1981-01-21,-39,-13,10,26
"7693",1981-01-22,-34,-11,0,23
"7694",1981-01-23,-36,-11,58,25
"7695",1981-01-24,-48,-7,0,41
"7696",1981-01-25,-73,-24,6,49
"7697",1981-01-26,-78,-34,0,44
"7698",1981-01-27,-114,9,0,123
"7699",1981-01-28,-78,33,0,111
"7700",1981-01-29,-39,15,0,54
"7701",1981-01-30,-24,13,0,37
"7702",1981-01-31,-34,62,0,96
"7703",1981-02-01,-3,89,0,92
"7704",1981-02-02,-6,67,0,73
"7705",1981-02-03,-52,44,0,96
"7706",1981-02-04,-26,31,0,57
"7707",1981-02-05,-34,72,0,106
"7708",1981-02-06,-31,86,0,117
"7709",1981-02-07,-39,131,0,170
"7710",1981-02-08,41,122,0,81
"7711",1981-02-09,19,95,0,76
"7712",1981-02-10,3,128,0,125
"7713",1981-02-11,-29,147,0,176
"7714",1981-02-12,0,140,0,140
"7715",1981-02-13,20,194,0,174
"7716",1981-02-14,65,122,0,57
"7717",1981-02-15,46,86,0,40
"7718",1981-02-16,-11,68,19,79
"7719",1981-02-17,-16,67,0,83
"7720",1981-02-18,7,97,0,90
"7721",1981-02-19,16,54,4,38
"7722",1981-02-20,0,85,0,85
"7723",1981-02-21,3,102,0,99
"7724",1981-02-22,7,97,0,90
"7725",1981-02-23,5,44,0,39
"7726",1981-02-24,2,53,0,51
"7727",1981-02-25,-47,33,0,80
"7728",1981-02-26,-76,33,0,109
"7729",1981-02-27,-33,49,0,82
"7730",1981-02-28,-30,37,0,67
"7731",1981-03-01,-12,61,0,73
"7732",1981-03-02,-25,48,5,73
"7733",1981-03-03,-12,142,0,154
"7734",1981-03-04,68,164,0,96
"7735",1981-03-05,3,137,0,134
"7736",1981-03-06,-31,160,0,191
"7737",1981-03-07,8,215,0,207
"7738",1981-03-08,-9,162,0,171
"7739",1981-03-09,-27,140,0,167
"7740",1981-03-10,38,180,0,142
"7741",1981-03-11,28,177,0,149
"7742",1981-03-12,44,189,0,145
"7743",1981-03-13,42,233,0,191
"7744",1981-03-14,112,196,0,84
"7745",1981-03-15,10,193,0,183
"7746",1981-03-16,56,214,0,158
"7747",1981-03-17,70,205,0,135
"7748",1981-03-18,71,228,0,157
"7749",1981-03-19,91,219,0,128
"7750",1981-03-20,68,170,36,102
"7751",1981-03-21,15,213,0,198
"7752",1981-03-22,85,175,0,90
"7753",1981-03-23,67,133,127,66
"7754",1981-03-24,69,172,47,103
"7755",1981-03-25,79,155,0,76
"7756",1981-03-26,23,162,0,139
"7757",1981-03-27,73,114,0,41
"7758",1981-03-28,39,143,0,104
"7759",1981-03-29,83,166,0,83
"7760",1981-03-30,77,117,0,40
"7761",1981-03-31,73,101,1,28
"7762",1981-04-01,84,124,0,40
"7763",1981-04-02,35,147,0,112
"7764",1981-04-03,67,132,11,65
"7765",1981-04-04,28,187,0,159
"7766",1981-04-05,63,247,0,184
"7767",1981-04-06,75,240,0,165
"7768",1981-04-07,78,182,0,104
"7769",1981-04-08,103,163,12,60
"7770",1981-04-09,85,238,0,153
"7771",1981-04-10,75,256,0,181
"7772",1981-04-11,81,224,0,143
"7773",1981-04-12,106,182,0,76
"7774",1981-04-13,109,167,0,58
"7775",1981-04-14,84,198,0,114
"7776",1981-04-15,66,241,0,175
"7777",1981-04-16,88,240,0,152
"7778",1981-04-17,90,181,58,91
"7779",1981-04-18,112,252,2,140
"7780",1981-04-19,92,212,0,120
"7781",1981-04-20,93,185,0,92
"7782",1981-04-21,95,241,6,146
"7783",1981-04-22,76,290,0,214
"7784",1981-04-23,148,307,0,159
"7785",1981-04-24,131,246,2,115
"7786",1981-04-25,62,275,0,213
"7787",1981-04-26,64,285,0,221
"7788",1981-04-27,96,321,0,225
"7789",1981-04-28,190,282,0,92
"7790",1981-04-29,98,271,0,173
"7791",1981-04-30,102,294,0,192
"7792",1981-05-01,169,310,0,141
"7793",1981-05-02,141,271,0,130
"7794",1981-05-03,79,236,0,157
"7795",1981-05-04,102,285,0,183
"7796",1981-05-05,121,312,0,191
"7797",1981-05-06,124,337,0,213
"7798",1981-05-07,155,367,0,212
"7799",1981-05-08,235,377,0,142
"7800",1981-05-09,178,305,0,127
"7801",1981-05-10,131,290,20,159
"7802",1981-05-11,90,242,0,152
"7803",1981-05-12,85,285,0,200
"7804",1981-05-13,129,255,0,126
"7805",1981-05-14,155,250,0,95
"7806",1981-05-15,123,270,0,147
"7807",1981-05-16,98,285,0,187
"7808",1981-05-17,92,332,0,240
"7809",1981-05-18,122,240,0,118
"7810",1981-05-19,101,274,0,173
"7811",1981-05-20,97,281,0,184
"7812",1981-05-21,135,292,0,157
"7813",1981-05-22,162,294,0,132
"7814",1981-05-23,126,310,0,184
"7815",1981-05-24,162,342,0,180
"7816",1981-05-25,204,342,0,138
"7817",1981-05-26,192,322,0,130
"7818",1981-05-27,188,340,0,152
"7819",1981-05-28,165,313,0,148
"7820",1981-05-29,190,312,0,122
"7821",1981-05-30,159,334,0,175
"7822",1981-05-31,160,288,0,128
"7823",1981-06-01,179,295,0,116
"7824",1981-06-02,149,276,0,127
"7825",1981-06-03,159,294,0,135
"7826",1981-06-04,134,338,0,204
"7827",1981-06-05,195,346,0,151
"7828",1981-06-06,185,355,0,170
"7829",1981-06-07,205,331,0,126
"7830",1981-06-08,215,294,84,79
"7831",1981-06-09,198,235,70,37
"7832",1981-06-10,160,257,0,97
"7833",1981-06-11,186,277,0,91
"7834",1981-06-12,155,329,0,174
"7835",1981-06-13,194,343,0,149
"7836",1981-06-14,208,374,0,166
"7837",1981-06-15,235,378,0,143
"7838",1981-06-16,225,384,0,159
"7839",1981-06-17,235,355,0,120
"7840",1981-06-18,219,371,0,152
"7841",1981-06-19,236,370,8,134
"7842",1981-06-20,225,280,71,55
"7843",1981-06-21,225,309,250,84
"7844",1981-06-22,231,285,6,54
"7845",1981-06-23,197,295,0,98
"7846",1981-06-24,191,217,168,26
"7847",1981-06-25,173,300,0,127
"7848",1981-06-26,212,341,0,129
"7849",1981-06-27,249,323,0,74
"7850",1981-06-28,204,340,0,136
"7851",1981-06-29,213,331,0,118
"7852",1981-06-30,222,316,0,94
"7853",1981-07-01,214,327,0,113
"7854",1981-07-02,218,346,0,128
"7855",1981-07-03,262,332,0,70
"7856",1981-07-04,250,317,136,67
"7857",1981-07-05,246,325,0,79
"7858",1981-07-06,255,294,2,39
"7859",1981-07-07,247,350,8,103
"7860",1981-07-08,265,356,0,91
"7861",1981-07-09,248,293,0,45
"7862",1981-07-10,225,289,0,64
"7863",1981-07-11,202,325,0,123
"7864",1981-07-12,205,327,0,122
"7865",1981-07-13,243,320,0,77
"7866",1981-07-14,245,287,163,42
"7867",1981-07-15,213,255,325,42
"7868",1981-07-16,208,286,0,78
"7869",1981-07-17,234,328,0,94
"7870",1981-07-18,254,355,2,101
"7871",1981-07-19,245,346,0,101
"7872",1981-07-20,250,342,0,92
"7873",1981-07-21,231,347,0,116
"7874",1981-07-22,250,357,0,107
"7875",1981-07-23,241,355,0,114
"7876",1981-07-24,248,340,0,92
"7877",1981-07-25,225,308,52,83
"7878",1981-07-26,233,323,17,90
"7879",1981-07-27,232,342,0,110
"7880",1981-07-28,262,348,1,86
"7881",1981-07-29,236,325,770,89
"7882",1981-07-30,252,335,76,83
"7883",1981-07-31,254,325,5,71
"7884",1981-08-01,253,335,0,82
"7885",1981-08-02,244,344,0,100
"7886",1981-08-03,255,359,0,104
"7887",1981-08-04,227,310,0,83
"7888",1981-08-05,219,281,0,62
"7889",1981-08-06,230,344,0,114
"7890",1981-08-07,227,360,0,133
"7891",1981-08-08,258,340,0,82
"7892",1981-08-09,225,323,60,98
"7893",1981-08-10,220,253,158,33
"7894",1981-08-11,219,298,0,79
"7895",1981-08-12,229,300,0,71
"7896",1981-08-13,208,317,0,109
"7897",1981-08-14,212,304,0,92
"7898",1981-08-15,240,306,0,66
"7899",1981-08-16,235,276,0,41
"7900",1981-08-17,235,292,2,57
"7901",1981-08-18,235,294,32,59
"7902",1981-08-19,217,262,0,45
"7903",1981-08-20,224,293,499,69
"7904",1981-08-21,209,295,0,86
"7905",1981-08-22,234,288,2,54
"7906",1981-08-23,196,249,143,53
"7907",1981-08-24,185,234,307,49
"7908",1981-08-25,212,305,3,93
"7909",1981-08-26,200,307,0,107
"7910",1981-08-27,198,313,0,115
"7911",1981-08-28,177,302,0,125
"7912",1981-08-29,220,288,6,68
"7913",1981-08-30,179,312,1,133
"7914",1981-08-31,234,277,0,43
"7915",1981-09-01,225,298,1,73
"7916",1981-09-02,194,282,0,88
"7917",1981-09-03,187,313,0,126
"7918",1981-09-04,223,273,0,50
"7919",1981-09-05,210,262,0,52
"7920",1981-09-06,192,239,10,47
"7921",1981-09-07,170,202,50,32
"7922",1981-09-08,167,299,0,132
"7923",1981-09-09,178,226,2,48
"7924",1981-09-10,122,276,0,154
"7925",1981-09-11,160,267,0,107
"7926",1981-09-12,173,255,0,82
"7927",1981-09-13,176,218,13,42
"7928",1981-09-14,163,250,0,87
"7929",1981-09-15,146,283,0,137
"7930",1981-09-16,149,276,0,127
"7931",1981-09-17,147,296,0,149
"7932",1981-09-18,143,318,92,175
"7933",1981-09-19,164,321,0,157
"7934",1981-09-20,182,325,0,143
"7935",1981-09-21,165,311,0,146
"7936",1981-09-22,155,289,0,134
"7937",1981-09-23,141,285,0,144
"7938",1981-09-24,170,295,0,125
"7939",1981-09-25,143,307,0,164
"7940",1981-09-26,166,306,0,140
"7941",1981-09-27,123,261,21,138
"7942",1981-09-28,89,128,281,39
"7943",1981-09-29,72,157,1,85
"7944",1981-09-30,129,183,13,54
"7945",1981-10-01,139,207,0,68
"7946",1981-10-02,103,174,0,71
"7947",1981-10-03,126,173,1,47
"7948",1981-10-04,134,182,2,48
"7949",1981-10-05,112,196,0,84
"7950",1981-10-06,125,194,0,69
"7951",1981-10-07,126,197,0,71
"7952",1981-10-08,95,199,0,104
"7953",1981-10-09,81,201,0,120
"7954",1981-10-10,19,244,0,225
"7955",1981-10-11,74,248,0,174
"7956",1981-10-12,74,268,0,194
"7957",1981-10-13,96,206,0,110
"7958",1981-10-14,111,176,0,65
"7959",1981-10-15,86,199,0,113
"7960",1981-10-16,74,225,0,151
"7961",1981-10-17,114,185,0,71
"7962",1981-10-18,96,174,0,78
"7963",1981-10-19,126,192,8,66
"7964",1981-10-20,114,180,3,66
"7965",1981-10-21,111,170,10,59
"7966",1981-10-22,70,162,6,92
"7967",1981-10-23,49,147,0,98
"7968",1981-10-24,62,181,0,119
"7969",1981-10-25,44,192,0,148
"7970",1981-10-26,20,198,0,178
"7971",1981-10-27,91,150,13,59
"7972",1981-10-28,86,193,0,107
"7973",1981-10-29,36,237,0,201
"7974",1981-10-30,55,235,0,180
"7975",1981-10-31,72,137,0,65
"7976",1981-11-01,52,103,67,51
"7977",1981-11-02,18,169,0,151
"7978",1981-11-03,52,133,0,81
"7979",1981-11-04,44,95,30,51
"7980",1981-11-05,24,47,159,23
"7981",1981-11-06,35,55,10,20
"7982",1981-11-07,26,77,0,51
"7983",1981-11-08,8,92,0,84
"7984",1981-11-09,-10,119,0,129
"7985",1981-11-10,28,155,0,127
"7986",1981-11-11,-23,158,0,181
"7987",1981-11-12,2,179,0,177
"7988",1981-11-13,10,160,0,150
"7989",1981-11-14,11,160,0,149
"7990",1981-11-15,81,176,0,95
"7991",1981-11-16,11,155,0,144
"7992",1981-11-17,-41,77,0,118
"7993",1981-11-18,0,112,0,112
"7994",1981-11-19,36,160,0,124
"7995",1981-11-20,30,128,0,98
"7996",1981-11-21,-6,76,0,82
"7997",1981-11-22,52,85,9,33
"7998",1981-11-23,23,113,0,90
"7999",1981-11-24,5,62,0,57
"8000",1981-11-25,14,44,11,30
"8001",1981-11-26,-11,71,0,82
"8002",1981-11-27,-41,62,0,103
"8003",1981-11-28,-47,92,0,139
"8004",1981-11-29,30,112,1,82
"8005",1981-11-30,2,75,0,73
"8006",1981-12-01,-49,43,0,92
"8007",1981-12-02,-85,22,0,107
"8008",1981-12-03,-41,61,0,102
"8009",1981-12-04,-38,88,0,126
"8010",1981-12-05,-37,74,0,111
"8011",1981-12-06,-33,116,0,149
"8012",1981-12-07,1,123,0,122
"8013",1981-12-08,-44,98,0,142
"8014",1981-12-09,-28,113,0,141
"8015",1981-12-10,-39,127,0,166
"8016",1981-12-11,32,135,0,103
"8017",1981-12-12,-18,78,0,96
"8018",1981-12-13,2,74,0,72
"8019",1981-12-14,-54,78,0,132
"8020",1981-12-15,-40,96,0,136
"8021",1981-12-16,-53,64,0,117
"8022",1981-12-17,-37,30,0,67
"8023",1981-12-18,-31,25,0,56
"8024",1981-12-19,-38,49,0,87
"8025",1981-12-20,-1,109,0,110
"8026",1981-12-21,-55,117,0,172
"8027",1981-12-22,26,115,0,89
"8028",1981-12-23,-20,86,0,106
"8029",1981-12-24,-54,93,0,147
"8030",1981-12-25,-2,122,0,124
"8031",1981-12-26,-29,162,0,191
"8032",1981-12-27,-31,108,0,139
"8033",1981-12-28,-21,47,0,68
"8034",1981-12-29,-37,20,0,57
"8035",1981-12-30,-20,68,0,88
"8036",1981-12-31,-33,56,0,89
"8037",1982-01-01,-58,64,0,122
"8038",1982-01-02,-37,3,0,40
"8039",1982-01-03,-29,97,0,126
"8040",1982-01-04,-28,83,0,111
"8041",1982-01-05,-39,89,0,128
"8042",1982-01-06,-37,57,0,94
"8043",1982-01-07,-79,64,0,143
"8044",1982-01-08,-35,172,0,207
"8045",1982-01-09,-26,111,0,137
"8046",1982-01-10,-44,116,0,160
"8047",1982-01-11,-9,161,0,170
"8048",1982-01-12,-52,43,0,95
"8049",1982-01-13,-49,24,0,73
"8050",1982-01-14,-70,98,0,168
"8051",1982-01-15,-47,18,0,65
"8052",1982-01-16,-108,34,0,142
"8053",1982-01-17,-92,66,0,158
"8054",1982-01-18,-52,34,0,86
"8055",1982-01-19,-79,66,0,145
"8056",1982-01-20,-87,81,0,168
"8057",1982-01-21,-30,111,0,141
"8058",1982-01-22,-55,60,0,115
"8059",1982-01-23,1,25,2,24
"8060",1982-01-24,3,42,0,39
"8061",1982-01-25,6,80,8,74
"8062",1982-01-26,-28,96,0,124
"8063",1982-01-27,-26,37,0,63
"8064",1982-01-28,-43,4,0,47
"8065",1982-01-29,-59,-3,0,56
"8066",1982-01-30,-56,21,5,77
"8067",1982-01-31,-61,44,14,105
"8068",1982-02-01,-39,21,0,60
"8069",1982-02-02,-31,1,26,32
"8070",1982-02-03,-30,-2,51,28
"8071",1982-02-04,-87,-8,0,79
"8072",1982-02-05,-76,23,0,99
"8073",1982-02-06,-60,18,0,78
"8074",1982-02-07,-23,26,0,49
"8075",1982-02-08,-36,45,0,81
"8076",1982-02-09,-47,76,0,123
"8077",1982-02-10,0,72,0,72
"8078",1982-02-11,-3,94,0,97
"8079",1982-02-12,-26,97,0,123
"8080",1982-02-13,-14,77,0,91
"8081",1982-02-14,-11,82,0,93
"8082",1982-02-15,-19,116,0,135
"8083",1982-02-16,-15,98,0,113
"8084",1982-02-17,-38,103,0,141
"8085",1982-02-18,45,76,11,31
"8086",1982-02-19,-11,111,0,122
"8087",1982-02-20,-3,113,0,116
"8088",1982-02-21,9,117,0,108
"8089",1982-02-22,56,102,0,46
"8090",1982-02-23,39,106,7,67
"8091",1982-02-24,9,67,20,58
"8092",1982-02-25,-23,69,0,92
"8093",1982-02-26,34,130,0,96
"8094",1982-02-27,-5,154,0,159
"8095",1982-02-28,35,102,7,67
"8096",1982-03-01,-28,122,0,150
"8097",1982-03-02,12,143,0,131
"8098",1982-03-03,28,167,0,139
"8099",1982-03-04,86,126,0,40
"8100",1982-03-05,39,111,3,72
"8101",1982-03-06,30,100,0,70
"8102",1982-03-07,22,119,0,97
"8103",1982-03-08,24,157,0,133
"8104",1982-03-09,7,202,0,195
"8105",1982-03-10,1,233,0,232
"8106",1982-03-11,76,198,0,122
"8107",1982-03-12,50,191,0,141
"8108",1982-03-13,52,143,0,91
"8109",1982-03-14,98,174,5,76
"8110",1982-03-15,42,242,0,200
"8111",1982-03-16,2,149,180,147
"8112",1982-03-17,0,60,116,60
"8113",1982-03-18,17,56,15,39
"8114",1982-03-19,21,84,42,63
"8115",1982-03-20,4,160,0,156
"8116",1982-03-21,46,198,0,152
"8117",1982-03-22,74,183,0,109
"8118",1982-03-23,65,148,2,83
"8119",1982-03-24,7,67,21,60
"8120",1982-03-25,19,65,0,46
"8121",1982-03-26,8,79,0,71
"8122",1982-03-27,-11,160,0,171
"8123",1982-03-28,44,147,0,103
"8124",1982-03-29,81,135,1,54
"8125",1982-03-30,33,222,0,189
"8126",1982-03-31,117,222,0,105
"8127",1982-04-01,101,201,26,100
"8128",1982-04-02,104,158,65,54
"8129",1982-04-03,59,158,0,99
"8130",1982-04-04,62,166,0,104
"8131",1982-04-05,26,171,0,145
"8132",1982-04-06,11,202,0,191
"8133",1982-04-07,37,258,0,221
"8134",1982-04-08,115,183,0,68
"8135",1982-04-09,29,192,0,163
"8136",1982-04-10,92,222,0,130
"8137",1982-04-11,58,246,0,188
"8138",1982-04-12,99,237,6,138
"8139",1982-04-13,76,247,0,171
"8140",1982-04-14,113,269,0,156
"8141",1982-04-15,79,212,0,133
"8142",1982-04-16,44,190,0,146
"8143",1982-04-17,88,194,0,106
"8144",1982-04-18,49,215,0,166
"8145",1982-04-19,69,228,24,159
"8146",1982-04-20,100,246,4,146
"8147",1982-04-21,103,240,0,137
"8148",1982-04-22,126,278,0,152
"8149",1982-04-23,122,291,0,169
"8150",1982-04-24,114,297,0,183
"8151",1982-04-25,143,265,0,122
"8152",1982-04-26,104,253,0,149
"8153",1982-04-27,132,208,0,76
"8154",1982-04-28,129,232,0,103
"8155",1982-04-29,133,183,2,50
"8156",1982-04-30,62,256,0,194
"8157",1982-05-01,110,302,0,192
"8158",1982-05-02,176,260,0,84
"8159",1982-05-03,121,226,0,105
"8160",1982-05-04,97,307,0,210
"8161",1982-05-05,159,240,0,81
"8162",1982-05-06,97,269,0,172
"8163",1982-05-07,112,304,0,192
"8164",1982-05-08,163,287,0,124
"8165",1982-05-09,200,316,0,116
"8166",1982-05-10,154,323,0,169
"8167",1982-05-11,187,296,0,109
"8168",1982-05-12,117,250,238,133
"8169",1982-05-13,111,230,6,119
"8170",1982-05-14,125,264,0,139
"8171",1982-05-15,129,296,0,167
"8172",1982-05-16,154,315,0,161
"8173",1982-05-17,157,313,0,156
"8174",1982-05-18,171,287,0,116
"8175",1982-05-19,155,310,0,155
"8176",1982-05-20,147,334,0,187
"8177",1982-05-21,139,360,0,221
"8178",1982-05-22,171,383,0,212
"8179",1982-05-23,198,334,0,136
"8180",1982-05-24,192,385,0,193
"8181",1982-05-25,239,367,0,128
"8182",1982-05-26,230,324,0,94
"8183",1982-05-27,202,310,0,108
"8184",1982-05-28,204,256,52,52
"8185",1982-05-29,165,210,251,45
"8186",1982-05-30,179,233,114,54
"8187",1982-05-31,200,285,0,85
"8188",1982-06-01,173,273,12,100
"8189",1982-06-02,141,287,0,146
"8190",1982-06-03,165,327,0,162
"8191",1982-06-04,212,285,0,73
"8192",1982-06-05,149,299,0,150
"8193",1982-06-06,169,339,0,170
"8194",1982-06-07,185,347,0,162
"8195",1982-06-08,184,316,8,132
"8196",1982-06-09,188,276,280,88
"8197",1982-06-10,203,298,0,95
"8198",1982-06-11,204,290,0,86
"8199",1982-06-12,202,329,1,127
"8200",1982-06-13,187,310,0,123
"8201",1982-06-14,201,287,0,86
"8202",1982-06-15,211,312,0,101
"8203",1982-06-16,219,351,0,132
"8204",1982-06-17,193,360,5,167
"8205",1982-06-18,223,336,0,113
"8206",1982-06-19,225,358,0,133
"8207",1982-06-20,222,355,0,133
"8208",1982-06-21,153,294,114,141
"8209",1982-06-22,126,292,0,166
"8210",1982-06-23,153,296,0,143
"8211",1982-06-24,166,338,0,172
"8212",1982-06-25,220,343,0,123
"8213",1982-06-26,226,327,59,101
"8214",1982-06-27,214,256,0,42
"8215",1982-06-28,199,282,0,83
"8216",1982-06-29,172,300,0,128
"8217",1982-06-30,183,327,0,144
"8218",1982-07-01,214,330,0,116
"8219",1982-07-02,203,299,0,96
"8220",1982-07-03,214,280,0,66
"8221",1982-07-04,190,295,0,105
"8222",1982-07-05,182,300,0,118
"8223",1982-07-06,193,319,0,126
"8224",1982-07-07,195,336,0,141
"8225",1982-07-08,245,362,44,117
"8226",1982-07-09,242,343,16,101
"8227",1982-07-10,224,304,175,80
"8228",1982-07-11,235,337,0,102
"8229",1982-07-12,200,275,89,75
"8230",1982-07-13,193,275,50,82
"8231",1982-07-14,185,303,0,118
"8232",1982-07-15,230,320,0,90
"8233",1982-07-16,225,319,0,94
"8234",1982-07-17,201,330,0,129
"8235",1982-07-18,210,337,0,127
"8236",1982-07-19,224,301,0,77
"8237",1982-07-20,231,280,120,49
"8238",1982-07-21,237,282,2,45
"8239",1982-07-22,235,297,13,62
"8240",1982-07-23,244,309,21,65
"8241",1982-07-24,228,298,12,70
"8242",1982-07-25,177,314,0,137
"8243",1982-07-26,194,312,0,118
"8244",1982-07-27,246,320,0,74
"8245",1982-07-28,230,315,30,85
"8246",1982-07-29,239,303,0,64
"8247",1982-07-30,245,300,29,55
"8248",1982-07-31,228,273,521,45
"8249",1982-08-01,230,257,671,27
"8250",1982-08-02,235,280,474,45
"8251",1982-08-03,220,258,40,38
"8252",1982-08-04,232,301,186,69
"8253",1982-08-05,218,336,0,118
"8254",1982-08-06,235,330,0,95
"8255",1982-08-07,237,327,0,90
"8256",1982-08-08,232,318,7,86
"8257",1982-08-09,238,317,40,79
"8258",1982-08-10,236,312,12,76
"8259",1982-08-11,234,307,0,73
"8260",1982-08-12,214,260,412,46
"8261",1982-08-13,211,268,262,57
"8262",1982-08-14,235,284,72,49
"8263",1982-08-15,234,308,1,74
"8264",1982-08-16,222,318,0,96
"8265",1982-08-17,243,320,0,77
"8266",1982-08-18,202,351,0,149
"8267",1982-08-19,231,322,0,91
"8268",1982-08-20,232,282,1,50
"8269",1982-08-21,197,252,2,55
"8270",1982-08-22,148,277,0,129
"8271",1982-08-23,180,280,0,100
"8272",1982-08-24,206,251,79,45
"8273",1982-08-25,201,286,0,85
"8274",1982-08-26,174,325,0,151
"8275",1982-08-27,189,328,0,139
"8276",1982-08-28,227,276,0,49
"8277",1982-08-29,206,233,16,27
"8278",1982-08-30,208,235,62,27
"8279",1982-08-31,186,216,72,30
"8280",1982-09-01,185,214,8,29
"8281",1982-09-02,182,213,11,31
"8282",1982-09-03,183,217,2,34
"8283",1982-09-04,179,282,0,103
"8284",1982-09-05,200,295,5,95
"8285",1982-09-06,156,273,0,117
"8286",1982-09-07,155,266,11,111
"8287",1982-09-08,162,282,0,120
"8288",1982-09-09,147,273,0,126
"8289",1982-09-10,156,276,0,120
"8290",1982-09-11,164,288,0,124
"8291",1982-09-12,163,292,0,129
"8292",1982-09-13,190,267,0,77
"8293",1982-09-14,126,275,0,149
"8294",1982-09-15,143,286,0,143
"8295",1982-09-16,160,279,0,119
"8296",1982-09-17,187,233,85,46
"8297",1982-09-18,175,222,74,47
"8298",1982-09-19,162,283,0,121
"8299",1982-09-20,155,260,0,105
"8300",1982-09-21,111,251,0,140
"8301",1982-09-22,126,268,0,142
"8302",1982-09-23,111,266,0,155
"8303",1982-09-24,107,272,0,165
"8304",1982-09-25,181,281,5,100
"8305",1982-09-26,145,215,2,70
"8306",1982-09-27,139,220,0,81
"8307",1982-09-28,56,188,1,132
"8308",1982-09-29,95,207,35,112
"8309",1982-09-30,142,167,149,25
"8310",1982-10-01,145,153,299,8
"8311",1982-10-02,149,238,2,89
"8312",1982-10-03,168,249,0,81
"8313",1982-10-04,161,217,0,56
"8314",1982-10-05,111,267,0,156
"8315",1982-10-06,119,288,0,169
"8316",1982-10-07,126,292,0,166
"8317",1982-10-08,127,271,0,144
"8318",1982-10-09,116,260,0,144
"8319",1982-10-10,101,261,0,160
"8320",1982-10-11,107,277,0,170
"8321",1982-10-12,135,272,0,137
"8322",1982-10-13,142,250,7,108
"8323",1982-10-14,160,270,0,110
"8324",1982-10-15,165,242,0,77
"8325",1982-10-16,123,182,0,59
"8326",1982-10-17,91,274,0,183
"8327",1982-10-18,115,293,0,178
"8328",1982-10-19,123,221,0,98
"8329",1982-10-20,90,237,0,147
"8330",1982-10-21,71,254,0,183
"8331",1982-10-22,84,204,0,120
"8332",1982-10-23,95,132,12,37
"8333",1982-10-24,51,167,0,116
"8334",1982-10-25,66,180,0,114
"8335",1982-10-26,77,189,0,112
"8336",1982-10-27,119,160,0,41
"8337",1982-10-28,133,205,0,72
"8338",1982-10-29,99,186,14,87
"8339",1982-10-30,97,185,2,88
"8340",1982-10-31,94,203,0,109
"8341",1982-11-01,64,152,0,88
"8342",1982-11-02,19,170,0,151
"8343",1982-11-03,61,185,0,124
"8344",1982-11-04,126,203,0,77
"8345",1982-11-05,70,187,0,117
"8346",1982-11-06,131,165,0,34
"8347",1982-11-07,117,152,0,35
"8348",1982-11-08,95,150,53,55
"8349",1982-11-09,55,149,0,94
"8350",1982-11-10,-16,122,0,138
"8351",1982-11-11,62,196,0,134
"8352",1982-11-12,12,145,0,133
"8353",1982-11-13,21,177,0,156
"8354",1982-11-14,52,155,0,103
"8355",1982-11-15,11,107,0,96
"8356",1982-11-16,-14,145,0,159
"8357",1982-11-17,3,154,0,151
"8358",1982-11-18,44,122,0,78
"8359",1982-11-19,-13,127,0,140
"8360",1982-11-20,-24,85,6,109
"8361",1982-11-21,54,90,39,36
"8362",1982-11-22,60,114,0,54
"8363",1982-11-23,39,132,0,93
"8364",1982-11-24,-12,77,0,89
"8365",1982-11-25,41,73,0,32
"8366",1982-11-26,34,84,0,50
"8367",1982-11-27,32,60,27,28
"8368",1982-11-28,17,47,110,30
"8369",1982-11-29,29,112,1,83
"8370",1982-11-30,6,134,0,128
"8371",1982-12-01,-24,151,0,175
"8372",1982-12-02,25,110,0,85
"8373",1982-12-03,-7,127,0,134
"8374",1982-12-04,15,114,0,99
"8375",1982-12-05,-48,50,0,98
"8376",1982-12-06,-75,39,0,114
"8377",1982-12-07,-69,34,0,103
"8378",1982-12-08,-15,43,0,58
"8379",1982-12-09,-1,62,0,63
"8380",1982-12-10,7,75,0,68
"8381",1982-12-11,0,67,0,67
"8382",1982-12-12,-66,66,0,132
"8383",1982-12-13,-26,81,0,107
"8384",1982-12-14,-57,63,0,120
"8385",1982-12-15,-7,76,0,83
"8386",1982-12-16,-1,82,0,83
"8387",1982-12-17,-25,82,0,107
"8388",1982-12-18,-6,110,0,116
"8389",1982-12-19,-41,132,0,173
"8390",1982-12-20,2,114,0,112
"8391",1982-12-21,-27,145,0,172
"8392",1982-12-22,-1,78,0,79
"8393",1982-12-23,-47,145,0,192
"8394",1982-12-24,13,96,0,83
"8395",1982-12-25,-43,36,0,79
"8396",1982-12-26,-13,94,0,107
"8397",1982-12-27,-53,108,0,161
"8398",1982-12-28,-31,128,0,159
"8399",1982-12-29,-46,78,0,124
"8400",1982-12-30,-1,69,0,70
"8401",1982-12-31,-35,26,0,61
"8402",1983-01-01,-24,53,0,77
"8403",1983-01-02,-66,67,0,133
"8404",1983-01-03,-46,57,0,103
"8405",1983-01-04,-11,60,0,71
"8406",1983-01-05,-59,69,0,128
"8407",1983-01-06,-48,13,0,61
"8408",1983-01-07,-54,20,0,74
"8409",1983-01-08,-109,-2,0,107
"8410",1983-01-09,-72,24,0,96
"8411",1983-01-10,-99,12,0,111
"8412",1983-01-11,-55,55,0,110
"8413",1983-01-12,-71,77,0,148
"8414",1983-01-13,-35,80,0,115
"8415",1983-01-14,-68,67,0,135
"8416",1983-01-15,-61,67,0,128
"8417",1983-01-16,-49,57,0,106
"8418",1983-01-17,-14,56,0,70
"8419",1983-01-18,-41,74,0,115
"8420",1983-01-19,-54,30,0,84
"8421",1983-01-20,-98,63,0,161
"8422",1983-01-21,-84,36,0,120
"8423",1983-01-22,-96,60,0,156
"8424",1983-01-23,-87,90,0,177
"8425",1983-01-24,-83,99,0,182
"8426",1983-01-25,-74,152,0,226
"8427",1983-01-26,-37,92,0,129
"8428",1983-01-27,-50,101,0,151
"8429",1983-01-28,-33,127,0,160
"8430",1983-01-29,-11,100,0,111
"8431",1983-01-30,-31,60,0,91
"8432",1983-01-31,-47,7,10,54
"8433",1983-02-01,-26,22,0,48
"8434",1983-02-02,-16,37,0,53
"8435",1983-02-03,-43,83,0,126
"8436",1983-02-04,-25,129,0,154
"8437",1983-02-05,-38,167,0,205
"8438",1983-02-06,-6,82,0,88
"8439",1983-02-07,6,94,0,88
"8440",1983-02-08,-26,144,0,170
"8441",1983-02-09,-51,77,0,128
"8442",1983-02-10,-53,77,0,130
"8443",1983-02-11,-68,113,0,181
"8444",1983-02-12,-36,47,0,83
"8445",1983-02-13,-74,88,0,162
"8446",1983-02-14,-14,125,0,139
"8447",1983-02-15,16,127,0,111
"8448",1983-02-16,55,150,0,95
"8449",1983-02-17,-6,93,0,99
"8450",1983-02-18,-76,55,0,131
"8451",1983-02-19,-67,57,0,124
"8452",1983-02-20,-106,-3,0,103
"8453",1983-02-21,-87,24,0,111
"8454",1983-02-22,-80,80,0,160
"8455",1983-02-23,23,70,0,47
"8456",1983-02-24,-46,100,0,146
"8457",1983-02-25,-43,117,0,160
"8458",1983-02-26,-28,95,0,123
"8459",1983-02-27,-32,114,0,146
"8460",1983-02-28,15,75,18,60
"8461",1983-03-01,2,35,73,33
"8462",1983-03-02,16,109,3,93
"8463",1983-03-03,3,126,0,123
"8464",1983-03-04,-6,87,0,93
"8465",1983-03-05,-31,143,0,174
"8466",1983-03-06,31,160,0,129
"8467",1983-03-07,-24,135,0,159
"8468",1983-03-08,6,98,0,92
"8469",1983-03-09,29,137,0,108
"8470",1983-03-10,29,181,0,152
"8471",1983-03-11,39,174,0,135
"8472",1983-03-12,28,118,0,90
"8473",1983-03-13,-36,110,0,146
"8474",1983-03-14,16,152,0,136
"8475",1983-03-15,9,192,0,183
"8476",1983-03-16,61,156,0,95
"8477",1983-03-17,-36,147,0,183
"8478",1983-03-18,-7,167,0,174
"8479",1983-03-19,66,190,0,124
"8480",1983-03-20,49,181,0,132
"8481",1983-03-21,56,159,0,103
"8482",1983-03-22,59,136,152,77
"8483",1983-03-23,42,91,52,49
"8484",1983-03-24,42,127,0,85
"8485",1983-03-25,14,141,0,127
"8486",1983-03-26,5,135,0,130
"8487",1983-03-27,2,155,0,153
"8488",1983-03-28,15,161,0,146
"8489",1983-03-29,41,166,0,125
"8490",1983-03-30,54,169,0,115
"8491",1983-03-31,51,210,0,159
"8492",1983-04-01,95,230,0,135
"8493",1983-04-02,35,206,0,171
"8494",1983-04-03,109,193,0,84
"8495",1983-04-04,78,255,0,177
"8496",1983-04-05,131,287,0,156
"8497",1983-04-06,160,288,0,128
"8498",1983-04-07,122,216,0,94
"8499",1983-04-08,108,255,0,147
"8500",1983-04-09,136,210,0,74
"8501",1983-04-10,110,195,1,85
"8502",1983-04-11,122,205,28,83
"8503",1983-04-12,100,188,0,88
"8504",1983-04-13,108,162,5,54
"8505",1983-04-14,75,229,1,154
"8506",1983-04-15,80,165,111,85
"8507",1983-04-16,54,211,0,157
"8508",1983-04-17,79,201,0,122
"8509",1983-04-18,115,203,0,88
"8510",1983-04-19,109,221,0,112
"8511",1983-04-20,101,171,0,70
"8512",1983-04-21,51,209,0,158
"8513",1983-04-22,118,277,0,159
"8514",1983-04-23,112,290,0,178
"8515",1983-04-24,133,292,0,159
"8516",1983-04-25,154,244,407,90
"8517",1983-04-26,142,264,110,122
"8518",1983-04-27,145,235,0,90
"8519",1983-04-28,99,197,31,98
"8520",1983-04-29,74,176,0,102
"8521",1983-04-30,101,183,0,82
"8522",1983-05-01,71,250,0,179
"8523",1983-05-02,147,240,0,93
"8524",1983-05-03,147,208,0,61
"8525",1983-05-04,149,185,13,36
"8526",1983-05-05,153,216,25,63
"8527",1983-05-06,122,288,0,166
"8528",1983-05-07,178,292,0,114
"8529",1983-05-08,156,316,0,160
"8530",1983-05-09,170,309,0,139
"8531",1983-05-10,182,310,0,128
"8532",1983-05-11,206,303,0,97
"8533",1983-05-12,194,279,0,85
"8534",1983-05-13,176,245,0,69
"8535",1983-05-14,103,202,287,99
"8536",1983-05-15,104,215,33,111
"8537",1983-05-16,100,282,0,182
"8538",1983-05-17,110,271,0,161
"8539",1983-05-18,168,292,0,124
"8540",1983-05-19,128,290,0,162
"8541",1983-05-20,166,328,0,162
"8542",1983-05-21,204,270,0,66
"8543",1983-05-22,158,225,906,67
"8544",1983-05-23,157,193,227,36
"8545",1983-05-24,181,208,115,27
"8546",1983-05-25,176,257,1,81
"8547",1983-05-26,171,239,28,68
"8548",1983-05-27,170,322,6,152
"8549",1983-05-28,141,331,0,190
"8550",1983-05-29,156,338,0,182
"8551",1983-05-30,185,343,0,158
"8552",1983-05-31,208,345,0,137
"8553",1983-06-01,210,300,69,90
"8554",1983-06-02,194,295,17,101
"8555",1983-06-03,175,317,0,142
"8556",1983-06-04,203,343,0,140
"8557",1983-06-05,202,263,0,61
"8558",1983-06-06,182,310,0,128
"8559",1983-06-07,183,332,0,149
"8560",1983-06-08,178,312,0,134
"8561",1983-06-09,152,300,0,148
"8562",1983-06-10,153,336,0,183
"8563",1983-06-11,181,296,416,115
"8564",1983-06-12,170,302,0,132
"8565",1983-06-13,158,321,0,163
"8566",1983-06-14,194,295,0,101
"8567",1983-06-15,167,317,0,150
"8568",1983-06-16,192,314,0,122
"8569",1983-06-17,201,321,0,120
"8570",1983-06-18,203,309,0,106
"8571",1983-06-19,217,278,0,61
"8572",1983-06-20,205,307,0,102
"8573",1983-06-21,220,277,24,57
"8574",1983-06-22,201,251,97,50
"8575",1983-06-23,193,290,7,97
"8576",1983-06-24,212,262,252,50
"8577",1983-06-25,207,259,3,52
"8578",1983-06-26,213,314,2,101
"8579",1983-06-27,208,348,0,140
"8580",1983-06-28,221,342,0,121
"8581",1983-06-29,233,339,0,106
"8582",1983-06-30,205,294,0,89
"8583",1983-07-01,212,256,367,44
"8584",1983-07-02,191,304,10,113
"8585",1983-07-03,182,315,0,133
"8586",1983-07-04,214,312,0,98
"8587",1983-07-05,202,326,0,124
"8588",1983-07-06,200,330,0,130
"8589",1983-07-07,236,335,0,99
"8590",1983-07-08,231,335,0,104
"8591",1983-07-09,232,281,1,49
"8592",1983-07-10,215,254,1,39
"8593",1983-07-11,229,299,0,70
"8594",1983-07-12,226,295,0,69
"8595",1983-07-13,234,300,1,66
"8596",1983-07-14,224,326,0,102
"8597",1983-07-15,225,329,0,104
"8598",1983-07-16,175,354,0,179
"8599",1983-07-17,210,328,0,118
"8600",1983-07-18,183,286,78,103
"8601",1983-07-19,208,231,76,23
"8602",1983-07-20,216,260,29,44
"8603",1983-07-21,205,266,3,61
"8604",1983-07-22,184,335,2,151
"8605",1983-07-23,229,289,0,60
"8606",1983-07-24,211,310,0,99
"8607",1983-07-25,204,328,0,124
"8608",1983-07-26,233,347,0,114
"8609",1983-07-27,254,350,0,96
"8610",1983-07-28,265,343,0,78
"8611",1983-07-29,245,325,354,80
"8612",1983-07-30,227,322,335,95
"8613",1983-07-31,208,246,144,38
"8614",1983-08-01,206,310,94,104
"8615",1983-08-02,242,336,0,94
"8616",1983-08-03,264,335,0,71
"8617",1983-08-04,250,344,0,94
"8618",1983-08-05,252,350,0,98
"8619",1983-08-06,260,326,0,66
"8620",1983-08-07,236,277,57,41
"8621",1983-08-08,230,288,1,58
"8622",1983-08-09,228,305,0,77
"8623",1983-08-10,224,269,1732,45
"8624",1983-08-11,236,269,11,33
"8625",1983-08-12,223,292,107,69
"8626",1983-08-13,212,299,2,87
"8627",1983-08-14,216,316,0,100
"8628",1983-08-15,223,325,0,102
"8629",1983-08-16,242,272,0,30
"8630",1983-08-17,223,261,0,38
"8631",1983-08-18,184,270,0,86
"8632",1983-08-19,205,266,2,61
"8633",1983-08-20,173,303,0,130
"8634",1983-08-21,184,298,0,114
"8635",1983-08-22,193,246,52,53
"8636",1983-08-23,186,271,1,85
"8637",1983-08-24,174,296,0,122
"8638",1983-08-25,180,303,3,123
"8639",1983-08-26,180,277,0,97
"8640",1983-08-27,181,307,0,126
"8641",1983-08-28,205,333,0,128
"8642",1983-08-29,183,358,0,175
"8643",1983-08-30,195,359,0,164
"8644",1983-08-31,223,303,0,80
"8645",1983-09-01,217,298,105,81
"8646",1983-09-02,195,327,0,132
"8647",1983-09-03,193,326,0,133
"8648",1983-09-04,189,324,0,135
"8649",1983-09-05,198,306,46,108
"8650",1983-09-06,200,281,0,81
"8651",1983-09-07,215,251,278,36
"8652",1983-09-08,190,265,1123,75
"8653",1983-09-09,192,230,9,38
"8654",1983-09-10,184,262,28,78
"8655",1983-09-11,160,301,0,141
"8656",1983-09-12,178,270,0,92
"8657",1983-09-13,202,292,0,90
"8658",1983-09-14,154,309,0,155
"8659",1983-09-15,196,283,0,87
"8660",1983-09-16,183,290,0,107
"8661",1983-09-17,198,279,0,81
"8662",1983-09-18,194,309,0,115
"8663",1983-09-19,195,256,0,61
"8664",1983-09-20,190,245,2,55
"8665",1983-09-21,169,218,47,49
"8666",1983-09-22,169,186,233,17
"8667",1983-09-23,171,237,139,66
"8668",1983-09-24,162,301,0,139
"8669",1983-09-25,190,277,1,87
"8670",1983-09-26,192,261,1,69
"8671",1983-09-27,177,227,0,50
"8672",1983-09-28,149,237,2,88
"8673",1983-09-29,124,269,0,145
"8674",1983-09-30,155,291,0,136
"8675",1983-10-01,172,301,0,129
"8676",1983-10-02,175,281,0,106
"8677",1983-10-03,188,234,21,46
"8678",1983-10-04,175,218,62,43
"8679",1983-10-05,177,203,31,26
"8680",1983-10-06,142,191,25,49
"8681",1983-10-07,134,191,2,57
"8682",1983-10-08,108,212,0,104
"8683",1983-10-09,155,226,0,71
"8684",1983-10-10,127,254,0,127
"8685",1983-10-11,127,191,0,64
"8686",1983-10-12,102,134,70,32
"8687",1983-10-13,104,174,33,70
"8688",1983-10-14,132,157,2,25
"8689",1983-10-15,126,209,2,83
"8690",1983-10-16,133,167,26,34
"8691",1983-10-17,94,142,279,48
"8692",1983-10-18,74,97,205,23
"8693",1983-10-19,88,118,15,30
"8694",1983-10-20,110,173,0,63
"8695",1983-10-21,73,207,0,134
"8696",1983-10-22,100,176,0,76
"8697",1983-10-23,104,165,0,61
"8698",1983-10-24,65,155,0,90
"8699",1983-10-25,99,125,83,26
"8700",1983-10-26,83,168,0,85
"8701",1983-10-27,33,184,0,151
"8702",1983-10-28,90,209,0,119
"8703",1983-10-29,71,210,0,139
"8704",1983-10-30,71,213,0,142
"8705",1983-10-31,72,227,0,155
"8706",1983-11-01,60,222,0,162
"8707",1983-11-02,70,213,0,143
"8708",1983-11-03,74,174,0,100
"8709",1983-11-04,44,201,0,157
"8710",1983-11-05,60,201,0,141
"8711",1983-11-06,65,169,0,104
"8712",1983-11-07,99,156,0,57
"8713",1983-11-08,113,137,28,24
"8714",1983-11-09,101,139,2,38
"8715",1983-11-10,74,149,0,75
"8716",1983-11-11,27,146,0,119
"8717",1983-11-12,7,149,0,142
"8718",1983-11-13,-3,134,0,137
"8719",1983-11-14,-4,182,0,186
"8720",1983-11-15,52,184,0,132
"8721",1983-11-16,7,126,0,119
"8722",1983-11-17,-28,135,0,163
"8723",1983-11-18,-21,156,0,177
"8724",1983-11-19,4,154,0,150
"8725",1983-11-20,1,151,0,150
"8726",1983-11-21,59,147,10,88
"8727",1983-11-22,46,131,3,85
"8728",1983-11-23,1,162,0,161
"8729",1983-11-24,19,126,0,107
"8730",1983-11-25,-11,143,0,154
"8731",1983-11-26,-31,145,0,176
"8732",1983-11-27,-26,147,0,173
"8733",1983-11-28,-1,147,0,148
"8734",1983-11-29,29,143,0,114
"8735",1983-11-30,12,109,0,97
"8736",1983-12-01,-38,144,0,182
"8737",1983-12-02,-10,160,0,170
"8738",1983-12-03,22,151,0,129
"8739",1983-12-04,-18,146,0,164
"8740",1983-12-05,28,168,0,140
"8741",1983-12-06,-11,126,0,137
"8742",1983-12-07,-18,136,0,154
"8743",1983-12-08,-11,160,0,171
"8744",1983-12-09,-8,174,0,182
"8745",1983-12-10,33,126,0,93
"8746",1983-12-11,-10,115,0,125
"8747",1983-12-12,-12,147,0,159
"8748",1983-12-13,-22,134,0,156
"8749",1983-12-14,-6,59,0,65
"8750",1983-12-15,-12,83,0,95
"8751",1983-12-16,-41,76,0,117
"8752",1983-12-17,-44,84,0,128
"8753",1983-12-18,-57,76,0,133
"8754",1983-12-19,21,89,0,68
"8755",1983-12-20,-47,69,0,116
"8756",1983-12-21,-1,79,0,80
"8757",1983-12-22,-42,68,0,110
"8758",1983-12-23,-76,65,0,141
"8759",1983-12-24,-55,28,0,83
"8760",1983-12-25,-68,82,0,150
"8761",1983-12-26,-41,68,0,109
"8762",1983-12-27,-62,67,0,129
"8763",1983-12-28,-73,10,0,83
"8764",1983-12-29,-48,18,0,66
"8765",1983-12-30,-75,0,0,75
"8766",1983-12-31,-82,54,0,136
"8767",1984-01-01,-50,92,0,142
"8768",1984-01-02,-55,50,0,105
"8769",1984-01-03,-49,50,0,99
"8770",1984-01-04,-70,47,0,117
"8771",1984-01-05,-52,38,0,90
"8772",1984-01-06,-73,70,0,143
"8773",1984-01-07,-25,99,0,124
"8774",1984-01-08,13,105,0,92
"8775",1984-01-09,6,149,0,143
"8776",1984-01-10,12,122,0,110
"8777",1984-01-11,-49,116,0,165
"8778",1984-01-12,-6,74,0,80
"8779",1984-01-13,-42,147,0,189
"8780",1984-01-14,-14,66,0,80
"8781",1984-01-15,-29,27,0,56
"8782",1984-01-16,-65,15,0,80
"8783",1984-01-17,-44,14,0,58
"8784",1984-01-18,-24,2,0,26
"8785",1984-01-19,-54,17,0,71
"8786",1984-01-20,-71,36,0,107
"8787",1984-01-21,-52,36,0,88
"8788",1984-01-22,-99,40,0,139
"8789",1984-01-23,-51,35,0,86
"8790",1984-01-24,-73,31,0,104
"8791",1984-01-25,-88,44,0,132
"8792",1984-01-26,-75,5,0,80
"8793",1984-01-27,-61,1,0,62
"8794",1984-01-28,-49,-15,0,34
"8795",1984-01-29,-62,-27,0,35
"8796",1984-01-30,-83,11,0,94
"8797",1984-01-31,-78,71,0,149
"8798",1984-02-01,-64,17,0,81
"8799",1984-02-02,-97,5,0,102
"8800",1984-02-03,-91,19,0,110
"8801",1984-02-04,-36,41,0,77
"8802",1984-02-05,-30,6,0,36
"8803",1984-02-06,-92,32,0,124
"8804",1984-02-07,-73,41,0,114
"8805",1984-02-08,-103,44,0,147
"8806",1984-02-09,-36,25,0,61
"8807",1984-02-10,-60,-3,25,57
"8808",1984-02-11,-31,22,0,53
"8809",1984-02-12,-57,57,0,114
"8810",1984-02-13,-50,50,0,100
"8811",1984-02-14,-43,85,0,128
"8812",1984-02-15,-36,32,0,68
"8813",1984-02-16,-15,1,1,16
"8814",1984-02-17,-28,51,0,79
"8815",1984-02-18,-63,72,0,135
"8816",1984-02-19,0,67,0,67
"8817",1984-02-20,12,65,0,53
"8818",1984-02-21,18,45,0,27
"8819",1984-02-22,1,46,0,45
"8820",1984-02-23,-20,82,0,102
"8821",1984-02-24,-32,60,0,92
"8822",1984-02-25,-15,90,0,105
"8823",1984-02-26,-9,107,0,116
"8824",1984-02-27,-24,78,0,102
"8825",1984-02-28,-12,67,0,79
"8826",1984-02-29,-48,108,0,156
"8827",1984-03-01,30,136,0,106
"8828",1984-03-02,-12,142,0,154
"8829",1984-03-03,-51,125,0,176
"8830",1984-03-04,-29,165,0,194
"8831",1984-03-05,14,107,0,93
"8832",1984-03-06,-27,60,0,87
"8833",1984-03-07,-18,111,0,129
"8834",1984-03-08,16,92,0,76
"8835",1984-03-09,-5,78,0,83
"8836",1984-03-10,-19,103,0,122
"8837",1984-03-11,21,205,0,184
"8838",1984-03-12,64,130,0,66
"8839",1984-03-13,0,76,67,76
"8840",1984-03-14,2,50,6,48
"8841",1984-03-15,14,183,0,169
"8842",1984-03-16,64,131,0,67
"8843",1984-03-17,33,165,0,132
"8844",1984-03-18,62,123,0,61
"8845",1984-03-19,-6,130,0,136
"8846",1984-03-20,16,172,0,156
"8847",1984-03-21,-6,75,0,81
"8848",1984-03-22,-8,158,0,166
"8849",1984-03-23,59,157,0,98
"8850",1984-03-24,3,136,0,133
"8851",1984-03-25,31,155,0,124
"8852",1984-03-26,35,182,0,147
"8853",1984-03-27,70,149,0,79
"8854",1984-03-28,41,239,0,198
"8855",1984-03-29,113,292,0,179
"8856",1984-03-30,89,215,0,126
"8857",1984-03-31,50,126,0,76
"8858",1984-04-01,13,181,0,168
"8859",1984-04-02,107,160,1,53
"8860",1984-04-03,62,162,3,100
"8861",1984-04-04,104,137,139,33
"8862",1984-04-05,60,140,0,80
"8863",1984-04-06,60,103,0,43
"8864",1984-04-07,47,175,0,128
"8865",1984-04-08,75,151,0,76
"8866",1984-04-09,29,180,0,151
"8867",1984-04-10,68,190,0,122
"8868",1984-04-11,89,173,0,84
"8869",1984-04-12,101,193,0,92
"8870",1984-04-13,94,231,0,137
"8871",1984-04-14,126,296,0,170
"8872",1984-04-15,139,298,0,159
"8873",1984-04-16,134,244,0,110
"8874",1984-04-17,119,206,0,87
"8875",1984-04-18,120,208,0,88
"8876",1984-04-19,88,210,0,122
"8877",1984-04-20,110,217,8,107
"8878",1984-04-21,121,232,0,111
"8879",1984-04-22,92,264,0,172
"8880",1984-04-23,133,248,0,115
"8881",1984-04-24,157,220,4,63
"8882",1984-04-25,137,245,0,108
"8883",1984-04-26,148,242,0,94
"8884",1984-04-27,99,163,0,64
"8885",1984-04-28,53,217,0,164
"8886",1984-04-29,114,234,0,120
"8887",1984-04-30,136,263,0,127
"8888",1984-05-01,126,209,0,83
"8889",1984-05-02,120,165,1,45
"8890",1984-05-03,105,135,124,30
"8891",1984-05-04,105,180,0,75
"8892",1984-05-05,102,219,0,117
"8893",1984-05-06,124,280,0,156
"8894",1984-05-07,131,339,0,208
"8895",1984-05-08,155,332,0,177
"8896",1984-05-09,173,293,0,120
"8897",1984-05-10,181,333,0,152
"8898",1984-05-11,146,283,26,137
"8899",1984-05-12,138,212,193,74
"8900",1984-05-13,106,263,0,157
"8901",1984-05-14,114,242,0,128
"8902",1984-05-15,152,209,11,57
"8903",1984-05-16,95,244,0,149
"8904",1984-05-17,143,256,0,113
"8905",1984-05-18,143,281,0,138
"8906",1984-05-19,128,290,0,162
"8907",1984-05-20,172,275,0,103
"8908",1984-05-21,158,280,0,122
"8909",1984-05-22,152,245,0,93
"8910",1984-05-23,129,245,0,116
"8911",1984-05-24,139,212,73,73
"8912",1984-05-25,144,248,1,104
"8913",1984-05-26,155,274,0,119
"8914",1984-05-27,162,310,11,148
"8915",1984-05-28,143,325,8,182
"8916",1984-05-29,187,278,20,91
"8917",1984-05-30,146,296,1,150
"8918",1984-05-31,198,305,0,107
"8919",1984-06-01,190,330,0,140
"8920",1984-06-02,194,339,0,145
"8921",1984-06-03,235,383,0,148
"8922",1984-06-04,197,335,0,138
"8923",1984-06-05,215,298,2,83
"8924",1984-06-06,173,232,66,59
"8925",1984-06-07,117,320,0,203
"8926",1984-06-08,207,296,0,89
"8927",1984-06-09,198,367,0,169
"8928",1984-06-10,159,374,0,215
"8929",1984-06-11,215,362,0,147
"8930",1984-06-12,215,320,0,105
"8931",1984-06-13,207,242,166,35
"8932",1984-06-14,201,228,13,27
"8933",1984-06-15,197,301,1,104
"8934",1984-06-16,183,347,0,164
"8935",1984-06-17,213,330,0,117
"8936",1984-06-18,233,353,0,120
"8937",1984-06-19,197,352,0,155
"8938",1984-06-20,230,314,0,84
"8939",1984-06-21,203,232,8,29
"8940",1984-06-22,182,223,193,41
"8941",1984-06-23,200,234,110,34
"8942",1984-06-24,205,300,0,95
"8943",1984-06-25,234,277,8,43
"8944",1984-06-26,213,295,1,82
"8945",1984-06-27,197,261,62,64
"8946",1984-06-28,180,285,15,105
"8947",1984-06-29,206,326,0,120
"8948",1984-06-30,221,339,0,118
"8949",1984-07-01,255,361,0,106
"8950",1984-07-02,225,330,68,105
"8951",1984-07-03,210,296,0,86
"8952",1984-07-04,186,306,0,120
"8953",1984-07-05,202,275,39,73
"8954",1984-07-06,172,215,357,43
"8955",1984-07-07,180,259,369,79
"8956",1984-07-08,206,288,0,82
"8957",1984-07-09,205,277,6,72
"8958",1984-07-10,231,257,162,26
"8959",1984-07-11,213,302,324,89
"8960",1984-07-12,242,330,76,88
"8961",1984-07-13,251,335,0,84
"8962",1984-07-14,252,303,0,51
"8963",1984-07-15,200,341,0,141
"8964",1984-07-16,213,329,0,116
"8965",1984-07-17,228,282,180,54
"8966",1984-07-18,195,237,256,42
"8967",1984-07-19,188,245,18,57
"8968",1984-07-20,207,274,2,67
"8969",1984-07-21,184,295,0,111
"8970",1984-07-22,205,310,0,105
"8971",1984-07-23,201,305,0,104
"8972",1984-07-24,200,269,309,69
"8973",1984-07-25,208,237,237,29
"8974",1984-07-26,215,266,36,51
"8975",1984-07-27,188,317,0,129
"8976",1984-07-28,219,316,0,97
"8977",1984-07-29,237,320,0,83
"8978",1984-07-30,230,324,0,94
"8979",1984-07-31,235,319,0,84
"8980",1984-08-01,232,324,0,92
"8981",1984-08-02,241,325,0,84
"8982",1984-08-03,235,336,0,101
"8983",1984-08-04,257,331,0,74
"8984",1984-08-05,238,353,0,115
"8985",1984-08-06,260,347,0,87
"8986",1984-08-07,246,311,14,65
"8987",1984-08-08,240,316,3,76
"8988",1984-08-09,228,283,1199,55
"8989",1984-08-10,227,328,10,101
"8990",1984-08-11,243,345,80,102
"8991",1984-08-12,240,315,150,75
"8992",1984-08-13,231,303,3,72
"8993",1984-08-14,202,274,71,72
"8994",1984-08-15,149,281,0,132
"8995",1984-08-16,161,275,0,114
"8996",1984-08-17,161,265,0,104
"8997",1984-08-18,173,258,0,85
"8998",1984-08-19,203,254,1,51
"8999",1984-08-20,221,270,0,49
"9000",1984-08-21,193,305,0,112
"9001",1984-08-22,213,311,0,98
"9002",1984-08-23,220,307,0,87
"9003",1984-08-24,220,320,0,100
"9004",1984-08-25,206,295,303,89
"9005",1984-08-26,221,294,0,73
"9006",1984-08-27,223,306,0,83
"9007",1984-08-28,210,273,0,63
"9008",1984-08-29,216,256,7,40
"9009",1984-08-30,212,289,0,77
"9010",1984-08-31,226,293,0,67
"9011",1984-09-01,207,264,0,57
"9012",1984-09-02,156,274,0,118
"9013",1984-09-03,157,292,0,135
"9014",1984-09-04,167,270,0,103
"9015",1984-09-05,200,242,0,42
"9016",1984-09-06,185,236,93,51
"9017",1984-09-07,200,218,58,18
"9018",1984-09-08,200,220,293,20
"9019",1984-09-09,165,211,97,46
"9020",1984-09-10,159,261,6,102
"9021",1984-09-11,170,268,0,98
"9022",1984-09-12,146,280,0,134
"9023",1984-09-13,144,283,5,139
"9024",1984-09-14,141,274,0,133
"9025",1984-09-15,149,285,0,136
"9026",1984-09-16,177,270,189,93
"9027",1984-09-17,168,245,4,77
"9028",1984-09-18,166,247,0,81
"9029",1984-09-19,160,239,0,79
"9030",1984-09-20,139,238,0,99
"9031",1984-09-21,155,266,0,111
"9032",1984-09-22,174,217,90,43
"9033",1984-09-23,176,198,382,22
"9034",1984-09-24,167,193,294,26
"9035",1984-09-25,157,200,28,43
"9036",1984-09-26,131,176,178,45
"9037",1984-09-27,113,136,326,23
"9038",1984-09-28,110,214,19,104
"9039",1984-09-29,86,252,0,166
"9040",1984-09-30,144,187,104,43
"9041",1984-10-01,148,166,94,18
"9042",1984-10-02,153,202,48,49
"9043",1984-10-03,133,178,0,45
"9044",1984-10-04,87,221,0,134
"9045",1984-10-05,98,230,0,132
"9046",1984-10-06,72,223,0,151
"9047",1984-10-07,91,221,0,130
"9048",1984-10-08,103,234,0,131
"9049",1984-10-09,120,230,0,110
"9050",1984-10-10,122,227,0,105
"9051",1984-10-11,133,189,37,56
"9052",1984-10-12,132,190,52,58
"9053",1984-10-13,66,220,0,154
"9054",1984-10-14,102,225,0,123
"9055",1984-10-15,88,212,0,124
"9056",1984-10-16,151,215,0,64
"9057",1984-10-17,123,257,0,134
"9058",1984-10-18,92,268,0,176
"9059",1984-10-19,115,230,0,115
"9060",1984-10-20,35,233,0,198
"9061",1984-10-21,43,270,0,227
"9062",1984-10-22,83,275,0,192
"9063",1984-10-23,77,233,0,156
"9064",1984-10-24,84,271,0,187
"9065",1984-10-25,84,270,0,186
"9066",1984-10-26,105,228,0,123
"9067",1984-10-27,77,225,0,148
"9068",1984-10-28,59,157,0,98
"9069",1984-10-29,72,123,0,51
"9070",1984-10-30,19,172,0,153
"9071",1984-10-31,78,184,0,106
"9072",1984-11-01,89,190,0,101
"9073",1984-11-02,64,213,0,149
"9074",1984-11-03,27,242,0,215
"9075",1984-11-04,63,251,0,188
"9076",1984-11-05,109,237,0,128
"9077",1984-11-06,107,202,0,95
"9078",1984-11-07,84,205,0,121
"9079",1984-11-08,65,207,0,142
"9080",1984-11-09,85,146,92,61
"9081",1984-11-10,76,141,38,65
"9082",1984-11-11,74,162,0,88
"9083",1984-11-12,79,126,58,47
"9084",1984-11-13,69,90,122,21
"9085",1984-11-14,79,124,53,45
"9086",1984-11-15,24,148,0,124
"9087",1984-11-16,94,160,0,66
"9088",1984-11-17,72,135,14,63
"9089",1984-11-18,22,74,5,52
"9090",1984-11-19,-20,45,0,65
"9091",1984-11-20,-31,48,0,79
"9092",1984-11-21,20,78,0,58
"9093",1984-11-22,34,104,0,70
"9094",1984-11-23,59,116,0,57
"9095",1984-11-24,15,85,0,70
"9096",1984-11-25,16,73,0,57
"9097",1984-11-26,50,100,36,50
"9098",1984-11-27,-12,71,0,83
"9099",1984-11-28,-29,105,0,134
"9100",1984-11-29,-24,153,0,177
"9101",1984-11-30,68,152,0,84
"9102",1984-12-01,-9,144,0,153
"9103",1984-12-02,22,145,0,123
"9104",1984-12-03,-10,102,0,112
"9105",1984-12-04,-2,72,0,74
"9106",1984-12-05,-52,61,0,113
"9107",1984-12-06,-51,58,0,109
"9108",1984-12-07,18,48,48,30
"9109",1984-12-08,13,41,19,28
"9110",1984-12-09,-2,50,58,52
"9111",1984-12-10,7,65,0,58
"9112",1984-12-11,-5,103,0,108
"9113",1984-12-12,9,50,0,41
"9114",1984-12-13,0,45,10,45
"9115",1984-12-14,-5,31,8,36
"9116",1984-12-15,-34,-3,136,31
"9117",1984-12-16,-45,-20,32,25
"9118",1984-12-17,-91,7,0,98
"9119",1984-12-18,-73,-22,0,51
"9120",1984-12-19,-51,14,0,65
"9121",1984-12-20,-73,6,0,79
"9122",1984-12-21,-72,3,0,75
"9123",1984-12-22,-102,-14,0,88
"9124",1984-12-23,-67,-27,0,40
"9125",1984-12-24,-70,-10,0,60
"9126",1984-12-25,-102,7,0,109
"9127",1984-12-26,-68,-3,0,65
"9128",1984-12-27,-76,17,0,93
"9129",1984-12-28,-56,17,0,73
"9130",1984-12-29,-59,38,0,97
"9131",1984-12-30,-66,67,0,133
"9132",1984-12-31,-60,33,0,93
"9133",1985-01-01,-52,34,0,86
"9134",1985-01-02,-5,11,0,16
"9135",1985-01-03,-8,27,0,35
"9136",1985-01-04,-46,3,0,49
"9137",1985-01-05,-52,32,0,84
"9138",1985-01-06,-58,10,0,68
"9139",1985-01-07,-32,7,0,39
"9140",1985-01-08,-72,63,0,135
"9141",1985-01-09,-23,52,0,75
"9142",1985-01-10,-68,92,0,160
"9143",1985-01-11,-30,48,0,78
"9144",1985-01-12,-52,28,0,80
"9145",1985-01-13,-69,28,0,97
"9146",1985-01-14,-83,78,0,161
"9147",1985-01-15,-76,106,0,182
"9148",1985-01-16,-68,43,0,111
"9149",1985-01-17,-46,13,0,59
"9150",1985-01-18,-50,32,0,82
"9151",1985-01-19,-63,84,0,147
"9152",1985-01-20,-68,54,0,122
"9153",1985-01-21,5,37,0,32
"9154",1985-01-22,8,54,3,46
"9155",1985-01-23,-37,16,40,53
"9156",1985-01-24,-114,2,3,116
"9157",1985-01-25,-63,22,0,85
"9158",1985-01-26,-5,12,2,17
"9159",1985-01-27,-24,10,0,34
"9160",1985-01-28,-53,53,0,106
"9161",1985-01-29,-34,27,0,61
"9162",1985-01-30,-63,43,0,106
"9163",1985-01-31,-43,108,0,151
"9164",1985-02-01,26,130,0,104
"9165",1985-02-02,-5,158,0,163
"9166",1985-02-03,-25,132,0,157
"9167",1985-02-04,30,134,0,104
"9168",1985-02-05,37,103,0,66
"9169",1985-02-06,41,72,1,31
"9170",1985-02-07,33,72,0,39
"9171",1985-02-08,32,70,2,38
"9172",1985-02-09,-15,140,0,155
"9173",1985-02-10,-27,117,0,144
"9174",1985-02-11,24,122,0,98
"9175",1985-02-12,-19,103,0,122
"9176",1985-02-13,-9,64,0,73
"9177",1985-02-14,12,69,0,57
"9178",1985-02-15,-13,124,0,137
"9179",1985-02-16,-27,62,0,89
"9180",1985-02-17,-71,-15,39,56
"9181",1985-02-18,-102,-46,2,56
"9182",1985-02-19,-78,-25,20,53
"9183",1985-02-20,-90,24,0,114
"9184",1985-02-21,-51,16,0,67
"9185",1985-02-22,-41,33,0,74
"9186",1985-02-23,-39,2,0,41
"9187",1985-02-24,-32,-9,0,23
"9188",1985-02-25,-46,30,0,76
"9189",1985-02-26,-24,27,0,51
"9190",1985-02-27,-5,34,1,39
"9191",1985-02-28,10,40,0,30
"9192",1985-03-01,10,45,0,35
"9193",1985-03-02,15,61,0,46
"9194",1985-03-03,-10,116,0,126
"9195",1985-03-04,18,92,0,74
"9196",1985-03-05,-13,60,0,73
"9197",1985-03-06,-29,-2,3,27
"9198",1985-03-07,-32,13,41,45
"9199",1985-03-08,4,98,31,94
"9200",1985-03-09,-14,56,0,70
"9201",1985-03-10,-4,27,22,31
"9202",1985-03-11,-24,113,0,137
"9203",1985-03-12,-11,117,0,128
"9204",1985-03-13,19,82,0,63
"9205",1985-03-14,-42,85,0,127
"9206",1985-03-15,-37,98,0,135
"9207",1985-03-16,10,132,0,122
"9208",1985-03-17,-9,125,0,134
"9209",1985-03-18,44,132,0,88
"9210",1985-03-19,15,144,0,129
"9211",1985-03-20,44,105,0,61
"9212",1985-03-21,10,128,0,118
"9213",1985-03-22,66,166,0,100
"9214",1985-03-23,71,195,0,124
"9215",1985-03-24,71,148,3,77
"9216",1985-03-25,53,127,14,74
"9217",1985-03-26,36,93,44,57
"9218",1985-03-27,35,172,0,137
"9219",1985-03-28,64,114,0,50
"9220",1985-03-29,-11,151,0,162
"9221",1985-03-30,5,167,0,162
"9222",1985-03-31,-3,187,0,190
"9223",1985-04-01,67,191,0,124
"9224",1985-04-02,78,201,0,123
"9225",1985-04-03,71,134,12,63
"9226",1985-04-04,26,139,0,113
"9227",1985-04-05,71,165,4,94
"9228",1985-04-06,66,218,14,152
"9229",1985-04-07,60,288,0,228
"9230",1985-04-08,113,259,0,146
"9231",1985-04-09,89,199,0,110
"9232",1985-04-10,102,163,0,61
"9233",1985-04-11,59,180,0,121
"9234",1985-04-12,18,160,0,142
"9235",1985-04-13,83,161,5,78
"9236",1985-04-14,47,213,0,166
"9237",1985-04-15,75,265,0,190
"9238",1985-04-16,75,262,0,187
"9239",1985-04-17,71,221,0,150
"9240",1985-04-18,84,331,0,247
"9241",1985-04-19,106,227,0,121
"9242",1985-04-20,84,254,0,170
"9243",1985-04-21,177,290,0,113
"9244",1985-04-22,125,248,0,123
"9245",1985-04-23,121,236,0,115
"9246",1985-04-24,109,240,9,131
"9247",1985-04-25,146,194,36,48
"9248",1985-04-26,110,226,0,116
"9249",1985-04-27,55,241,0,186
"9250",1985-04-28,127,262,0,135
"9251",1985-04-29,163,322,0,159
"9252",1985-04-30,176,290,0,114
"9253",1985-05-01,162,307,0,145
"9254",1985-05-02,203,275,29,72
"9255",1985-05-03,170,226,684,56
"9256",1985-05-04,156,200,82,44
"9257",1985-05-05,146,189,256,43
"9258",1985-05-06,130,212,0,82
"9259",1985-05-07,126,262,0,136
"9260",1985-05-08,152,281,0,129
"9261",1985-05-09,155,272,0,117
"9262",1985-05-10,187,248,0,61
"9263",1985-05-11,195,239,3,44
"9264",1985-05-12,188,227,869,39
"9265",1985-05-13,160,212,0,52
"9266",1985-05-14,139,172,0,33
"9267",1985-05-15,135,222,0,87
"9268",1985-05-16,129,232,0,103
"9269",1985-05-17,147,203,22,56
"9270",1985-05-18,127,232,3,105
"9271",1985-05-19,156,274,0,118
"9272",1985-05-20,117,277,0,160
"9273",1985-05-21,139,265,0,126
"9274",1985-05-22,146,269,0,123
"9275",1985-05-23,166,286,0,120
"9276",1985-05-24,165,322,0,157
"9277",1985-05-25,158,262,0,104
"9278",1985-05-26,137,165,44,28
"9279",1985-05-27,137,252,0,115
"9280",1985-05-28,158,272,0,114
"9281",1985-05-29,142,215,0,73
"9282",1985-05-30,142,282,0,140
"9283",1985-05-31,176,295,282,119
"9284",1985-06-01,162,305,1,143
"9285",1985-06-02,185,312,0,127
"9286",1985-06-03,195,277,0,82
"9287",1985-06-04,195,280,16,85
"9288",1985-06-05,182,247,2,65
"9289",1985-06-06,185,313,5,128
"9290",1985-06-07,172,337,0,165
"9291",1985-06-08,220,387,0,167
"9292",1985-06-09,248,336,0,88
"9293",1985-06-10,213,352,0,139
"9294",1985-06-11,222,293,21,71
"9295",1985-06-12,205,315,22,110
"9296",1985-06-13,178,348,0,170
"9297",1985-06-14,193,293,0,100
"9298",1985-06-15,213,292,0,79
"9299",1985-06-16,175,292,11,117
"9300",1985-06-17,202,326,0,124
"9301",1985-06-18,203,327,0,124
"9302",1985-06-19,216,321,0,105
"9303",1985-06-20,212,310,0,98
"9304",1985-06-21,234,322,0,88
"9305",1985-06-22,193,315,0,122
"9306",1985-06-23,230,317,0,87
"9307",1985-06-24,203,337,0,134
"9308",1985-06-25,198,342,0,144
"9309",1985-06-26,205,352,0,147
"9310",1985-06-27,220,366,0,146
"9311",1985-06-28,250,337,0,87
"9312",1985-06-29,236,313,3,77
"9313",1985-06-30,222,310,13,88
"9314",1985-07-01,225,328,0,103
"9315",1985-07-02,209,308,0,99
"9316",1985-07-03,212,350,4,138
"9317",1985-07-04,243,350,0,107
"9318",1985-07-05,212,305,0,93
"9319",1985-07-06,232,316,0,84
"9320",1985-07-07,197,335,0,138
"9321",1985-07-08,221,340,0,119
"9322",1985-07-09,258,401,0,143
"9323",1985-07-10,251,347,6,96
"9324",1985-07-11,228,303,50,75
"9325",1985-07-12,221,287,4,66
"9326",1985-07-13,221,349,0,128
"9327",1985-07-14,235,333,0,98
"9328",1985-07-15,227,329,267,102
"9329",1985-07-16,235,288,7,53
"9330",1985-07-17,235,351,0,116
"9331",1985-07-18,213,368,0,155
"9332",1985-07-19,245,354,0,109
"9333",1985-07-20,232,316,1,84
"9334",1985-07-21,220,321,0,101
"9335",1985-07-22,241,330,0,89
"9336",1985-07-23,255,353,0,98
"9337",1985-07-24,225,315,90,90
"9338",1985-07-25,223,330,20,107
"9339",1985-07-26,207,317,138,110
"9340",1985-07-27,231,332,0,101
"9341",1985-07-28,243,327,0,84
"9342",1985-07-29,241,321,0,80
"9343",1985-07-30,240,315,0,75
"9344",1985-07-31,238,332,0,94
"9345",1985-08-01,215,342,0,127
"9346",1985-08-02,219,330,16,111
"9347",1985-08-03,204,350,35,146
"9348",1985-08-04,202,347,234,145
"9349",1985-08-05,250,342,0,92
"9350",1985-08-06,272,353,0,81
"9351",1985-08-07,228,299,26,71
"9352",1985-08-08,226,320,0,94
"9353",1985-08-09,251,301,6,50
"9354",1985-08-10,225,325,0,100
"9355",1985-08-11,245,325,0,80
"9356",1985-08-12,245,318,0,73
"9357",1985-08-13,224,317,89,93
"9358",1985-08-14,201,312,14,111
"9359",1985-08-15,203,325,0,122
"9360",1985-08-16,218,318,0,100
"9361",1985-08-17,239,294,131,55
"9362",1985-08-18,236,284,30,48
"9363",1985-08-19,235,300,0,65
"9364",1985-08-20,237,292,1,55
"9365",1985-08-21,188,272,0,84
"9366",1985-08-22,217,241,445,24
"9367",1985-08-23,216,262,174,46
"9368",1985-08-24,230,297,123,67
"9369",1985-08-25,247,288,0,41
"9370",1985-08-26,223,270,6,47
"9371",1985-08-27,232,302,0,70
"9372",1985-08-28,198,247,23,49
"9373",1985-08-29,206,276,0,70
"9374",1985-08-30,192,262,86,70
"9375",1985-08-31,185,258,0,73
"9376",1985-09-01,193,242,0,49
"9377",1985-09-02,160,265,0,105
"9378",1985-09-03,155,290,0,135
"9379",1985-09-04,184,286,0,102
"9380",1985-09-05,188,273,30,85
"9381",1985-09-06,194,287,0,93
"9382",1985-09-07,205,278,0,73
"9383",1985-09-08,223,295,49,72
"9384",1985-09-09,175,228,70,53
"9385",1985-09-10,167,217,0,50
"9386",1985-09-11,178,267,0,89
"9387",1985-09-12,173,243,50,70
"9388",1985-09-13,141,199,5,58
"9389",1985-09-14,129,146,118,17
"9390",1985-09-15,132,152,543,20
"9391",1985-09-16,144,157,602,13
"9392",1985-09-17,144,204,45,60
"9393",1985-09-18,167,227,0,60
"9394",1985-09-19,163,249,1,86
"9395",1985-09-20,116,272,0,156
"9396",1985-09-21,156,212,49,56
"9397",1985-09-22,121,208,0,87
"9398",1985-09-23,154,240,0,86
"9399",1985-09-24,107,225,0,118
"9400",1985-09-25,99,204,0,105
"9401",1985-09-26,129,214,0,85
"9402",1985-09-27,131,245,0,114
"9403",1985-09-28,114,252,0,138
"9404",1985-09-29,116,248,0,132
"9405",1985-09-30,127,250,0,123
"9406",1985-10-01,63,253,0,190
"9407",1985-10-02,76,263,0,187
"9408",1985-10-03,87,297,0,210
"9409",1985-10-04,104,265,0,161
"9410",1985-10-05,89,266,0,177
"9411",1985-10-06,81,297,0,216
"9412",1985-10-07,122,271,0,149
"9413",1985-10-08,106,270,0,164
"9414",1985-10-09,160,199,12,39
"9415",1985-10-10,140,257,0,117
"9416",1985-10-11,128,227,30,99
"9417",1985-10-12,99,155,107,56
"9418",1985-10-13,86,138,81,52
"9419",1985-10-14,86,138,178,52
"9420",1985-10-15,124,151,60,27
"9421",1985-10-16,85,151,29,66
"9422",1985-10-17,80,107,24,27
"9423",1985-10-18,72,103,57,31
"9424",1985-10-19,72,104,66,32
"9425",1985-10-20,41,152,0,111
"9426",1985-10-21,60,202,0,142
"9427",1985-10-22,49,234,0,185
"9428",1985-10-23,85,232,0,147
"9429",1985-10-24,89,183,0,94
"9430",1985-10-25,104,179,0,75
"9431",1985-10-26,69,198,0,129
"9432",1985-10-27,122,161,164,39
"9433",1985-10-28,121,197,12,76
"9434",1985-10-29,109,225,0,116
"9435",1985-10-30,102,202,0,100
"9436",1985-10-31,70,156,0,86
"9437",1985-11-01,15,136,0,121
"9438",1985-11-02,64,145,0,81
"9439",1985-11-03,58,190,0,132
"9440",1985-11-04,96,158,0,62
"9441",1985-11-05,108,176,2,68
"9442",1985-11-06,50,186,0,136
"9443",1985-11-07,45,143,9,98
"9444",1985-11-08,36,99,6,63
"9445",1985-11-09,-31,125,0,156
"9446",1985-11-10,42,167,0,125
"9447",1985-11-11,8,115,0,107
"9448",1985-11-12,4,165,0,161
"9449",1985-11-13,21,145,0,124
"9450",1985-11-14,6,181,0,175
"9451",1985-11-15,60,186,0,126
"9452",1985-11-16,52,133,0,81
"9453",1985-11-17,-2,138,0,140
"9454",1985-11-18,-4,187,0,191
"9455",1985-11-19,64,172,0,108
"9456",1985-11-20,31,197,0,166
"9457",1985-11-21,86,138,0,52
"9458",1985-11-22,75,120,0,45
"9459",1985-11-23,50,111,0,61
"9460",1985-11-24,2,121,0,119
"9461",1985-11-25,-15,168,0,183
"9462",1985-11-26,15,117,0,102
"9463",1985-11-27,38,98,0,60
"9464",1985-11-28,33,84,0,51
"9465",1985-11-29,-46,115,0,161
"9466",1985-11-30,-17,95,0,112
"9467",1985-12-01,-18,102,0,120
"9468",1985-12-02,-38,135,0,173
"9469",1985-12-03,-16,130,0,146
"9470",1985-12-04,-22,84,0,106
"9471",1985-12-05,-40,43,0,83
"9472",1985-12-06,-38,23,0,61
"9473",1985-12-07,-78,-38,11,40
"9474",1985-12-08,-88,-20,0,68
"9475",1985-12-09,-103,-7,0,96
"9476",1985-12-10,-99,-5,0,94
"9477",1985-12-11,-99,45,0,144
"9478",1985-12-12,-57,93,0,150
"9479",1985-12-13,-47,103,0,150
"9480",1985-12-14,0,55,0,55
"9481",1985-12-15,-47,52,0,99
"9482",1985-12-16,-38,80,0,118
"9483",1985-12-17,-76,53,0,129
"9484",1985-12-18,-64,40,0,104
"9485",1985-12-19,-70,49,0,119
"9486",1985-12-20,-53,38,0,91
"9487",1985-12-21,-31,50,3,81
"9488",1985-12-22,-59,2,0,61
"9489",1985-12-23,-40,25,0,65
"9490",1985-12-24,-18,109,0,127
"9491",1985-12-25,-24,25,0,49
"9492",1985-12-26,-17,55,0,72
"9493",1985-12-27,-36,32,0,68
"9494",1985-12-28,1,49,0,48
"9495",1985-12-29,3,36,87,33
"9496",1985-12-30,-23,78,25,101
"9497",1985-12-31,-17,77,0,94
"9498",1986-01-01,-44,75,0,119
"9499",1986-01-02,-46,47,0,93
"9500",1986-01-03,-12,92,0,104
"9501",1986-01-04,-88,7,0,95
"9502",1986-01-05,-91,47,0,138
"9503",1986-01-06,-24,91,0,115
"9504",1986-01-07,-39,79,0,118
"9505",1986-01-08,-55,89,0,144
"9506",1986-01-09,-38,86,0,124
"9507",1986-01-10,-76,42,0,118
"9508",1986-01-11,-66,25,0,91
"9509",1986-01-12,-59,95,0,154
"9510",1986-01-13,-82,42,0,124
"9511",1986-01-14,-19,65,11,84
"9512",1986-01-15,-38,125,0,163
"9513",1986-01-16,-27,132,0,159
"9514",1986-01-17,23,64,0,41
"9515",1986-01-18,-31,77,0,108
"9516",1986-01-19,-15,107,0,122
"9517",1986-01-20,-22,47,0,69
"9518",1986-01-21,-31,0,0,31
"9519",1986-01-22,-49,64,0,113
"9520",1986-01-23,-19,94,0,113
"9521",1986-01-24,-58,78,0,136
"9522",1986-01-25,-23,100,0,123
"9523",1986-01-26,-75,105,0,180
"9524",1986-01-27,-76,90,0,166
"9525",1986-01-28,-61,92,0,153
"9526",1986-01-29,-43,120,0,163
"9527",1986-01-30,-24,64,0,88
"9528",1986-01-31,-51,33,0,84
"9529",1986-02-01,-46,92,0,138
"9530",1986-02-02,-29,31,0,60
"9531",1986-02-03,-85,46,0,131
"9532",1986-02-04,-45,44,0,89
"9533",1986-02-05,-34,56,0,90
"9534",1986-02-06,-100,50,0,150
"9535",1986-02-07,-67,66,0,133
"9536",1986-02-08,-86,84,0,170
"9537",1986-02-09,-14,77,0,91
"9538",1986-02-10,-35,82,0,117
"9539",1986-02-11,-65,112,0,177
"9540",1986-02-12,-17,56,0,73
"9541",1986-02-13,-33,160,0,193
"9542",1986-02-14,-18,82,0,100
"9543",1986-02-15,-60,67,0,127
"9544",1986-02-16,-14,35,2,49
"9545",1986-02-17,-44,70,0,114
"9546",1986-02-18,-53,115,0,168
"9547",1986-02-19,-5,90,0,95
"9548",1986-02-20,-1,82,0,83
"9549",1986-02-21,-40,116,0,156
"9550",1986-02-22,-30,130,0,160
"9551",1986-02-23,-15,140,0,155
"9552",1986-02-24,-45,101,0,146
"9553",1986-02-25,-22,117,0,139
"9554",1986-02-26,-40,55,0,95
"9555",1986-02-27,-83,45,0,128
"9556",1986-02-28,-71,45,0,116
"9557",1986-03-01,-40,77,0,117
"9558",1986-03-02,-12,128,0,140
"9559",1986-03-03,17,172,0,155
"9560",1986-03-04,22,191,0,169
"9561",1986-03-05,-5,206,0,211
"9562",1986-03-06,-15,217,0,232
"9563",1986-03-07,48,227,0,179
"9564",1986-03-08,24,133,60,109
"9565",1986-03-09,26,106,0,80
"9566",1986-03-10,6,96,0,90
"9567",1986-03-11,-3,181,0,184
"9568",1986-03-12,16,166,0,150
"9569",1986-03-13,49,136,27,87
"9570",1986-03-14,5,161,0,156
"9571",1986-03-15,34,115,0,81
"9572",1986-03-16,6,104,0,98
"9573",1986-03-17,1,74,148,73
"9574",1986-03-18,-25,122,0,147
"9575",1986-03-19,15,124,0,109
"9576",1986-03-20,65,114,0,49
"9577",1986-03-21,51,127,0,76
"9578",1986-03-22,36,146,0,110
"9579",1986-03-23,47,160,0,113
"9580",1986-03-24,30,156,0,126
"9581",1986-03-25,40,183,0,143
"9582",1986-03-26,60,176,0,116
"9583",1986-03-27,57,174,0,117
"9584",1986-03-28,84,164,0,80
"9585",1986-03-29,83,140,0,57
"9586",1986-03-30,76,181,0,105
"9587",1986-03-31,46,209,0,163
"9588",1986-04-01,75,221,0,146
"9589",1986-04-02,106,168,0,62
"9590",1986-04-03,77,220,0,143
"9591",1986-04-04,129,220,0,91
"9592",1986-04-05,107,240,0,133
"9593",1986-04-06,89,231,0,142
"9594",1986-04-07,83,235,0,152
"9595",1986-04-08,60,245,0,185
"9596",1986-04-09,82,260,0,178
"9597",1986-04-10,129,202,0,73
"9598",1986-04-11,29,198,0,169
"9599",1986-04-12,120,221,0,101
"9600",1986-04-13,85,247,0,162
"9601",1986-04-14,156,241,0,85
"9602",1986-04-15,110,197,0,87
"9603",1986-04-16,65,234,0,169
"9604",1986-04-17,140,260,0,120
"9605",1986-04-18,112,273,0,161
"9606",1986-04-19,138,278,0,140
"9607",1986-04-20,75,187,0,112
"9608",1986-04-21,87,240,10,153
"9609",1986-04-22,80,245,0,165
"9610",1986-04-23,100,302,0,202
"9611",1986-04-24,127,250,0,123
"9612",1986-04-25,125,196,0,71
"9613",1986-04-26,108,130,56,22
"9614",1986-04-27,106,177,0,71
"9615",1986-04-28,82,193,0,111
"9616",1986-04-29,121,151,13,30
"9617",1986-04-30,112,146,26,34
"9618",1986-05-01,84,212,2,128
"9619",1986-05-02,102,236,0,134
"9620",1986-05-03,88,240,0,152
"9621",1986-05-04,104,256,0,152
"9622",1986-05-05,124,269,0,145
"9623",1986-05-06,109,340,0,231
"9624",1986-05-07,136,343,0,207
"9625",1986-05-08,184,383,0,199
"9626",1986-05-09,162,261,0,99
"9627",1986-05-10,141,248,0,107
"9628",1986-05-11,118,295,0,177
"9629",1986-05-12,187,262,3,75
"9630",1986-05-13,182,333,0,151
"9631",1986-05-14,122,323,0,201
"9632",1986-05-15,132,327,0,195
"9633",1986-05-16,161,368,0,207
"9634",1986-05-17,181,349,0,168
"9635",1986-05-18,145,265,384,120
"9636",1986-05-19,145,227,121,82
"9637",1986-05-20,160,227,0,67
"9638",1986-05-21,135,285,0,150
"9639",1986-05-22,141,287,0,146
"9640",1986-05-23,165,310,0,145
"9641",1986-05-24,187,293,0,106
"9642",1986-05-25,125,214,126,89
"9643",1986-05-26,124,235,48,111
"9644",1986-05-27,146,295,0,149
"9645",1986-05-28,194,320,32,126
"9646",1986-05-29,156,321,22,165
"9647",1986-05-30,180,324,0,144
"9648",1986-05-31,196,345,0,149
"9649",1986-06-01,206,312,0,106
"9650",1986-06-02,211,378,0,167
"9651",1986-06-03,193,366,0,173
"9652",1986-06-04,230,310,0,80
"9653",1986-06-05,200,295,4,95
"9654",1986-06-06,170,318,0,148
"9655",1986-06-07,178,324,0,146
"9656",1986-06-08,190,330,0,140
"9657",1986-06-09,217,288,0,71
"9658",1986-06-10,180,322,0,142
"9659",1986-06-11,213,286,0,73
"9660",1986-06-12,193,244,0,51
"9661",1986-06-13,169,261,0,92
"9662",1986-06-14,155,244,0,89
"9663",1986-06-15,186,227,0,41
"9664",1986-06-16,172,322,0,150
"9665",1986-06-17,185,350,0,165
"9666",1986-06-18,216,371,0,155
"9667",1986-06-19,219,336,0,117
"9668",1986-06-20,198,332,0,134
"9669",1986-06-21,198,340,0,142
"9670",1986-06-22,200,350,0,150
"9671",1986-06-23,210,341,0,131
"9672",1986-06-24,197,325,0,128
"9673",1986-06-25,220,352,0,132
"9674",1986-06-26,258,365,2,107
"9675",1986-06-27,240,350,17,110
"9676",1986-06-28,254,379,0,125
"9677",1986-06-29,255,348,0,93
"9678",1986-06-30,267,326,0,59
"9679",1986-07-01,243,306,0,63
"9680",1986-07-02,215,250,74,35
"9681",1986-07-03,197,222,59,25
"9682",1986-07-04,180,258,24,78
"9683",1986-07-05,180,298,0,118
"9684",1986-07-06,206,325,0,119
"9685",1986-07-07,210,330,0,120
"9686",1986-07-08,220,350,0,130
"9687",1986-07-09,238,327,0,89
"9688",1986-07-10,229,320,4,91
"9689",1986-07-11,191,341,0,150
"9690",1986-07-12,218,357,0,139
"9691",1986-07-13,230,363,0,133
"9692",1986-07-14,250,410,0,160
"9693",1986-07-15,295,340,0,45
"9694",1986-07-16,225,330,67,105
"9695",1986-07-17,235,325,0,90
"9696",1986-07-18,213,337,0,124
"9697",1986-07-19,247,297,0,50
"9698",1986-07-20,220,306,1,86
"9699",1986-07-21,225,340,0,115
"9700",1986-07-22,220,358,0,138
"9701",1986-07-23,237,378,0,141
"9702",1986-07-24,268,337,0,69
"9703",1986-07-25,216,330,0,114
"9704",1986-07-26,220,324,0,104
"9705",1986-07-27,226,346,0,120
"9706",1986-07-28,249,363,0,114
"9707",1986-07-29,269,376,0,107
"9708",1986-07-30,247,325,45,78
"9709",1986-07-31,212,288,209,76
"9710",1986-08-01,200,306,0,106
"9711",1986-08-02,217,312,0,95
"9712",1986-08-03,212,307,0,95
"9713",1986-08-04,220,315,0,95
"9714",1986-08-05,212,282,0,70
"9715",1986-08-06,181,281,13,100
"9716",1986-08-07,190,322,0,132
"9717",1986-08-08,210,336,0,126
"9718",1986-08-09,235,345,0,110
"9719",1986-08-10,230,310,0,80
"9720",1986-08-11,246,353,0,107
"9721",1986-08-12,278,401,0,123
"9722",1986-08-13,246,353,0,107
"9723",1986-08-14,232,327,215,95
"9724",1986-08-15,195,251,252,56
"9725",1986-08-16,214,286,0,72
"9726",1986-08-17,216,296,0,80
"9727",1986-08-18,234,299,220,65
"9728",1986-08-19,206,264,42,58
"9729",1986-08-20,179,287,0,108
"9730",1986-08-21,199,280,0,81
"9731",1986-08-22,185,310,0,125
"9732",1986-08-23,174,306,1,132
"9733",1986-08-24,217,315,0,98
"9734",1986-08-25,214,317,0,103
"9735",1986-08-26,188,301,0,113
"9736",1986-08-27,195,303,0,108
"9737",1986-08-28,177,310,0,133
"9738",1986-08-29,159,330,0,171
"9739",1986-08-30,191,323,0,132
"9740",1986-08-31,202,332,0,130
"9741",1986-09-01,209,323,55,114
"9742",1986-09-02,191,313,0,122
"9743",1986-09-03,166,306,0,140
"9744",1986-09-04,175,316,0,141
"9745",1986-09-05,150,310,0,160
"9746",1986-09-06,172,264,6,92
"9747",1986-09-07,210,237,23,27
"9748",1986-09-08,173,255,188,82
"9749",1986-09-09,168,224,183,56
"9750",1986-09-10,160,224,4,64
"9751",1986-09-11,138,265,0,127
"9752",1986-09-12,189,246,0,57
"9753",1986-09-13,160,258,0,98
"9754",1986-09-14,165,285,0,120
"9755",1986-09-15,193,292,0,99
"9756",1986-09-16,191,272,0,81
"9757",1986-09-17,115,257,0,142
"9758",1986-09-18,133,289,0,156
"9759",1986-09-19,123,319,0,196
"9760",1986-09-20,138,250,0,112
"9761",1986-09-21,100,284,0,184
"9762",1986-09-22,105,336,0,231
"9763",1986-09-23,127,297,0,170
"9764",1986-09-24,122,304,0,182
"9765",1986-09-25,172,292,0,120
"9766",1986-09-26,163,305,0,142
"9767",1986-09-27,140,215,11,75
"9768",1986-09-28,120,148,143,28
"9769",1986-09-29,98,195,1,97
"9770",1986-09-30,78,254,0,176
"9771",1986-10-01,87,258,0,171
"9772",1986-10-02,84,265,0,181
"9773",1986-10-03,123,268,0,145
"9774",1986-10-04,125,267,0,142
"9775",1986-10-05,117,270,0,153
"9776",1986-10-06,145,270,0,125
"9777",1986-10-07,132,235,0,103
"9778",1986-10-08,116,256,0,140
"9779",1986-10-09,115,216,0,101
"9780",1986-10-10,51,206,0,155
"9781",1986-10-11,50,226,0,176
"9782",1986-10-12,65,233,0,168
"9783",1986-10-13,78,282,0,204
"9784",1986-10-14,100,242,0,142
"9785",1986-10-15,78,263,0,185
"9786",1986-10-16,113,193,7,80
"9787",1986-10-17,77,135,401,58
"9788",1986-10-18,75,105,5,30
"9789",1986-10-19,86,104,69,18
"9790",1986-10-20,83,112,224,29
"9791",1986-10-21,73,182,2,109
"9792",1986-10-22,60,136,0,76
"9793",1986-10-23,94,174,3,80
"9794",1986-10-24,60,222,0,162
"9795",1986-10-25,81,208,0,127
"9796",1986-10-26,94,197,0,103
"9797",1986-10-27,62,226,0,164
"9798",1986-10-28,59,105,0,46
"9799",1986-10-29,23,134,0,111
"9800",1986-10-30,-15,165,0,180
"9801",1986-10-31,37,213,0,176
"9802",1986-11-01,76,161,0,85
"9803",1986-11-02,50,211,0,161
"9804",1986-11-03,65,171,0,106
"9805",1986-11-04,24,205,0,181
"9806",1986-11-05,26,176,0,150
"9807",1986-11-06,87,155,0,68
"9808",1986-11-07,50,117,0,67
"9809",1986-11-08,59,146,0,87
"9810",1986-11-09,73,184,0,111
"9811",1986-11-10,17,175,0,158
"9812",1986-11-11,76,123,0,47
"9813",1986-11-12,34,168,0,134
"9814",1986-11-13,18,205,0,187
"9815",1986-11-14,50,122,0,72
"9816",1986-11-15,20,83,0,63
"9817",1986-11-16,16,90,0,74
"9818",1986-11-17,50,121,0,71
"9819",1986-11-18,4,130,0,126
"9820",1986-11-19,64,108,12,44
"9821",1986-11-20,-7,130,0,137
"9822",1986-11-21,42,82,0,40
"9823",1986-11-22,55,82,20,27
"9824",1986-11-23,44,62,0,18
"9825",1986-11-24,40,61,2,21
"9826",1986-11-25,-15,40,0,55
"9827",1986-11-26,8,28,0,20
"9828",1986-11-27,-25,66,0,91
"9829",1986-11-28,-7,49,0,56
"9830",1986-11-29,-74,40,0,114
"9831",1986-11-30,-58,136,0,194
"9832",1986-12-01,-24,81,0,105
"9833",1986-12-02,41,116,0,75
"9834",1986-12-03,15,116,0,101
"9835",1986-12-04,-19,151,0,170
"9836",1986-12-05,-4,145,0,149
"9837",1986-12-06,-21,92,0,113
"9838",1986-12-07,-65,76,0,141
"9839",1986-12-08,-4,50,0,54
"9840",1986-12-09,15,133,0,118
"9841",1986-12-10,-28,152,0,180
"9842",1986-12-11,18,157,0,139
"9843",1986-12-12,8,80,0,72
"9844",1986-12-13,34,69,68,35
"9845",1986-12-14,25,66,1,41
"9846",1986-12-15,-7,25,0,32
"9847",1986-12-16,-24,11,39,35
"9848",1986-12-17,-15,14,27,29
"9849",1986-12-18,-3,42,0,45
"9850",1986-12-19,-58,28,0,86
"9851",1986-12-20,-40,35,0,75
"9852",1986-12-21,-32,54,0,86
"9853",1986-12-22,-55,27,0,82
"9854",1986-12-23,-42,113,0,155
"9855",1986-12-24,-20,110,0,130
"9856",1986-12-25,-37,45,0,82
"9857",1986-12-26,-35,-2,5,33
"9858",1986-12-27,-73,37,3,110
"9859",1986-12-28,-75,-7,2,68
"9860",1986-12-29,-42,10,0,52
"9861",1986-12-30,-26,10,5,36
"9862",1986-12-31,-26,19,0,45
"9863",1987-01-01,-52,-18,79,34
"9864",1987-01-02,-89,16,0,105
"9865",1987-01-03,-77,20,0,97
"9866",1987-01-04,-61,-5,0,56
"9867",1987-01-05,-25,25,0,50
"9868",1987-01-06,-24,0,2,24
"9869",1987-01-07,-15,110,0,125
"9870",1987-01-08,-27,173,0,200
"9871",1987-01-09,-30,90,0,120
"9872",1987-01-10,-32,-8,0,24
"9873",1987-01-11,-17,115,0,132
"9874",1987-01-12,-42,70,0,112
"9875",1987-01-13,-82,37,0,119
"9876",1987-01-14,-65,125,0,190
"9877",1987-01-15,-41,52,0,93
"9878",1987-01-16,-30,122,0,152
"9879",1987-01-17,-30,70,0,100
"9880",1987-01-18,-30,50,0,80
"9881",1987-01-19,-75,92,0,167
"9882",1987-01-20,-14,75,0,89
"9883",1987-01-21,15,53,0,38
"9884",1987-01-22,17,37,0,20
"9885",1987-01-23,-11,77,0,88
"9886",1987-01-24,-18,62,0,80
"9887",1987-01-25,-42,61,0,103
"9888",1987-01-26,-25,93,0,118
"9889",1987-01-27,-9,142,0,151
"9890",1987-01-28,-61,155,0,216
"9891",1987-01-29,-39,121,0,160
"9892",1987-01-30,-39,102,0,141
"9893",1987-01-31,-28,85,0,113
"9894",1987-02-01,14,113,0,99
"9895",1987-02-02,-30,104,0,134
"9896",1987-02-03,-53,32,0,85
"9897",1987-02-04,-71,90,0,161
"9898",1987-02-05,-40,140,0,180
"9899",1987-02-06,-24,178,0,202
"9900",1987-02-07,-13,185,0,198
"9901",1987-02-08,-5,197,0,202
"9902",1987-02-09,17,175,0,158
"9903",1987-02-10,74,135,12,61
"9904",1987-02-11,64,107,58,43
"9905",1987-02-12,-18,65,0,83
"9906",1987-02-13,25,170,0,145
"9907",1987-02-14,25,102,0,77
"9908",1987-02-15,15,64,0,49
"9909",1987-02-16,24,48,11,24
"9910",1987-02-17,-5,28,25,33
"9911",1987-02-18,-38,-3,9,35
"9912",1987-02-19,-50,-14,41,36
"9913",1987-02-20,-70,6,0,76
"9914",1987-02-21,-42,100,0,142
"9915",1987-02-22,8,161,0,153
"9916",1987-02-23,5,205,0,200
"9917",1987-02-24,-16,92,0,108
"9918",1987-02-25,-52,48,0,100
"9919",1987-02-26,-35,57,0,92
"9920",1987-02-27,-45,110,0,155
"9921",1987-02-28,30,173,0,143
"9922",1987-03-01,35,174,0,139
"9923",1987-03-02,35,178,0,143
"9924",1987-03-03,5,198,0,193
"9925",1987-03-04,25,233,0,208
"9926",1987-03-05,35,163,0,128
"9927",1987-03-06,-7,89,90,96
"9928",1987-03-07,-5,33,1,38
"9929",1987-03-08,16,50,4,34
"9930",1987-03-09,-1,34,53,35
"9931",1987-03-10,-13,115,30,128
"9932",1987-03-11,-4,80,0,84
"9933",1987-03-12,32,78,0,46
"9934",1987-03-13,-1,75,30,76
"9935",1987-03-14,4,92,0,88
"9936",1987-03-15,5,161,0,156
"9937",1987-03-16,50,165,0,115
"9938",1987-03-17,69,187,0,118
"9939",1987-03-18,57,145,89,88
"9940",1987-03-19,22,154,10,132
"9941",1987-03-20,44,101,0,57
"9942",1987-03-21,10,46,6,36
"9943",1987-03-22,-12,48,110,60
"9944",1987-03-23,35,90,0,55
"9945",1987-03-24,-1,60,0,61
"9946",1987-03-25,-4,85,0,89
"9947",1987-03-26,-10,132,0,142
"9948",1987-03-27,-9,161,0,170
"9949",1987-03-28,67,165,0,98
"9950",1987-03-29,34,155,0,121
"9951",1987-03-30,54,127,0,73
"9952",1987-03-31,24,78,0,54
"9953",1987-04-01,-7,102,4,109
"9954",1987-04-02,8,225,0,217
"9955",1987-04-03,48,230,0,182
"9956",1987-04-04,85,228,0,143
"9957",1987-04-05,120,160,27,40
"9958",1987-04-06,67,250,0,183
"9959",1987-04-07,112,259,0,147
"9960",1987-04-08,103,243,0,140
"9961",1987-04-09,135,245,4,110
"9962",1987-04-10,82,164,0,82
"9963",1987-04-11,37,118,0,81
"9964",1987-04-12,11,162,0,151
"9965",1987-04-13,50,183,0,133
"9966",1987-04-14,69,180,0,111
"9967",1987-04-15,59,202,0,143
"9968",1987-04-16,69,245,0,176
"9969",1987-04-17,103,257,0,154
"9970",1987-04-18,137,247,0,110
"9971",1987-04-19,120,230,0,110
"9972",1987-04-20,119,185,88,66
"9973",1987-04-21,64,265,26,201
"9974",1987-04-22,154,246,0,92
"9975",1987-04-23,130,274,0,144
"9976",1987-04-24,115,215,6,100
"9977",1987-04-25,73,137,7,64
"9978",1987-04-26,76,174,0,98
"9979",1987-04-27,83,205,0,122
"9980",1987-04-28,87,273,0,186
"9981",1987-04-29,129,254,0,125
"9982",1987-04-30,117,288,0,171
"9983",1987-05-01,144,244,0,100
"9984",1987-05-02,104,158,21,54
"9985",1987-05-03,66,224,0,158
"9986",1987-05-04,124,230,0,106
"9987",1987-05-05,142,223,0,81
"9988",1987-05-06,116,228,0,112
"9989",1987-05-07,87,267,0,180
"9990",1987-05-08,143,261,0,118
"9991",1987-05-09,129,267,0,138
"9992",1987-05-10,156,265,0,109
"9993",1987-05-11,170,225,0,55
"9994",1987-05-12,168,204,190,36
"9995",1987-05-13,123,224,3,101
"9996",1987-05-14,126,266,0,140
"9997",1987-05-15,167,257,0,90
"9998",1987-05-16,194,267,0,73
"9999",1987-05-17,90,307,0,217
"10000",1987-05-18,172,305,0,133
"10001",1987-05-19,202,276,0,74
"10002",1987-05-20,168,305,0,137
"10003",1987-05-21,187,293,0,106
"10004",1987-05-22,180,331,0,151
"10005",1987-05-23,199,329,0,130
"10006",1987-05-24,200,304,0,104
"10007",1987-05-25,182,222,0,40
"10008",1987-05-26,177,209,47,32
"10009",1987-05-27,170,276,11,106
"10010",1987-05-28,185,301,0,116
"10011",1987-05-29,144,328,0,184
"10012",1987-05-30,198,326,0,128
"10013",1987-05-31,210,304,0,94
"10014",1987-06-01,165,211,614,46
"10015",1987-06-02,142,339,0,197
"10016",1987-06-03,190,352,0,162
"10017",1987-06-04,222,344,0,122
"10018",1987-06-05,220,315,0,95
"10019",1987-06-06,121,224,253,103
"10020",1987-06-07,133,261,0,128
"10021",1987-06-08,129,291,0,162
"10022",1987-06-09,143,293,0,150
"10023",1987-06-10,181,304,0,123
"10024",1987-06-11,160,287,7,127
"10025",1987-06-12,176,237,39,61
"10026",1987-06-13,183,225,23,42
"10027",1987-06-14,178,244,0,66
"10028",1987-06-15,135,299,0,164
"10029",1987-06-16,180,316,0,136
"10030",1987-06-17,200,319,0,119
"10031",1987-06-18,202,296,0,94
"10032",1987-06-19,210,316,0,106
"10033",1987-06-20,194,284,0,90
"10034",1987-06-21,180,229,196,49
"10035",1987-06-22,183,205,174,22
"10036",1987-06-23,182,281,13,99
"10037",1987-06-24,217,287,0,70
"10038",1987-06-25,202,308,0,106
"10039",1987-06-26,229,309,0,80
"10040",1987-06-27,224,282,0,58
"10041",1987-06-28,210,321,0,111
"10042",1987-06-29,198,346,0,148
"10043",1987-06-30,216,300,0,84
"10044",1987-07-01,225,316,0,91
"10045",1987-07-02,216,324,0,108
"10046",1987-07-03,215,322,0,107
"10047",1987-07-04,230,366,0,136
"10048",1987-07-05,244,319,1,75
"10049",1987-07-06,218,349,141,131
"10050",1987-07-07,225,344,43,119
"10051",1987-07-08,245,346,46,101
"10052",1987-07-09,238,320,1,82
"10053",1987-07-10,247,314,91,67
"10054",1987-07-11,244,279,0,35
"10055",1987-07-12,226,306,5,80
"10056",1987-07-13,226,302,0,76
"10057",1987-07-14,202,314,0,112
"10058",1987-07-15,215,307,0,92
"10059",1987-07-16,222,304,0,82
"10060",1987-07-17,231,311,0,80
"10061",1987-07-18,219,271,28,52
"10062",1987-07-19,219,308,0,89
"10063",1987-07-20,235,332,198,97
"10064",1987-07-21,230,339,0,109
"10065",1987-07-22,234,334,0,100
"10066",1987-07-23,195,363,0,168
"10067",1987-07-24,199,360,0,161
"10068",1987-07-25,222,333,0,111
"10069",1987-07-26,221,316,10,95
"10070",1987-07-27,219,323,0,104
"10071",1987-07-28,231,323,0,92
"10072",1987-07-29,232,332,0,100
"10073",1987-07-30,241,325,0,84
"10074",1987-07-31,251,339,0,88
"10075",1987-08-01,230,341,0,111
"10076",1987-08-02,242,349,0,107
"10077",1987-08-03,266,317,1,51
"10078",1987-08-04,225,289,229,64
"10079",1987-08-05,231,323,0,92
"10080",1987-08-06,252,303,0,51
"10081",1987-08-07,234,326,0,92
"10082",1987-08-08,215,354,0,139
"10083",1987-08-09,195,333,0,138
"10084",1987-08-10,208,335,0,127
"10085",1987-08-11,200,320,0,120
"10086",1987-08-12,199,317,0,118
"10087",1987-08-13,217,279,68,62
"10088",1987-08-14,200,250,892,50
"10089",1987-08-15,188,286,0,98
"10090",1987-08-16,208,326,0,118
"10091",1987-08-17,234,322,0,88
"10092",1987-08-18,225,327,0,102
"10093",1987-08-19,227,312,0,85
"10094",1987-08-20,235,350,0,115
"10095",1987-08-21,230,332,0,102
"10096",1987-08-22,230,322,0,92
"10097",1987-08-23,227,333,0,106
"10098",1987-08-24,237,316,0,79
"10099",1987-08-25,213,333,0,120
"10100",1987-08-26,238,336,206,98
"10101",1987-08-27,230,339,0,109
"10102",1987-08-28,226,339,0,113
"10103",1987-08-29,222,337,0,115
"10104",1987-08-30,203,344,0,141
"10105",1987-08-31,218,315,0,97
"10106",1987-09-01,188,310,0,122
"10107",1987-09-02,207,306,6,99
"10108",1987-09-03,197,257,327,60
"10109",1987-09-04,205,271,0,66
"10110",1987-09-05,188,278,0,90
"10111",1987-09-06,185,291,0,106
"10112",1987-09-07,175,251,0,76
"10113",1987-09-08,149,276,0,127
"10114",1987-09-09,165,284,0,119
"10115",1987-09-10,141,262,0,121
"10116",1987-09-11,129,267,0,138
"10117",1987-09-12,166,290,0,124
"10118",1987-09-13,193,324,0,131
"10119",1987-09-14,220,259,0,39
"10120",1987-09-15,195,269,0,74
"10121",1987-09-16,155,265,0,110
"10122",1987-09-17,151,306,0,155
"10123",1987-09-18,153,355,0,202
"10124",1987-09-19,148,375,0,227
"10125",1987-09-20,216,359,0,143
"10126",1987-09-21,210,314,0,104
"10127",1987-09-22,168,313,0,145
"10128",1987-09-23,155,293,0,138
"10129",1987-09-24,190,300,0,110
"10130",1987-09-25,149,233,0,84
"10131",1987-09-26,80,251,0,171
"10132",1987-09-27,133,270,0,137
"10133",1987-09-28,132,250,0,118
"10134",1987-09-29,115,293,0,178
"10135",1987-09-30,128,319,0,191
"10136",1987-10-01,154,329,0,175
"10137",1987-10-02,134,305,0,171
"10138",1987-10-03,121,316,0,195
"10139",1987-10-04,173,314,0,141
"10140",1987-10-05,139,322,0,183
"10141",1987-10-06,160,343,0,183
"10142",1987-10-07,178,268,0,90
"10143",1987-10-08,149,306,0,157
"10144",1987-10-09,158,274,0,116
"10145",1987-10-10,163,282,0,119
"10146",1987-10-11,160,283,0,123
"10147",1987-10-12,129,230,112,101
"10148",1987-10-13,104,145,462,41
"10149",1987-10-14,116,151,215,35
"10150",1987-10-15,99,159,84,60
"10151",1987-10-16,78,156,2,78
"10152",1987-10-17,115,202,4,87
"10153",1987-10-18,89,159,32,70
"10154",1987-10-19,62,158,0,96
"10155",1987-10-20,63,105,0,42
"10156",1987-10-21,79,127,0,48
"10157",1987-10-22,48,193,0,145
"10158",1987-10-23,92,182,0,90
"10159",1987-10-24,78,195,0,117
"10160",1987-10-25,38,195,0,157
"10161",1987-10-26,45,209,0,164
"10162",1987-10-27,72,261,0,189
"10163",1987-10-28,109,238,0,129
"10164",1987-10-29,141,232,0,91
"10165",1987-10-30,73,161,0,88
"10166",1987-10-31,23,74,75,51
"10167",1987-11-01,22,70,54,48
"10168",1987-11-02,50,123,7,73
"10169",1987-11-03,-14,159,0,173
"10170",1987-11-04,62,133,0,71
"10171",1987-11-05,33,130,0,97
"10172",1987-11-06,16,165,0,149
"10173",1987-11-07,9,141,0,132
"10174",1987-11-08,7,212,0,205
"10175",1987-11-09,28,231,0,203
"10176",1987-11-10,83,227,0,144
"10177",1987-11-11,57,154,0,97
"10178",1987-11-12,95,155,0,60
"10179",1987-11-13,40,112,0,72
"10180",1987-11-14,21,124,0,103
"10181",1987-11-15,59,167,0,108
"10182",1987-11-16,8,146,0,138
"10183",1987-11-17,56,164,0,108
"10184",1987-11-18,87,164,0,77
"10185",1987-11-19,23,188,0,165
"10186",1987-11-20,20,205,0,185
"10187",1987-11-21,15,167,0,152
"10188",1987-11-22,19,141,0,122
"10189",1987-11-23,15,197,0,182
"10190",1987-11-24,59,91,6,32
"10191",1987-11-25,49,85,3,36
"10192",1987-11-26,12,56,51,44
"10193",1987-11-27,-53,18,43,71
"10194",1987-11-28,-104,-15,10,89
"10195",1987-11-29,-90,6,0,96
"10196",1987-11-30,-65,20,0,85
"10197",1987-12-01,-67,14,0,81
"10198",1987-12-02,-55,62,0,117
"10199",1987-12-03,-18,47,0,65
"10200",1987-12-04,-20,51,0,71
"10201",1987-12-05,-1,51,0,52
"10202",1987-12-06,-66,88,0,154
"10203",1987-12-07,-50,101,0,151
"10204",1987-12-08,-2,116,0,118
"10205",1987-12-09,-32,146,0,178
"10206",1987-12-10,-8,52,0,60
"10207",1987-12-11,-60,64,0,124
"10208",1987-12-12,-80,76,0,156
"10209",1987-12-13,-60,42,0,102
"10210",1987-12-14,-63,112,0,175
"10211",1987-12-15,10,118,0,108
"10212",1987-12-16,-53,107,0,160
"10213",1987-12-17,-50,115,0,165
"10214",1987-12-18,-27,136,0,163
"10215",1987-12-19,-14,74,0,88
"10216",1987-12-20,-52,128,0,180
"10217",1987-12-21,-28,163,0,191
"10218",1987-12-22,10,145,0,135
"10219",1987-12-23,-29,142,0,171
"10220",1987-12-24,-12,147,0,159
"10221",1987-12-25,25,157,0,132
"10222",1987-12-26,-14,187,0,201
"10223",1987-12-27,-13,219,0,232
"10224",1987-12-28,30,183,0,153
"10225",1987-12-29,7,79,0,72
"10226",1987-12-30,-48,50,0,98
"10227",1987-12-31,-38,65,0,103
"10228",1988-01-01,-15,66,0,81
"10229",1988-01-02,-55,57,0,112
"10230",1988-01-03,-12,25,1,37
"10231",1988-01-04,-24,48,0,72
"10232",1988-01-05,-76,23,0,99
"10233",1988-01-06,-61,28,0,89
"10234",1988-01-07,-3,120,0,123
"10235",1988-01-08,-10,112,0,122
"10236",1988-01-09,-58,32,0,90
"10237",1988-01-10,-34,67,0,101
"10238",1988-01-11,-18,70,0,88
"10239",1988-01-12,-46,100,0,146
"10240",1988-01-13,-16,32,0,48
"10241",1988-01-14,13,52,0,39
"10242",1988-01-15,19,58,0,39
"10243",1988-01-16,2,56,0,54
"10244",1988-01-17,-12,61,0,73
"10245",1988-01-18,-67,80,0,147
"10246",1988-01-19,-64,134,0,198
"10247",1988-01-20,-17,107,0,124
"10248",1988-01-21,0,130,0,130
"10249",1988-01-22,-20,90,0,110
"10250",1988-01-23,-70,2,0,72
"10251",1988-01-24,-78,28,0,106
"10252",1988-01-25,-76,59,0,135
"10253",1988-01-26,-58,89,0,147
"10254",1988-01-27,-49,85,0,134
"10255",1988-01-28,-57,158,0,215
"10256",1988-01-29,-37,43,0,80
"10257",1988-01-30,-34,67,0,101
"10258",1988-01-31,-65,85,0,150
"10259",1988-02-01,-40,134,0,174
"10260",1988-02-02,-30,77,0,107
"10261",1988-02-03,-79,72,0,151
"10262",1988-02-04,-40,209,0,249
"10263",1988-02-05,2,74,0,72
"10264",1988-02-06,-59,42,0,101
"10265",1988-02-07,-5,84,0,89
"10266",1988-02-08,-63,78,0,141
"10267",1988-02-09,-44,59,0,103
"10268",1988-02-10,-33,47,0,80
"10269",1988-02-11,-50,111,0,161
"10270",1988-02-12,-16,115,0,131
"10271",1988-02-13,-17,117,0,134
"10272",1988-02-14,-27,34,0,61
"10273",1988-02-15,-40,21,0,61
"10274",1988-02-16,-35,3,27,38
"10275",1988-02-17,-80,46,0,126
"10276",1988-02-18,-55,82,0,137
"10277",1988-02-19,-35,77,0,112
"10278",1988-02-20,-42,106,0,148
"10279",1988-02-21,-31,102,0,133
"10280",1988-02-22,21,75,3,54
"10281",1988-02-23,-5,54,4,59
"10282",1988-02-24,-47,76,0,123
"10283",1988-02-25,5,45,4,40
"10284",1988-02-26,-1,50,2,51
"10285",1988-02-27,-18,50,0,68
"10286",1988-02-28,-32,13,27,45
"10287",1988-02-29,-28,12,13,40
"10288",1988-03-01,-30,87,0,117
"10289",1988-03-02,-30,42,0,72
"10290",1988-03-03,-65,72,0,137
"10291",1988-03-04,3,98,0,95
"10292",1988-03-05,-17,100,0,117
"10293",1988-03-06,-5,47,0,52
"10294",1988-03-07,-47,105,0,152
"10295",1988-03-08,17,132,0,115
"10296",1988-03-09,5,188,0,183
"10297",1988-03-10,5,173,0,168
"10298",1988-03-11,41,218,0,177
"10299",1988-03-12,52,221,0,169
"10300",1988-03-13,74,181,16,107
"10301",1988-03-14,28,123,159,95
"10302",1988-03-15,28,55,0,27
"10303",1988-03-16,-1,69,0,70
"10304",1988-03-17,-16,102,0,118
"10305",1988-03-18,11,121,0,110
"10306",1988-03-19,48,95,0,47
"10307",1988-03-20,31,64,14,33
"10308",1988-03-21,4,45,71,41
"10309",1988-03-22,33,73,0,40
"10310",1988-03-23,13,88,0,75
"10311",1988-03-24,32,103,10,71
"10312",1988-03-25,17,85,0,68
"10313",1988-03-26,27,150,0,123
"10314",1988-03-27,45,158,0,113
"10315",1988-03-28,75,151,0,76
"10316",1988-03-29,73,133,0,60
"10317",1988-03-30,16,176,0,160
"10318",1988-03-31,33,199,0,166
"10319",1988-04-01,56,179,0,123
"10320",1988-04-02,63,190,0,127
"10321",1988-04-03,92,158,0,66
"10322",1988-04-04,47,143,0,96
"10323",1988-04-05,28,130,85,102
"10324",1988-04-06,-2,48,151,50
"10325",1988-04-07,9,194,0,185
"10326",1988-04-08,64,184,0,120
"10327",1988-04-09,75,216,0,141
"10328",1988-04-10,101,235,0,134
"10329",1988-04-11,132,216,0,84
"10330",1988-04-12,105,243,0,138
"10331",1988-04-13,56,260,0,204
"10332",1988-04-14,66,248,0,182
"10333",1988-04-15,97,272,0,175
"10334",1988-04-16,144,247,0,103
"10335",1988-04-17,145,193,0,48
"10336",1988-04-18,78,291,0,213
"10337",1988-04-19,132,225,0,93
"10338",1988-04-20,132,233,0,101
"10339",1988-04-21,109,235,0,126
"10340",1988-04-22,63,227,0,164
"10341",1988-04-23,72,196,0,124
"10342",1988-04-24,52,236,0,184
"10343",1988-04-25,97,220,0,123
"10344",1988-04-26,131,230,9,99
"10345",1988-04-27,91,266,0,175
"10346",1988-04-28,98,329,0,231
"10347",1988-04-29,215,312,0,97
"10348",1988-04-30,193,343,0,150
"10349",1988-05-01,170,284,0,114
"10350",1988-05-02,147,250,0,103
"10351",1988-05-03,165,247,0,82
"10352",1988-05-04,185,220,0,35
"10353",1988-05-05,167,275,0,108
"10354",1988-05-06,130,230,83,100
"10355",1988-05-07,127,202,0,75
"10356",1988-05-08,129,165,12,36
"10357",1988-05-09,83,207,5,124
"10358",1988-05-10,111,217,0,106
"10359",1988-05-11,149,236,0,87
"10360",1988-05-12,121,247,0,126
"10361",1988-05-13,131,251,0,120
"10362",1988-05-14,160,300,0,140
"10363",1988-05-15,144,309,0,165
"10364",1988-05-16,152,333,0,181
"10365",1988-05-17,165,333,0,168
"10366",1988-05-18,205,268,59,63
"10367",1988-05-19,201,286,26,85
"10368",1988-05-20,134,253,26,119
"10369",1988-05-21,112,152,102,40
"10370",1988-05-22,91,285,0,194
"10371",1988-05-23,166,275,0,109
"10372",1988-05-24,167,303,0,136
"10373",1988-05-25,192,276,0,84
"10374",1988-05-26,179,305,0,126
"10375",1988-05-27,197,291,0,94
"10376",1988-05-28,170,311,0,141
"10377",1988-05-29,184,300,0,116
"10378",1988-05-30,158,251,17,93
"10379",1988-05-31,128,326,0,198
"10380",1988-06-01,136,349,0,213
"10381",1988-06-02,146,335,0,189
"10382",1988-06-03,149,325,0,176
"10383",1988-06-04,160,352,0,192
"10384",1988-06-05,207,350,0,143
"10385",1988-06-06,187,345,0,158
"10386",1988-06-07,243,369,0,126
"10387",1988-06-08,193,279,12,86
"10388",1988-06-09,195,236,10,41
"10389",1988-06-10,168,329,0,161
"10390",1988-06-11,227,301,0,74
"10391",1988-06-12,226,347,0,121
"10392",1988-06-13,181,368,0,187
"10393",1988-06-14,223,391,0,168
"10394",1988-06-15,253,331,0,78
"10395",1988-06-16,176,342,0,166
"10396",1988-06-17,207,359,0,152
"10397",1988-06-18,222,369,0,147
"10398",1988-06-19,208,342,0,134
"10399",1988-06-20,206,302,0,96
"10400",1988-06-21,224,281,0,57
"10401",1988-06-22,179,303,0,124
"10402",1988-06-23,204,332,0,128
"10403",1988-06-24,233,340,0,107
"10404",1988-06-25,222,340,0,118
"10405",1988-06-26,219,331,0,112
"10406",1988-06-27,239,304,0,65
"10407",1988-06-28,238,325,0,87
"10408",1988-06-29,225,352,0,127
"10409",1988-06-30,242,370,0,128
"10410",1988-07-01,218,374,138,156
"10411",1988-07-02,206,332,7,126
"10412",1988-07-03,172,271,147,99
"10413",1988-07-04,178,220,314,42
"10414",1988-07-05,184,209,0,25
"10415",1988-07-06,190,342,0,152
"10416",1988-07-07,248,359,0,111
"10417",1988-07-08,242,328,0,86
"10418",1988-07-09,223,297,0,74
"10419",1988-07-10,227,272,10,45
"10420",1988-07-11,208,298,0,90
"10421",1988-07-12,234,270,0,36
"10422",1988-07-13,225,324,0,99
"10423",1988-07-14,249,342,0,93
"10424",1988-07-15,235,360,455,125
"10425",1988-07-16,224,304,23,80
"10426",1988-07-17,258,343,0,85
"10427",1988-07-18,274,365,0,91
"10428",1988-07-19,256,329,0,73
"10429",1988-07-20,256,330,0,74
"10430",1988-07-21,250,346,11,96
"10431",1988-07-22,248,354,0,106
"10432",1988-07-23,255,344,0,89
"10433",1988-07-24,246,285,1,39
"10434",1988-07-25,237,307,0,70
"10435",1988-07-26,234,297,0,63
"10436",1988-07-27,202,301,0,99
"10437",1988-07-28,220,304,0,84
"10438",1988-07-29,240,288,62,48
"10439",1988-07-30,213,287,150,74
"10440",1988-07-31,213,282,26,69
"10441",1988-08-01,247,282,8,35
"10442",1988-08-02,249,305,0,56
"10443",1988-08-03,252,331,0,79
"10444",1988-08-04,262,349,0,87
"10445",1988-08-05,262,334,0,72
"10446",1988-08-06,232,309,0,77
"10447",1988-08-07,220,311,2,91
"10448",1988-08-08,230,311,50,81
"10449",1988-08-09,245,291,10,46
"10450",1988-08-10,252,278,8,26
"10451",1988-08-11,232,314,73,82
"10452",1988-08-12,246,321,43,75
"10453",1988-08-13,240,293,22,53
"10454",1988-08-14,218,266,33,48
"10455",1988-08-15,202,251,619,49
"10456",1988-08-16,192,272,15,80
"10457",1988-08-17,202,289,0,87
"10458",1988-08-18,206,254,84,48
"10459",1988-08-19,210,235,151,25
"10460",1988-08-20,200,316,10,116
"10461",1988-08-21,214,283,0,69
"10462",1988-08-22,187,304,0,117
"10463",1988-08-23,190,292,0,102
"10464",1988-08-24,160,292,0,132
"10465",1988-08-25,178,268,0,90
"10466",1988-08-26,197,271,3,74
"10467",1988-08-27,166,285,0,119
"10468",1988-08-28,176,298,0,122
"10469",1988-08-29,194,306,0,112
"10470",1988-08-30,187,299,0,112
"10471",1988-08-31,213,281,35,68
"10472",1988-09-01,170,233,256,63
"10473",1988-09-02,169,259,35,90
"10474",1988-09-03,168,289,0,121
"10475",1988-09-04,189,303,0,114
"10476",1988-09-05,199,307,0,108
"10477",1988-09-06,204,330,0,126
"10478",1988-09-07,218,326,0,108
"10479",1988-09-08,228,280,3,52
"10480",1988-09-09,180,242,0,62
"10481",1988-09-10,173,286,0,113
"10482",1988-09-11,173,281,0,108
"10483",1988-09-12,175,287,0,112
"10484",1988-09-13,173,226,61,53
"10485",1988-09-14,133,246,0,113
"10486",1988-09-15,144,266,0,122
"10487",1988-09-16,169,281,0,112
"10488",1988-09-17,192,301,0,109
"10489",1988-09-18,159,241,15,82
"10490",1988-09-19,153,252,0,99
"10491",1988-09-20,125,262,0,137
"10492",1988-09-21,143,268,0,125
"10493",1988-09-22,158,259,0,101
"10494",1988-09-23,170,247,0,77
"10495",1988-09-24,133,266,0,133
"10496",1988-09-25,126,278,0,152
"10497",1988-09-26,121,261,0,140
"10498",1988-09-27,94,267,0,173
"10499",1988-09-28,99,267,0,168
"10500",1988-09-29,154,250,0,96
"10501",1988-09-30,104,232,0,128
"10502",1988-10-01,163,232,0,69
"10503",1988-10-02,147,228,0,81
"10504",1988-10-03,118,242,0,124
"10505",1988-10-04,159,208,0,49
"10506",1988-10-05,104,231,6,127
"10507",1988-10-06,101,230,0,129
"10508",1988-10-07,130,232,0,102
"10509",1988-10-08,99,253,0,154
"10510",1988-10-09,113,273,0,160
"10511",1988-10-10,152,258,0,106
"10512",1988-10-11,161,250,0,89
"10513",1988-10-12,130,213,2,83
"10514",1988-10-13,82,185,0,103
"10515",1988-10-14,94,145,21,51
"10516",1988-10-15,95,120,210,25
"10517",1988-10-16,109,183,144,74
"10518",1988-10-17,98,197,0,99
"10519",1988-10-18,70,216,0,146
"10520",1988-10-19,141,186,6,45
"10521",1988-10-20,147,197,2,50
"10522",1988-10-21,144,185,0,41
"10523",1988-10-22,124,172,68,48
"10524",1988-10-23,116,196,3,80
"10525",1988-10-24,88,256,0,168
"10526",1988-10-25,75,250,0,175
"10527",1988-10-26,74,238,0,164
"10528",1988-10-27,96,175,0,79
"10529",1988-10-28,74,156,0,82
"10530",1988-10-29,32,172,0,140
"10531",1988-10-30,32,205,0,173
"10532",1988-10-31,45,222,0,177
"10533",1988-11-01,89,152,0,63
"10534",1988-11-02,21,183,0,162
"10535",1988-11-03,75,192,0,117
"10536",1988-11-04,94,209,0,115
"10537",1988-11-05,25,215,0,190
"10538",1988-11-06,34,232,0,198
"10539",1988-11-07,56,223,0,167
"10540",1988-11-08,36,248,0,212
"10541",1988-11-09,31,178,0,147
"10542",1988-11-10,12,145,0,133
"10543",1988-11-11,58,184,0,126
"10544",1988-11-12,114,214,0,100
"10545",1988-11-13,44,238,0,194
"10546",1988-11-14,31,160,0,129
"10547",1988-11-15,47,136,0,89
"10548",1988-11-16,-16,130,0,146
"10549",1988-11-17,-11,147,0,158
"10550",1988-11-18,-20,152,0,172
"10551",1988-11-19,33,205,0,172
"10552",1988-11-20,23,183,0,160
"10553",1988-11-21,6,161,0,155
"10554",1988-11-22,26,149,0,123
"10555",1988-11-23,-29,152,0,181
"10556",1988-11-24,-50,121,0,171
"10557",1988-11-25,11,110,0,99
"10558",1988-11-26,-45,141,0,186
"10559",1988-11-27,14,127,0,113
"10560",1988-11-28,-38,128,0,166
"10561",1988-11-29,-40,140,0,180
"10562",1988-11-30,-11,164,0,175
"10563",1988-12-01,-27,122,0,149
"10564",1988-12-02,-44,122,0,166
"10565",1988-12-03,-24,130,0,154
"10566",1988-12-04,-15,112,0,127
"10567",1988-12-05,-70,125,0,195
"10568",1988-12-06,-30,164,0,194
"10569",1988-12-07,1,149,0,148
"10570",1988-12-08,52,110,0,58
"10571",1988-12-09,-29,82,0,111
"10572",1988-12-10,-44,108,0,152
"10573",1988-12-11,-15,137,0,152
"10574",1988-12-12,-28,166,0,194
"10575",1988-12-13,11,87,0,76
"10576",1988-12-14,-68,73,0,141
"10577",1988-12-15,-55,30,0,85
"10578",1988-12-16,-86,66,0,152
"10579",1988-12-17,-95,77,0,172
"10580",1988-12-18,-28,115,0,143
"10581",1988-12-19,-50,80,0,130
"10582",1988-12-20,29,85,0,56
"10583",1988-12-21,-30,52,0,82
"10584",1988-12-22,3,42,72,39
"10585",1988-12-23,-2,54,46,56
"10586",1988-12-24,4,35,8,31
"10587",1988-12-25,-13,8,0,21
"10588",1988-12-26,-20,89,0,109
"10589",1988-12-27,-17,62,0,79
"10590",1988-12-28,-14,42,20,56
"10591",1988-12-29,-18,48,0,66
"10592",1988-12-30,-52,-2,0,50
"10593",1988-12-31,-12,13,0,25
"10594",1989-01-01,-19,57,0,76
"10595",1989-01-02,-41,82,0,123
"10596",1989-01-03,0,22,11,22
"10597",1989-01-04,-7,18,37,25
"10598",1989-01-05,-3,9,132,12
"10599",1989-01-06,-5,12,89,17
"10600",1989-01-07,-5,22,72,27
"10601",1989-01-08,3,35,16,32
"10602",1989-01-09,-37,29,0,66
"10603",1989-01-10,-20,23,177,43
"10604",1989-01-11,-55,4,3,59
"10605",1989-01-12,-100,10,0,110
"10606",1989-01-13,-90,15,0,105
"10607",1989-01-14,-105,8,0,113
"10608",1989-01-15,-102,54,0,156
"10609",1989-01-16,-98,37,0,135
"10610",1989-01-17,-39,20,0,59
"10611",1989-01-18,-6,30,1,36
"10612",1989-01-19,-6,59,0,65
"10613",1989-01-20,-30,61,0,91
"10614",1989-01-21,-14,58,0,72
"10615",1989-01-22,-22,78,0,100
"10616",1989-01-23,-31,92,0,123
"10617",1989-01-24,-15,60,0,75
"10618",1989-01-25,-7,110,2,117
"10619",1989-01-26,0,55,0,55
"10620",1989-01-27,-63,36,0,99
"10621",1989-01-28,-64,13,0,77
"10622",1989-01-29,-52,43,0,95
"10623",1989-01-30,-32,78,0,110
"10624",1989-01-31,-10,70,0,80
"10625",1989-02-01,-25,58,0,83
"10626",1989-02-02,-58,42,0,100
"10627",1989-02-03,-25,73,0,98
"10628",1989-02-04,-35,50,0,85
"10629",1989-02-05,-44,49,0,93
"10630",1989-02-06,-20,37,0,57
"10631",1989-02-07,-10,22,32,32
"10632",1989-02-08,-36,75,0,111
"10633",1989-02-09,7,83,0,76
"10634",1989-02-10,-46,83,0,129
"10635",1989-02-11,9,125,0,116
"10636",1989-02-12,-10,138,0,148
"10637",1989-02-13,-47,120,0,167
"10638",1989-02-14,7,63,0,56
"10639",1989-02-15,35,90,0,55
"10640",1989-02-16,11,72,26,61
"10641",1989-02-17,-19,32,98,51
"10642",1989-02-18,-11,58,0,69
"10643",1989-02-19,-23,83,0,106
"10644",1989-02-20,33,66,0,33
"10645",1989-02-21,-30,58,22,88
"10646",1989-02-22,-8,31,7,39
"10647",1989-02-23,-22,18,74,40
"10648",1989-02-24,-55,16,0,71
"10649",1989-02-25,-47,33,0,80
"10650",1989-02-26,-21,57,0,78
"10651",1989-02-27,-2,160,0,162
"10652",1989-02-28,29,115,0,86
"10653",1989-03-01,7,85,1,78
"10654",1989-03-02,0,24,257,24
"10655",1989-03-03,4,34,8,30
"10656",1989-03-04,0,51,0,51
"10657",1989-03-05,-10,92,0,102
"10658",1989-03-06,-10,80,0,90
"10659",1989-03-07,2,88,0,86
"10660",1989-03-08,-21,119,0,140
"10661",1989-03-09,-1,153,0,154
"10662",1989-03-10,2,177,0,175
"10663",1989-03-11,26,188,0,162
"10664",1989-03-12,67,198,0,131
"10665",1989-03-13,101,207,0,106
"10666",1989-03-14,40,210,0,170
"10667",1989-03-15,47,207,0,160
"10668",1989-03-16,75,137,0,62
"10669",1989-03-17,39,97,4,58
"10670",1989-03-18,32,117,1,85
"10671",1989-03-19,14,138,0,124
"10672",1989-03-20,47,120,0,73
"10673",1989-03-21,-3,145,0,148
"10674",1989-03-22,40,109,0,69
"10675",1989-03-23,19,83,54,64
"10676",1989-03-24,5,93,0,88
"10677",1989-03-25,-18,145,0,163
"10678",1989-03-26,20,198,0,178
"10679",1989-03-27,55,157,0,102
"10680",1989-03-28,-9,192,0,201
"10681",1989-03-29,22,219,0,197
"10682",1989-03-30,125,232,0,107
"10683",1989-03-31,97,255,0,158
"10684",1989-04-01,146,212,0,66
"10685",1989-04-02,67,186,6,119
"10686",1989-04-03,90,235,0,145
"10687",1989-04-04,107,194,0,87
"10688",1989-04-05,45,237,0,192
"10689",1989-04-06,75,227,0,152
"10690",1989-04-07,90,210,0,120
"10691",1989-04-08,62,218,0,156
"10692",1989-04-09,73,206,0,133
"10693",1989-04-10,63,187,0,124
"10694",1989-04-11,48,206,0,158
"10695",1989-04-12,95,163,0,68
"10696",1989-04-13,102,187,0,85
"10697",1989-04-14,56,191,0,135
"10698",1989-04-15,107,196,0,89
"10699",1989-04-16,67,264,5,197
"10700",1989-04-17,127,265,5,138
"10701",1989-04-18,124,284,0,160
"10702",1989-04-19,117,264,0,147
"10703",1989-04-20,179,222,0,43
"10704",1989-04-21,173,198,0,25
"10705",1989-04-22,132,209,0,77
"10706",1989-04-23,101,224,0,123
"10707",1989-04-24,67,263,0,196
"10708",1989-04-25,140,289,0,149
"10709",1989-04-26,127,257,0,130
"10710",1989-04-27,144,194,0,50
"10711",1989-04-28,103,155,16,52
"10712",1989-04-29,109,144,35,35
"10713",1989-04-30,113,191,3,78
"10714",1989-05-01,83,226,0,143
"10715",1989-05-02,103,227,0,124
"10716",1989-05-03,137,241,0,104
"10717",1989-05-04,152,246,0,94
"10718",1989-05-05,119,262,0,143
"10719",1989-05-06,143,280,13,137
"10720",1989-05-07,159,277,0,118
"10721",1989-05-08,172,309,0,137
"10722",1989-05-09,168,255,0,87
"10723",1989-05-10,130,215,270,85
"10724",1989-05-11,110,242,0,132
"10725",1989-05-12,144,224,84,80
"10726",1989-05-13,82,225,0,143
"10727",1989-05-14,110,247,0,137
"10728",1989-05-15,138,257,0,119
"10729",1989-05-16,124,302,0,178
"10730",1989-05-17,147,299,0,152
"10731",1989-05-18,175,314,0,139
"10732",1989-05-19,195,257,0,62
"10733",1989-05-20,151,261,0,110
"10734",1989-05-21,185,278,0,93
"10735",1989-05-22,182,287,0,105
"10736",1989-05-23,132,354,0,222
"10737",1989-05-24,128,261,16,133
"10738",1989-05-25,107,311,0,204
"10739",1989-05-26,122,292,0,170
"10740",1989-05-27,143,265,0,122
"10741",1989-05-28,178,279,4,101
"10742",1989-05-29,155,312,0,157
"10743",1989-05-30,159,314,0,155
"10744",1989-05-31,172,335,0,163
"10745",1989-06-01,190,374,0,184
"10746",1989-06-02,208,368,0,160
"10747",1989-06-03,205,306,41,101
"10748",1989-06-04,188,297,111,109
"10749",1989-06-05,205,342,0,137
"10750",1989-06-06,209,293,1,84
"10751",1989-06-07,170,242,225,72
"10752",1989-06-08,178,295,4,117
"10753",1989-06-09,196,304,0,108
"10754",1989-06-10,185,286,0,101
"10755",1989-06-11,164,248,0,84
"10756",1989-06-12,208,238,8,30
"10757",1989-06-13,174,210,86,36
"10758",1989-06-14,158,326,21,168
"10759",1989-06-15,228,280,0,52
"10760",1989-06-16,207,328,0,121
"10761",1989-06-17,177,303,0,126
"10762",1989-06-18,170,313,0,143
"10763",1989-06-19,210,301,1,91
"10764",1989-06-20,220,268,0,48
"10765",1989-06-21,187,279,4,92
"10766",1989-06-22,160,311,0,151
"10767",1989-06-23,177,315,0,138
"10768",1989-06-24,173,350,0,177
"10769",1989-06-25,247,325,0,78
"10770",1989-06-26,233,327,0,94
"10771",1989-06-27,193,361,0,168
"10772",1989-06-28,223,363,0,140
"10773",1989-06-29,210,349,0,139
"10774",1989-06-30,212,337,0,125
"10775",1989-07-01,211,325,3,114
"10776",1989-07-02,186,329,0,143
"10777",1989-07-03,211,321,0,110
"10778",1989-07-04,185,309,0,124
"10779",1989-07-05,199,264,290,65
"10780",1989-07-06,195,216,131,21
"10781",1989-07-07,204,229,130,25
"10782",1989-07-08,205,295,0,90
"10783",1989-07-09,226,281,0,55
"10784",1989-07-10,203,257,415,54
"10785",1989-07-11,207,271,75,64
"10786",1989-07-12,207,304,0,97
"10787",1989-07-13,212,305,0,93
"10788",1989-07-14,224,297,0,73
"10789",1989-07-15,234,316,0,82
"10790",1989-07-16,238,341,0,103
"10791",1989-07-17,268,364,0,96
"10792",1989-07-18,263,343,0,80
"10793",1989-07-19,255,362,0,107
"10794",1989-07-20,256,346,0,90
"10795",1989-07-21,272,349,0,77
"10796",1989-07-22,253,316,0,63
"10797",1989-07-23,262,319,5,57
"10798",1989-07-24,250,292,512,42
"10799",1989-07-25,244,324,0,80
"10800",1989-07-26,227,284,0,57
"10801",1989-07-27,188,281,0,93
"10802",1989-07-28,182,300,0,118
"10803",1989-07-29,198,296,0,98
"10804",1989-07-30,195,250,6,55
"10805",1989-07-31,187,238,156,51
"10806",1989-08-01,210,290,2,80
"10807",1989-08-02,236,301,0,65
"10808",1989-08-03,230,297,0,67
"10809",1989-08-04,220,274,5,54
"10810",1989-08-05,219,256,132,37
"10811",1989-08-06,226,296,114,70
"10812",1989-08-07,230,313,0,83
"10813",1989-08-08,209,294,0,85
"10814",1989-08-09,223,320,0,97
"10815",1989-08-10,254,332,0,78
"10816",1989-08-11,233,365,46,132
"10817",1989-08-12,235,266,16,31
"10818",1989-08-13,206,303,0,97
"10819",1989-08-14,232,292,0,60
"10820",1989-08-15,212,286,25,74
"10821",1989-08-16,194,258,52,64
"10822",1989-08-17,186,233,73,47
"10823",1989-08-18,202,266,0,64
"10824",1989-08-19,198,245,62,47
"10825",1989-08-20,177,273,0,96
"10826",1989-08-21,180,258,0,78
"10827",1989-08-22,155,269,0,114
"10828",1989-08-23,174,275,0,101
"10829",1989-08-24,184,285,0,101
"10830",1989-08-25,179,297,0,118
"10831",1989-08-26,197,271,0,74
"10832",1989-08-27,165,315,0,150
"10833",1989-08-28,202,307,0,105
"10834",1989-08-29,186,301,0,115
"10835",1989-08-30,217,300,0,83
"10836",1989-08-31,217,317,0,100
"10837",1989-09-01,206,286,0,80
"10838",1989-09-02,197,290,0,93
"10839",1989-09-03,143,285,0,142
"10840",1989-09-04,183,238,12,55
"10841",1989-09-05,144,278,0,134
"10842",1989-09-06,156,286,0,130
"10843",1989-09-07,160,285,0,125
"10844",1989-09-08,204,269,16,65
"10845",1989-09-09,198,264,0,66
"10846",1989-09-10,185,270,19,85
"10847",1989-09-11,202,323,0,121
"10848",1989-09-12,162,305,0,143
"10849",1989-09-13,157,299,0,142
"10850",1989-09-14,170,315,0,145
"10851",1989-09-15,192,279,0,87
"10852",1989-09-16,185,237,2,52
"10853",1989-09-17,138,318,0,180
"10854",1989-09-18,151,340,0,189
"10855",1989-09-19,150,245,0,95
"10856",1989-09-20,144,218,0,74
"10857",1989-09-21,162,265,0,103
"10858",1989-09-22,157,274,0,117
"10859",1989-09-23,177,263,0,86
"10860",1989-09-24,197,241,0,44
"10861",1989-09-25,116,202,275,86
"10862",1989-09-26,115,178,24,63
"10863",1989-09-27,150,228,0,78
"10864",1989-09-28,147,247,0,100
"10865",1989-09-29,112,248,0,136
"10866",1989-09-30,120,268,0,148
"10867",1989-10-01,123,261,0,138
"10868",1989-10-02,154,269,0,115
"10869",1989-10-03,105,261,0,156
"10870",1989-10-04,131,247,0,116
"10871",1989-10-05,157,208,8,51
"10872",1989-10-06,107,211,0,104
"10873",1989-10-07,83,241,0,158
"10874",1989-10-08,115,212,0,97
"10875",1989-10-09,99,247,0,148
"10876",1989-10-10,113,272,0,159
"10877",1989-10-11,77,262,0,185
"10878",1989-10-12,86,245,0,159
"10879",1989-10-13,90,268,0,178
"10880",1989-10-14,141,205,44,64
"10881",1989-10-15,115,192,0,77
"10882",1989-10-16,83,162,0,79
"10883",1989-10-17,24,165,0,141
"10884",1989-10-18,93,188,0,95
"10885",1989-10-19,118,220,0,102
"10886",1989-10-20,32,250,0,218
"10887",1989-10-21,65,275,0,210
"10888",1989-10-22,68,271,0,203
"10889",1989-10-23,73,256,0,183
"10890",1989-10-24,88,274,0,186
"10891",1989-10-25,106,259,0,153
"10892",1989-10-26,143,197,0,54
"10893",1989-10-27,137,215,0,78
"10894",1989-10-28,88,238,0,150
"10895",1989-10-29,77,234,0,157
"10896",1989-10-30,107,227,0,120
"10897",1989-10-31,67,198,0,131
"10898",1989-11-01,40,203,0,163
"10899",1989-11-02,103,147,32,44
"10900",1989-11-03,108,140,37,32
"10901",1989-11-04,115,152,1,37
"10902",1989-11-05,103,134,88,31
"10903",1989-11-06,104,139,0,35
"10904",1989-11-07,84,115,124,31
"10905",1989-11-08,64,125,0,61
"10906",1989-11-09,15,140,0,125
"10907",1989-11-10,52,85,0,33
"10908",1989-11-11,45,88,0,43
"10909",1989-11-12,66,123,7,57
"10910",1989-11-13,15,71,0,56
"10911",1989-11-14,-22,80,0,102
"10912",1989-11-15,-16,90,0,106
"10913",1989-11-16,-18,163,0,181
"10914",1989-11-17,16,148,0,132
"10915",1989-11-18,-40,97,0,137
"10916",1989-11-19,-11,93,0,104
"10917",1989-11-20,-39,152,0,191
"10918",1989-11-21,64,167,0,103
"10919",1989-11-22,2,177,0,175
"10920",1989-11-23,4,130,0,126
"10921",1989-11-24,49,125,0,76
"10922",1989-11-25,-5,153,0,158
"10923",1989-11-26,68,136,0,68
"10924",1989-11-27,48,120,0,72
"10925",1989-11-28,-38,99,0,137
"10926",1989-11-29,-52,111,0,163
"10927",1989-11-30,-45,141,0,186
"10928",1989-12-01,-27,165,0,192
"10929",1989-12-02,29,227,0,198
"10930",1989-12-03,9,238,0,229
"10931",1989-12-04,70,157,0,87
"10932",1989-12-05,5,157,0,152
"10933",1989-12-06,37,84,0,47
"10934",1989-12-07,-16,83,0,99
"10935",1989-12-08,-39,105,0,144
"10936",1989-12-09,-13,73,0,86
"10937",1989-12-10,31,107,0,76
"10938",1989-12-11,33,97,0,64
"10939",1989-12-12,0,54,116,54
"10940",1989-12-13,-25,96,5,121
"10941",1989-12-14,-26,76,0,102
"10942",1989-12-15,-8,132,0,140
"10943",1989-12-16,24,82,0,58
"10944",1989-12-17,-27,36,0,63
"10945",1989-12-18,-20,9,3,29
"10946",1989-12-19,-28,-16,33,12
"10947",1989-12-20,-32,14,7,46
"10948",1989-12-21,-37,-2,112,35
"10949",1989-12-22,-48,1,18,49
"10950",1989-12-23,-36,6,19,42
"10951",1989-12-24,-8,33,0,41
"10952",1989-12-25,-51,10,0,61
"10953",1989-12-26,-35,60,0,95
"10954",1989-12-27,-22,2,0,24
"10955",1989-12-28,-30,32,0,62
"10956",1989-12-29,-31,12,0,43
"10957",1989-12-30,-21,17,0,38
"10958",1989-12-31,-16,39,0,55
"10959",1990-01-01,2,26,0,24
"10960",1990-01-02,-20,20,0,40
"10961",1990-01-03,-24,26,0,50
"10962",1990-01-04,-29,84,0,113
"10963",1990-01-05,-22,59,0,81
"10964",1990-01-06,-67,65,0,132
"10965",1990-01-07,-35,38,0,73
"10966",1990-01-08,-2,38,0,40
"10967",1990-01-09,0,90,37,90
"10968",1990-01-10,-7,17,0,24
"10969",1990-01-11,-9,50,0,59
"10970",1990-01-12,-19,27,0,46
"10971",1990-01-13,-58,17,0,75
"10972",1990-01-14,-35,20,0,55
"10973",1990-01-15,-22,66,0,88
"10974",1990-01-16,-61,80,0,141
"10975",1990-01-17,-13,72,0,85
"10976",1990-01-18,-27,44,0,71
"10977",1990-01-19,-39,13,0,52
"10978",1990-01-20,-85,44,0,129
"10979",1990-01-21,-63,73,0,136
"10980",1990-01-22,-35,38,0,73
"10981",1990-01-23,-65,42,0,107
"10982",1990-01-24,-77,-12,1,65
"10983",1990-01-25,-65,-17,1,48
"10984",1990-01-26,-47,9,0,56
"10985",1990-01-27,-30,-12,35,18
"10986",1990-01-28,-45,6,101,51
"10987",1990-01-29,-68,-19,0,49
"10988",1990-01-30,-107,-37,68,70
"10989",1990-01-31,-163,-20,0,143
"10990",1990-02-01,-179,7,0,186
"10991",1990-02-02,-55,20,0,75
"10992",1990-02-03,-55,6,0,61
"10993",1990-02-04,-132,14,0,146
"10994",1990-02-05,-83,42,0,125
"10995",1990-02-06,-56,12,0,68
"10996",1990-02-07,-15,29,6,44
"10997",1990-02-08,-56,46,0,102
"10998",1990-02-09,8,24,37,16
"10999",1990-02-10,-7,118,0,125
"11000",1990-02-11,8,165,0,157
"11001",1990-02-12,8,112,0,104
"11002",1990-02-13,36,73,8,37
"11003",1990-02-14,32,60,2,28
"11004",1990-02-15,38,72,0,34
"11005",1990-02-16,31,58,71,27
"11006",1990-02-17,9,36,227,27
"11007",1990-02-18,2,83,130,81
"11008",1990-02-19,-15,90,0,105
"11009",1990-02-20,45,64,72,19
"11010",1990-02-21,23,50,95,27
"11011",1990-02-22,29,62,3,33
"11012",1990-02-23,2,39,1,37
"11013",1990-02-24,-10,42,0,52
"11014",1990-02-25,-28,67,0,95
"11015",1990-02-26,-29,69,0,98
"11016",1990-02-27,-21,58,0,79
"11017",1990-02-28,0,69,0,69
"11018",1990-03-01,-33,103,0,136
"11019",1990-03-02,1,117,0,116
"11020",1990-03-03,-3,138,0,141
"11021",1990-03-04,8,97,0,89
"11022",1990-03-05,-27,144,0,171
"11023",1990-03-06,18,176,0,158
"11024",1990-03-07,-5,170,0,175
"11025",1990-03-08,25,152,55,127
"11026",1990-03-09,12,189,0,177
"11027",1990-03-10,55,194,0,139
"11028",1990-03-11,93,183,0,90
"11029",1990-03-12,-1,158,0,159
"11030",1990-03-13,78,152,0,74
"11031",1990-03-14,64,188,0,124
"11032",1990-03-15,44,158,0,114
"11033",1990-03-16,52,193,0,141
"11034",1990-03-17,60,170,0,110
"11035",1990-03-18,27,187,0,160
"11036",1990-03-19,83,232,0,149
"11037",1990-03-20,83,170,0,87
"11038",1990-03-21,25,83,304,58
"11039",1990-03-22,25,54,60,29
"11040",1990-03-23,40,82,21,42
"11041",1990-03-24,50,80,23,30
"11042",1990-03-25,15,60,96,45
"11043",1990-03-26,8,29,310,21
"11044",1990-03-27,24,42,80,18
"11045",1990-03-28,32,87,10,55
"11046",1990-03-29,58,125,0,67
"11047",1990-03-30,88,186,0,98
"11048",1990-03-31,58,203,0,145
"11049",1990-04-01,63,233,0,170
"11050",1990-04-02,93,212,2,119
"11051",1990-04-03,53,170,96,117
"11052",1990-04-04,12,155,0,143
"11053",1990-04-05,13,198,0,185
"11054",1990-04-06,126,218,0,92
"11055",1990-04-07,109,197,0,88
"11056",1990-04-08,62,239,0,177
"11057",1990-04-09,101,235,0,134
"11058",1990-04-10,70,189,0,119
"11059",1990-04-11,123,170,1,47
"11060",1990-04-12,84,134,54,50
"11061",1990-04-13,63,192,0,129
"11062",1990-04-14,53,216,0,163
"11063",1990-04-15,67,232,0,165
"11064",1990-04-16,78,234,0,156
"11065",1990-04-17,90,211,0,121
"11066",1990-04-18,102,207,0,105
"11067",1990-04-19,125,246,8,121
"11068",1990-04-20,130,210,0,80
"11069",1990-04-21,104,179,60,75
"11070",1990-04-22,75,235,2,160
"11071",1990-04-23,80,188,0,108
"11072",1990-04-24,27,214,0,187
"11073",1990-04-25,108,256,0,148
"11074",1990-04-26,112,240,0,128
"11075",1990-04-27,168,232,0,64
"11076",1990-04-28,144,211,0,67
"11077",1990-04-29,140,184,34,44
"11078",1990-04-30,120,163,137,43
"11079",1990-05-01,113,207,62,94
"11080",1990-05-02,114,165,0,51
"11081",1990-05-03,116,200,0,84
"11082",1990-05-04,78,245,0,167
"11083",1990-05-05,107,274,0,167
"11084",1990-05-06,186,288,0,102
"11085",1990-05-07,110,298,0,188
"11086",1990-05-08,137,310,0,173
"11087",1990-05-09,174,311,0,137
"11088",1990-05-10,209,281,0,72
"11089",1990-05-11,140,300,0,160
"11090",1990-05-12,178,325,0,147
"11091",1990-05-13,163,281,0,118
"11092",1990-05-14,124,271,0,147
"11093",1990-05-15,154,215,26,61
"11094",1990-05-16,121,159,512,38
"11095",1990-05-17,115,192,5,77
"11096",1990-05-18,108,313,0,205
"11097",1990-05-19,185,284,0,99
"11098",1990-05-20,157,250,0,93
"11099",1990-05-21,118,222,0,104
"11100",1990-05-22,150,242,0,92
"11101",1990-05-23,143,256,0,113
"11102",1990-05-24,124,271,0,147
"11103",1990-05-25,144,290,0,146
"11104",1990-05-26,175,291,0,116
"11105",1990-05-27,172,315,0,143
"11106",1990-05-28,177,305,0,128
"11107",1990-05-29,195,291,24,96
"11108",1990-05-30,179,262,29,83
"11109",1990-05-31,156,277,0,121
"11110",1990-06-01,138,310,0,172
"11111",1990-06-02,157,340,0,183
"11112",1990-06-03,180,344,0,164
"11113",1990-06-04,183,372,0,189
"11114",1990-06-05,194,365,0,171
"11115",1990-06-06,190,316,0,126
"11116",1990-06-07,167,283,364,116
"11117",1990-06-08,162,298,1,136
"11118",1990-06-09,157,362,0,205
"11119",1990-06-10,182,294,0,112
"11120",1990-06-11,198,283,36,85
"11121",1990-06-12,183,333,0,150
"11122",1990-06-13,223,357,0,134
"11123",1990-06-14,223,296,31,73
"11124",1990-06-15,180,313,0,133
"11125",1990-06-16,193,316,0,123
"11126",1990-06-17,223,299,21,76
"11127",1990-06-18,198,240,350,42
"11128",1990-06-19,188,230,74,42
"11129",1990-06-20,183,257,56,74
"11130",1990-06-21,182,333,0,151
"11131",1990-06-22,208,333,0,125
"11132",1990-06-23,228,313,22,85
"11133",1990-06-24,218,269,263,51
"11134",1990-06-25,211,243,228,32
"11135",1990-06-26,212,281,0,69
"11136",1990-06-27,207,323,0,116
"11137",1990-06-28,197,321,364,124
"11138",1990-06-29,253,324,0,71
"11139",1990-06-30,225,294,0,69
"11140",1990-07-01,222,250,0,28
"11141",1990-07-02,202,275,2,73
"11142",1990-07-03,198,308,2,110
"11143",1990-07-04,217,318,0,101
"11144",1990-07-05,233,332,0,99
"11145",1990-07-06,264,342,17,78
"11146",1990-07-07,226,326,57,100
"11147",1990-07-08,194,372,0,178
"11148",1990-07-09,261,363,0,102
"11149",1990-07-10,223,323,36,100
"11150",1990-07-11,224,307,138,83
"11151",1990-07-12,233,330,85,97
"11152",1990-07-13,255,348,0,93
"11153",1990-07-14,259,380,0,121
"11154",1990-07-15,274,368,0,94
"11155",1990-07-16,247,353,14,106
"11156",1990-07-17,232,310,93,78
"11157",1990-07-18,200,324,0,124
"11158",1990-07-19,235,298,0,63
"11159",1990-07-20,231,271,25,40
"11160",1990-07-21,224,285,301,61
"11161",1990-07-22,237,331,0,94
"11162",1990-07-23,259,341,0,82
"11163",1990-07-24,261,366,0,105
"11164",1990-07-25,242,317,45,75
"11165",1990-07-26,233,295,0,62
"11166",1990-07-27,240,304,1,64
"11167",1990-07-28,226,325,140,99
"11168",1990-07-29,233,299,14,66
"11169",1990-07-30,239,302,42,63
"11170",1990-07-31,247,321,0,74
"11171",1990-08-01,238,330,0,92
"11172",1990-08-02,243,297,0,54
"11173",1990-08-03,218,301,0,83
"11174",1990-08-04,209,320,0,111
"11175",1990-08-05,217,316,0,99
"11176",1990-08-06,226,306,66,80
"11177",1990-08-07,210,319,0,109
"11178",1990-08-08,230,303,1,73
"11179",1990-08-09,188,299,0,111
"11180",1990-08-10,204,321,0,117
"11181",1990-08-11,241,329,0,88
"11182",1990-08-12,251,335,0,84
"11183",1990-08-13,244,311,4,67
"11184",1990-08-14,221,260,30,39
"11185",1990-08-15,216,238,221,22
"11186",1990-08-16,192,247,161,55
"11187",1990-08-17,200,267,0,67
"11188",1990-08-18,216,296,0,80
"11189",1990-08-19,198,315,0,117
"11190",1990-08-20,195,318,0,123
"11191",1990-08-21,204,337,0,133
"11192",1990-08-22,206,351,0,145
"11193",1990-08-23,212,334,0,122
"11194",1990-08-24,213,332,0,119
"11195",1990-08-25,204,310,4,106
"11196",1990-08-26,235,295,476,60
"11197",1990-08-27,215,277,239,62
"11198",1990-08-28,228,321,0,93
"11199",1990-08-29,227,322,0,95
"11200",1990-08-30,222,322,0,100
"11201",1990-08-31,203,312,0,109
"11202",1990-09-01,205,304,0,99
"11203",1990-09-02,175,331,0,156
"11204",1990-09-03,195,320,0,125
"11205",1990-09-04,205,259,7,54
"11206",1990-09-05,201,272,0,71
"11207",1990-09-06,202,279,0,77
"11208",1990-09-07,225,284,0,59
"11209",1990-09-08,205,296,0,91
"11210",1990-09-09,173,210,46,37
"11211",1990-09-10,178,253,1,75
"11212",1990-09-11,174,288,0,114
"11213",1990-09-12,183,272,0,89
"11214",1990-09-13,193,285,0,92
"11215",1990-09-14,168,285,0,117
"11216",1990-09-15,162,298,0,136
"11217",1990-09-16,176,300,0,124
"11218",1990-09-17,113,271,0,158
"11219",1990-09-18,102,274,0,172
"11220",1990-09-19,132,297,0,165
"11221",1990-09-20,143,311,0,168
"11222",1990-09-21,159,276,0,117
"11223",1990-09-22,177,228,203,51
"11224",1990-09-23,169,240,294,71
"11225",1990-09-24,149,252,0,103
"11226",1990-09-25,143,262,0,119
"11227",1990-09-26,135,237,0,102
"11228",1990-09-27,167,261,0,94
"11229",1990-09-28,148,262,0,114
"11230",1990-09-29,154,271,0,117
"11231",1990-09-30,160,233,0,73
"11232",1990-10-01,102,239,0,137
"11233",1990-10-02,140,232,0,92
"11234",1990-10-03,120,239,7,119
"11235",1990-10-04,107,276,0,169
"11236",1990-10-05,107,300,0,193
"11237",1990-10-06,117,230,0,113
"11238",1990-10-07,108,245,0,137
"11239",1990-10-08,97,235,0,138
"11240",1990-10-09,122,187,0,65
"11241",1990-10-10,125,172,0,47
"11242",1990-10-11,111,222,0,111
"11243",1990-10-12,117,242,0,125
"11244",1990-10-13,102,266,0,164
"11245",1990-10-14,117,252,0,135
"11246",1990-10-15,96,247,0,151
"11247",1990-10-16,115,243,0,128
"11248",1990-10-17,139,197,2,58
"11249",1990-10-18,128,205,0,77
"11250",1990-10-19,79,220,0,141
"11251",1990-10-20,117,218,0,101
"11252",1990-10-21,120,192,0,72
"11253",1990-10-22,134,217,0,83
"11254",1990-10-23,134,231,0,97
"11255",1990-10-24,96,180,0,84
"11256",1990-10-25,17,210,0,193
"11257",1990-10-26,36,225,0,189
"11258",1990-10-27,25,230,0,205
"11259",1990-10-28,36,237,0,201
"11260",1990-10-29,50,238,0,188
"11261",1990-10-30,71,244,0,173
"11262",1990-10-31,93,256,0,163
"11263",1990-11-01,95,193,0,98
"11264",1990-11-02,91,144,0,53
"11265",1990-11-03,88,178,0,90
"11266",1990-11-04,65,208,0,143
"11267",1990-11-05,78,194,0,116
"11268",1990-11-06,100,213,0,113
"11269",1990-11-07,102,162,46,60
"11270",1990-11-08,92,115,222,23
"11271",1990-11-09,46,127,2,81
"11272",1990-11-10,8,160,0,152
"11273",1990-11-11,15,205,0,190
"11274",1990-11-12,42,227,0,185
"11275",1990-11-13,42,233,0,191
"11276",1990-11-14,65,260,0,195
"11277",1990-11-15,74,126,0,52
"11278",1990-11-16,29,130,0,101
"11279",1990-11-17,97,125,0,28
"11280",1990-11-18,85,113,152,28
"11281",1990-11-19,85,168,42,83
"11282",1990-11-20,6,118,0,112
"11283",1990-11-21,-36,100,0,136
"11284",1990-11-22,-17,130,0,147
"11285",1990-11-23,25,86,0,61
"11286",1990-11-24,50,160,0,110
"11287",1990-11-25,12,178,0,166
"11288",1990-11-26,40,188,0,148
"11289",1990-11-27,5,181,0,176
"11290",1990-11-28,25,168,0,143
"11291",1990-11-29,32,89,0,57
"11292",1990-11-30,-13,80,0,93
"11293",1990-12-01,-35,45,0,80
"11294",1990-12-02,-50,73,0,123
"11295",1990-12-03,-54,117,0,171
"11296",1990-12-04,-33,155,0,188
"11297",1990-12-05,-22,168,0,190
"11298",1990-12-06,-25,201,0,226
"11299",1990-12-07,-16,153,0,169
"11300",1990-12-08,-26,163,0,189
"11301",1990-12-09,-28,194,0,222
"11302",1990-12-10,-7,88,0,95
"11303",1990-12-11,-42,4,12,46
"11304",1990-12-12,-34,22,20,56
"11305",1990-12-13,-20,106,0,126
"11306",1990-12-14,-30,54,0,84
"11307",1990-12-15,-7,83,0,90
"11308",1990-12-16,-20,32,0,52
"11309",1990-12-17,-2,86,0,88
"11310",1990-12-18,-54,81,0,135
"11311",1990-12-19,-38,88,0,126
"11312",1990-12-20,5,158,0,153
"11313",1990-12-21,8,125,0,117
"11314",1990-12-22,-3,114,0,117
"11315",1990-12-23,-55,132,0,187
"11316",1990-12-24,-19,82,0,101
"11317",1990-12-25,-20,62,0,82
"11318",1990-12-26,-74,48,0,122
"11319",1990-12-27,-23,23,0,46
"11320",1990-12-28,-80,27,0,107
"11321",1990-12-29,-31,3,0,34
"11322",1990-12-30,-8,15,18,23
"11323",1990-12-31,0,54,0,54
"11324",1991-01-01,-17,48,0,65
"11325",1991-01-02,-57,42,0,99
"11326",1991-01-03,-49,24,0,73
"11327",1991-01-04,-54,24,0,78
"11328",1991-01-05,-89,-7,0,82
"11329",1991-01-06,-17,-5,5,12
"11330",1991-01-07,-79,22,0,101
"11331",1991-01-08,-96,17,0,113
"11332",1991-01-09,-63,62,0,125
"11333",1991-01-10,-35,9,2,44
"11334",1991-01-11,-69,95,0,164
"11335",1991-01-12,-37,73,0,110
"11336",1991-01-13,-68,68,0,136
"11337",1991-01-14,-15,98,0,113
"11338",1991-01-15,-52,157,0,209
"11339",1991-01-16,-12,141,0,153
"11340",1991-01-17,-50,100,0,150
"11341",1991-01-18,-61,80,0,141
"11342",1991-01-19,-33,74,0,107
"11343",1991-01-20,-18,57,2,75
"11344",1991-01-21,21,50,48,29
"11345",1991-01-22,-3,30,0,33
"11346",1991-01-23,-18,24,0,42
"11347",1991-01-24,-27,87,0,114
"11348",1991-01-25,-37,117,0,154
"11349",1991-01-26,-37,84,0,121
"11350",1991-01-27,-15,61,0,76
"11351",1991-01-28,0,45,17,45
"11352",1991-01-29,2,33,2,31
"11353",1991-01-30,-2,38,0,40
"11354",1991-01-31,-38,68,0,106
"11355",1991-02-01,-39,73,0,112
"11356",1991-02-02,-37,96,0,133
"11357",1991-02-03,-11,120,0,131
"11358",1991-02-04,-60,112,0,172
"11359",1991-02-05,-38,97,0,135
"11360",1991-02-06,7,130,0,123
"11361",1991-02-07,-12,137,0,149
"11362",1991-02-08,20,67,7,47
"11363",1991-02-09,37,88,12,51
"11364",1991-02-10,34,142,0,108
"11365",1991-02-11,-23,77,0,100
"11366",1991-02-12,-10,53,19,63
"11367",1991-02-13,12,46,32,34
"11368",1991-02-14,29,86,3,57
"11369",1991-02-15,-7,115,0,122
"11370",1991-02-16,26,70,0,44
"11371",1991-02-17,-13,92,0,105
"11372",1991-02-18,8,88,0,80
"11373",1991-02-19,-19,55,0,74
"11374",1991-02-20,-10,102,0,112
"11375",1991-02-21,8,129,0,121
"11376",1991-02-22,6,95,0,89
"11377",1991-02-23,-60,72,0,132
"11378",1991-02-24,-43,75,0,118
"11379",1991-02-25,-32,68,0,100
"11380",1991-02-26,-22,60,23,82
"11381",1991-02-27,3,73,0,70
"11382",1991-02-28,-10,65,20,75
"11383",1991-03-01,-31,83,0,114
"11384",1991-03-02,-20,153,0,173
"11385",1991-03-03,-23,138,0,161
"11386",1991-03-04,16,164,0,148
"11387",1991-03-05,35,180,0,145
"11388",1991-03-06,67,128,69,61
"11389",1991-03-07,-24,74,223,98
"11390",1991-03-08,-30,35,5,65
"11391",1991-03-09,-17,23,0,40
"11392",1991-03-10,-5,22,32,27
"11393",1991-03-11,-15,89,0,104
"11394",1991-03-12,28,100,0,72
"11395",1991-03-13,0,64,0,64
"11396",1991-03-14,-7,3,10,10
"11397",1991-03-15,-7,133,19,140
"11398",1991-03-16,29,132,0,103
"11399",1991-03-17,17,187,0,170
"11400",1991-03-18,69,230,0,161
"11401",1991-03-19,84,242,0,158
"11402",1991-03-20,50,185,1,135
"11403",1991-03-21,17,53,18,36
"11404",1991-03-22,-24,135,0,159
"11405",1991-03-23,19,165,0,146
"11406",1991-03-24,54,134,36,80
"11407",1991-03-25,60,91,2,31
"11408",1991-03-26,0,83,225,83
"11409",1991-03-27,-7,78,0,85
"11410",1991-03-28,-4,85,0,89
"11411",1991-03-29,52,123,0,71
"11412",1991-03-30,21,98,9,77
"11413",1991-03-31,5,117,0,112
"11414",1991-04-01,-13,151,0,164
"11415",1991-04-02,5,187,0,182
"11416",1991-04-03,41,177,0,136
"11417",1991-04-04,50,203,0,153
"11418",1991-04-05,67,207,0,140
"11419",1991-04-06,74,210,0,136
"11420",1991-04-07,99,230,0,131
"11421",1991-04-08,132,192,0,60
"11422",1991-04-09,122,213,0,91
"11423",1991-04-10,118,195,0,77
"11424",1991-04-11,101,155,23,54
"11425",1991-04-12,79,117,79,38
"11426",1991-04-13,31,192,0,161
"11427",1991-04-14,79,205,0,126
"11428",1991-04-15,116,192,0,76
"11429",1991-04-16,91,165,31,74
"11430",1991-04-17,84,146,68,62
"11431",1991-04-18,76,155,0,79
"11432",1991-04-19,78,214,0,136
"11433",1991-04-20,57,213,0,156
"11434",1991-04-21,85,227,0,142
"11435",1991-04-22,114,246,0,132
"11436",1991-04-23,105,271,0,166
"11437",1991-04-24,134,289,0,155
"11438",1991-04-25,109,242,0,133
"11439",1991-04-26,25,185,0,160
"11440",1991-04-27,72,248,0,176
"11441",1991-04-28,141,212,14,71
"11442",1991-04-29,103,257,0,154
"11443",1991-04-30,92,252,0,160
"11444",1991-05-01,107,210,0,103
"11445",1991-05-02,71,235,0,164
"11446",1991-05-03,120,236,0,116
"11447",1991-05-04,92,163,84,71
"11448",1991-05-05,93,133,116,40
"11449",1991-05-06,57,189,2,132
"11450",1991-05-07,111,224,6,113
"11451",1991-05-08,139,268,0,129
"11452",1991-05-09,108,298,0,190
"11453",1991-05-10,130,284,0,154
"11454",1991-05-11,149,295,0,146
"11455",1991-05-12,126,310,0,184
"11456",1991-05-13,158,300,0,142
"11457",1991-05-14,168,313,0,145
"11458",1991-05-15,158,294,0,136
"11459",1991-05-16,135,312,0,177
"11460",1991-05-17,142,330,0,188
"11461",1991-05-18,182,260,7,78
"11462",1991-05-19,165,207,130,42
"11463",1991-05-20,181,289,0,108
"11464",1991-05-21,191,292,0,101
"11465",1991-05-22,186,286,0,100
"11466",1991-05-23,166,250,0,84
"11467",1991-05-24,166,210,231,44
"11468",1991-05-25,128,182,153,54
"11469",1991-05-26,110,205,0,95
"11470",1991-05-27,132,223,0,91
"11471",1991-05-28,149,210,0,61
"11472",1991-05-29,166,195,64,29
"11473",1991-05-30,159,232,41,73
"11474",1991-05-31,145,200,83,55
"11475",1991-06-01,149,189,149,40
"11476",1991-06-02,158,234,65,76
"11477",1991-06-03,183,293,0,110
"11478",1991-06-04,196,272,0,76
"11479",1991-06-05,191,286,0,95
"11480",1991-06-06,181,302,0,121
"11481",1991-06-07,196,324,0,128
"11482",1991-06-08,210,325,0,115
"11483",1991-06-09,221,305,0,84
"11484",1991-06-10,214,322,148,108
"11485",1991-06-11,206,341,0,135
"11486",1991-06-12,212,289,0,77
"11487",1991-06-13,174,283,0,109
"11488",1991-06-14,186,255,51,69
"11489",1991-06-15,175,290,0,115
"11490",1991-06-16,207,311,0,104
"11491",1991-06-17,205,300,0,95
"11492",1991-06-18,219,297,0,78
"11493",1991-06-19,209,306,0,97
"11494",1991-06-20,194,325,0,131
"11495",1991-06-21,204,350,0,146
"11496",1991-06-22,182,329,0,147
"11497",1991-06-23,198,365,5,167
"11498",1991-06-24,184,284,98,100
"11499",1991-06-25,178,277,108,99
"11500",1991-06-26,203,322,0,119
"11501",1991-06-27,226,344,0,118
"11502",1991-06-28,277,361,0,84
"11503",1991-06-29,233,321,0,88
"11504",1991-06-30,231,347,0,116
"11505",1991-07-01,224,355,0,131
"11506",1991-07-02,220,365,0,145
"11507",1991-07-03,221,324,0,103
"11508",1991-07-04,237,350,0,113
"11509",1991-07-05,226,338,0,112
"11510",1991-07-06,249,302,22,53
"11511",1991-07-07,206,322,0,116
"11512",1991-07-08,219,344,0,125
"11513",1991-07-09,241,339,0,98
"11514",1991-07-10,209,310,0,101
"11515",1991-07-11,226,318,0,92
"11516",1991-07-12,217,334,0,117
"11517",1991-07-13,226,334,0,108
"11518",1991-07-14,264,307,2,43
"11519",1991-07-15,251,338,1,87
"11520",1991-07-16,258,345,10,87
"11521",1991-07-17,241,323,178,82
"11522",1991-07-18,256,330,0,74
"11523",1991-07-19,269,342,4,73
"11524",1991-07-20,242,361,1,119
"11525",1991-07-21,261,330,0,69
"11526",1991-07-22,268,351,0,83
"11527",1991-07-23,258,355,0,97
"11528",1991-07-24,259,356,36,97
"11529",1991-07-25,219,318,297,99
"11530",1991-07-26,241,301,116,60
"11531",1991-07-27,255,292,0,37
"11532",1991-07-28,257,303,0,46
"11533",1991-07-29,228,346,3,118
"11534",1991-07-30,223,335,0,112
"11535",1991-07-31,219,324,0,105
"11536",1991-08-01,202,275,44,73
"11537",1991-08-02,185,276,0,91
"11538",1991-08-03,211,285,2,74
"11539",1991-08-04,203,287,0,84
"11540",1991-08-05,201,313,0,112
"11541",1991-08-06,233,298,1,65
"11542",1991-08-07,197,300,0,103
"11543",1991-08-08,184,326,0,142
"11544",1991-08-09,214,342,0,128
"11545",1991-08-10,217,322,0,105
"11546",1991-08-11,231,333,0,102
"11547",1991-08-12,216,311,0,95
"11548",1991-08-13,207,312,0,105
"11549",1991-08-14,211,319,10,108
"11550",1991-08-15,221,336,0,115
"11551",1991-08-16,233,337,0,104
"11552",1991-08-17,216,315,320,99
"11553",1991-08-18,218,318,22,100
"11554",1991-08-19,233,315,0,82
"11555",1991-08-20,221,325,0,104
"11556",1991-08-21,228,325,0,97
"11557",1991-08-22,201,329,0,128
"11558",1991-08-23,217,317,0,100
"11559",1991-08-24,212,309,22,97
"11560",1991-08-25,208,248,231,40
"11561",1991-08-26,208,272,0,64
"11562",1991-08-27,197,274,0,77
"11563",1991-08-28,186,305,0,119
"11564",1991-08-29,201,254,0,53
"11565",1991-08-30,152,300,0,148
"11566",1991-08-31,162,320,0,158
"11567",1991-09-01,216,286,32,70
"11568",1991-09-02,227,288,325,61
"11569",1991-09-03,203,266,8,63
"11570",1991-09-04,189,292,9,103
"11571",1991-09-05,162,321,0,159
"11572",1991-09-06,177,327,0,150
"11573",1991-09-07,171,323,0,152
"11574",1991-09-08,169,307,0,138
"11575",1991-09-09,175,300,0,125
"11576",1991-09-10,178,257,4,79
"11577",1991-09-11,170,250,20,80
"11578",1991-09-12,176,280,0,104
"11579",1991-09-13,177,272,0,95
"11580",1991-09-14,156,279,0,123
"11581",1991-09-15,178,252,0,74
"11582",1991-09-16,156,258,0,102
"11583",1991-09-17,163,269,0,106
"11584",1991-09-18,166,281,0,115
"11585",1991-09-19,119,281,0,162
"11586",1991-09-20,103,272,0,169
"11587",1991-09-21,113,258,0,145
"11588",1991-09-22,148,253,0,105
"11589",1991-09-23,141,267,0,126
"11590",1991-09-24,158,263,0,105
"11591",1991-09-25,136,264,0,128
"11592",1991-09-26,154,275,0,121
"11593",1991-09-27,150,290,0,140
"11594",1991-09-28,161,291,0,130
"11595",1991-09-29,142,294,0,152
"11596",1991-09-30,131,270,0,139
"11597",1991-10-01,135,278,0,143
"11598",1991-10-02,142,230,0,88
"11599",1991-10-03,115,227,28,112
"11600",1991-10-04,102,216,0,114
"11601",1991-10-05,91,247,0,156
"11602",1991-10-06,94,237,0,143
"11603",1991-10-07,67,255,0,188
"11604",1991-10-08,97,266,0,169
"11605",1991-10-09,103,252,0,149
"11606",1991-10-10,88,245,0,157
"11607",1991-10-11,120,247,0,127
"11608",1991-10-12,101,245,0,144
"11609",1991-10-13,125,254,0,129
"11610",1991-10-14,139,195,0,56
"11611",1991-10-15,148,235,0,87
"11612",1991-10-16,128,232,0,104
"11613",1991-10-17,63,249,0,186
"11614",1991-10-18,110,205,0,95
"11615",1991-10-19,44,176,0,132
"11616",1991-10-20,15,207,0,192
"11617",1991-10-21,79,218,0,139
"11618",1991-10-22,36,193,0,157
"11619",1991-10-23,70,232,0,162
"11620",1991-10-24,89,219,0,130
"11621",1991-10-25,74,261,0,187
"11622",1991-10-26,109,195,0,86
"11623",1991-10-27,48,160,0,112
"11624",1991-10-28,7,204,0,197
"11625",1991-10-29,8,247,0,239
"11626",1991-10-30,90,187,0,97
"11627",1991-10-31,7,217,0,210
"11628",1991-11-01,30,257,0,227
"11629",1991-11-02,77,270,0,193
"11630",1991-11-03,77,163,0,86
"11631",1991-11-04,37,194,0,157
"11632",1991-11-05,85,143,0,58
"11633",1991-11-06,63,136,197,73
"11634",1991-11-07,27,126,14,99
"11635",1991-11-08,1,127,0,126
"11636",1991-11-09,31,131,0,100
"11637",1991-11-10,-15,137,0,152
"11638",1991-11-11,-1,132,0,133
"11639",1991-11-12,-9,162,0,171
"11640",1991-11-13,47,182,0,135
"11641",1991-11-14,8,147,0,139
"11642",1991-11-15,-15,166,0,181
"11643",1991-11-16,-2,183,0,185
"11644",1991-11-17,7,172,0,165
"11645",1991-11-18,-4,187,0,191
"11646",1991-11-19,17,127,0,110
"11647",1991-11-20,-8,134,0,142
"11648",1991-11-21,7,162,0,155
"11649",1991-11-22,9,162,0,153
"11650",1991-11-23,3,136,0,133
"11651",1991-11-24,16,83,0,67
"11652",1991-11-25,-4,91,0,95
"11653",1991-11-26,21,106,0,85
"11654",1991-11-27,13,167,0,154
"11655",1991-11-28,-16,164,0,180
"11656",1991-11-29,1,187,0,186
"11657",1991-11-30,16,98,0,82
"11658",1991-12-01,-24,94,0,118
"11659",1991-12-02,23,154,0,131
"11660",1991-12-03,-26,152,0,178
"11661",1991-12-04,-21,188,0,209
"11662",1991-12-05,-6,195,0,201
"11663",1991-12-06,-12,117,0,129
"11664",1991-12-07,1,73,0,72
"11665",1991-12-08,-22,4,0,26
"11666",1991-12-09,-12,11,0,23
"11667",1991-12-10,-9,112,1,121
"11668",1991-12-11,-25,67,0,92
"11669",1991-12-12,-30,82,0,112
"11670",1991-12-13,-52,161,0,213
"11671",1991-12-14,-20,94,0,114
"11672",1991-12-15,-37,125,0,162
"11673",1991-12-16,-23,25,0,48
"11674",1991-12-17,-22,60,0,82
"11675",1991-12-18,-44,46,0,90
"11676",1991-12-19,-40,39,0,79
"11677",1991-12-20,-29,63,0,92
"11678",1991-12-21,-12,38,0,50
"11679",1991-12-22,-1,19,11,20
"11680",1991-12-23,-3,33,30,36
"11681",1991-12-24,-37,-1,15,36
"11682",1991-12-25,-49,-16,1,33
"11683",1991-12-26,-55,-42,47,13
"11684",1991-12-27,-80,-33,2,47
"11685",1991-12-28,-84,-23,0,61
"11686",1991-12-29,-57,19,0,76
"11687",1991-12-30,-88,29,0,117
"11688",1991-12-31,-74,39,0,113
"11689",1992-01-01,-70,56,0,126
"11690",1992-01-02,-67,30,0,97
"11691",1992-01-03,-60,40,0,100
"11692",1992-01-04,-68,62,0,130
"11693",1992-01-05,-10,27,0,37
"11694",1992-01-06,-42,69,0,111
"11695",1992-01-07,-5,50,0,55
"11696",1992-01-08,-53,71,0,124
"11697",1992-01-09,-69,47,0,116
"11698",1992-01-10,-82,43,0,125
"11699",1992-01-11,-34,91,0,125
"11700",1992-01-12,-39,79,0,118
"11701",1992-01-13,-17,47,0,64
"11702",1992-01-14,-76,63,0,139
"11703",1992-01-15,-64,94,0,158
"11704",1992-01-16,-24,101,0,125
"11705",1992-01-17,-51,58,0,109
"11706",1992-01-18,-81,58,0,139
"11707",1992-01-19,-64,62,0,126
"11708",1992-01-20,-32,92,0,124
"11709",1992-01-21,13,106,0,93
"11710",1992-01-22,-62,87,0,149
"11711",1992-01-23,-46,74,0,120
"11712",1992-01-24,-55,126,0,181
"11713",1992-01-25,-53,92,0,145
"11714",1992-01-26,-45,151,0,196
"11715",1992-01-27,-42,146,0,188
"11716",1992-01-28,-14,140,0,154
"11717",1992-01-29,38,88,4,50
"11718",1992-01-30,-4,51,0,55
"11719",1992-01-31,-29,27,3,56
"11720",1992-02-01,-67,16,0,83
"11721",1992-02-02,-25,35,0,60
"11722",1992-02-03,-39,89,0,128
"11723",1992-02-04,-61,81,0,142
"11724",1992-02-05,-49,99,0,148
"11725",1992-02-06,-7,73,0,80
"11726",1992-02-07,-52,74,0,126
"11727",1992-02-08,-45,61,0,106
"11728",1992-02-09,-52,99,0,151
"11729",1992-02-10,-43,77,0,120
"11730",1992-02-11,-52,117,0,169
"11731",1992-02-12,-14,86,0,100
"11732",1992-02-13,-61,61,0,122
"11733",1992-02-14,-39,136,0,175
"11734",1992-02-15,23,143,0,120
"11735",1992-02-16,-21,83,0,104
"11736",1992-02-17,-40,152,0,192
"11737",1992-02-18,35,99,0,64
"11738",1992-02-19,-27,86,0,113
"11739",1992-02-20,-36,98,0,134
"11740",1992-02-21,-49,137,0,186
"11741",1992-02-22,-3,158,0,161
"11742",1992-02-23,18,91,0,73
"11743",1992-02-24,-25,193,0,218
"11744",1992-02-25,14,205,0,191
"11745",1992-02-26,26,226,0,200
"11746",1992-02-27,30,220,0,190
"11747",1992-02-28,99,207,9,108
"11748",1992-02-29,58,135,17,77
"11749",1992-03-01,-11,87,80,98
"11750",1992-03-02,-11,29,8,40
"11751",1992-03-03,-24,22,92,46
"11752",1992-03-04,-29,29,21,58
"11753",1992-03-05,-75,61,0,136
"11754",1992-03-06,-29,91,0,120
"11755",1992-03-07,-2,137,0,139
"11756",1992-03-08,3,153,0,150
"11757",1992-03-09,28,157,0,129
"11758",1992-03-10,16,170,0,154
"11759",1992-03-11,48,180,0,132
"11760",1992-03-12,56,161,0,105
"11761",1992-03-13,86,116,5,30
"11762",1992-03-14,82,115,55,33
"11763",1992-03-15,51,110,11,59
"11764",1992-03-16,8,59,3,51
"11765",1992-03-17,3,49,7,46
"11766",1992-03-18,-8,151,0,159
"11767",1992-03-19,25,136,0,111
"11768",1992-03-20,5,62,4,57
"11769",1992-03-21,7,63,0,56
"11770",1992-03-22,14,51,17,37
"11771",1992-03-23,-15,71,0,86
"11772",1992-03-24,3,136,0,133
"11773",1992-03-25,52,107,8,55
"11774",1992-03-26,16,138,0,122
"11775",1992-03-27,29,147,0,118
"11776",1992-03-28,21,186,0,165
"11777",1992-03-29,78,205,0,127
"11778",1992-03-30,97,188,0,91
"11779",1992-03-31,100,237,0,137
"11780",1992-04-01,144,236,0,92
"11781",1992-04-02,88,247,0,159
"11782",1992-04-03,113,242,0,129
"11783",1992-04-04,87,268,0,181
"11784",1992-04-05,127,258,25,131
"11785",1992-04-06,69,178,0,109
"11786",1992-04-07,61,91,0,30
"11787",1992-04-08,88,118,14,30
"11788",1992-04-09,77,117,126,40
"11789",1992-04-10,33,225,0,192
"11790",1992-04-11,127,191,0,64
"11791",1992-04-12,64,233,0,169
"11792",1992-04-13,77,241,0,164
"11793",1992-04-14,64,282,0,218
"11794",1992-04-15,50,180,0,130
"11795",1992-04-16,65,233,0,168
"11796",1992-04-17,114,304,0,190
"11797",1992-04-18,121,220,0,99
"11798",1992-04-19,57,251,0,194
"11799",1992-04-20,130,302,0,172
"11800",1992-04-21,166,265,0,99
"11801",1992-04-22,99,257,0,158
"11802",1992-04-23,88,307,0,219
"11803",1992-04-24,140,240,0,100
"11804",1992-04-25,130,223,0,93
"11805",1992-04-26,90,277,0,187
"11806",1992-04-27,124,309,0,185
"11807",1992-04-28,149,242,0,93
"11808",1992-04-29,114,237,6,123
"11809",1992-04-30,129,267,0,138
"11810",1992-05-01,159,224,33,65
"11811",1992-05-02,96,258,0,162
"11812",1992-05-03,107,271,0,164
"11813",1992-05-04,154,242,809,88
"11814",1992-05-05,143,180,604,37
"11815",1992-05-06,144,194,0,50
"11816",1992-05-07,159,243,19,84
"11817",1992-05-08,153,262,0,109
"11818",1992-05-09,149,215,0,66
"11819",1992-05-10,90,201,0,111
"11820",1992-05-11,84,198,7,114
"11821",1992-05-12,123,197,7,74
"11822",1992-05-13,132,223,0,91
"11823",1992-05-14,125,229,0,104
"11824",1992-05-15,136,259,0,123
"11825",1992-05-16,131,224,0,93
"11826",1992-05-17,130,262,0,132
"11827",1992-05-18,139,281,0,142
"11828",1992-05-19,156,309,0,153
"11829",1992-05-20,140,325,0,185
"11830",1992-05-21,155,334,0,179
"11831",1992-05-22,151,359,0,208
"11832",1992-05-23,181,285,0,104
"11833",1992-05-24,157,298,0,141
"11834",1992-05-25,156,276,0,120
"11835",1992-05-26,155,318,0,163
"11836",1992-05-27,138,318,0,180
"11837",1992-05-28,176,327,0,151
"11838",1992-05-29,196,328,0,132
"11839",1992-05-30,204,332,0,128
"11840",1992-05-31,187,347,0,160
"11841",1992-06-01,203,348,0,145
"11842",1992-06-02,228,295,0,67
"11843",1992-06-03,186,351,0,165
"11844",1992-06-04,209,375,0,166
"11845",1992-06-05,235,322,0,87
"11846",1992-06-06,140,254,2,114
"11847",1992-06-07,150,326,0,176
"11848",1992-06-08,158,368,0,210
"11849",1992-06-09,159,342,0,183
"11850",1992-06-10,153,314,0,161
"11851",1992-06-11,176,308,0,132
"11852",1992-06-12,196,281,29,85
"11853",1992-06-13,180,230,205,50
"11854",1992-06-14,203,298,11,95
"11855",1992-06-15,205,302,0,97
"11856",1992-06-16,190,321,0,131
"11857",1992-06-17,183,293,0,110
"11858",1992-06-18,174,300,0,126
"11859",1992-06-19,165,300,0,135
"11860",1992-06-20,156,268,36,112
"11861",1992-06-21,148,254,110,106
"11862",1992-06-22,187,272,0,85
"11863",1992-06-23,180,289,0,109
"11864",1992-06-24,206,305,0,99
"11865",1992-06-25,206,298,0,92
"11866",1992-06-26,217,287,0,70
"11867",1992-06-27,185,302,0,117
"11868",1992-06-28,216,274,0,58
"11869",1992-06-29,190,291,0,101
"11870",1992-06-30,174,318,0,144
"11871",1992-07-01,207,364,0,157
"11872",1992-07-02,211,397,0,186
"11873",1992-07-03,243,335,0,92
"11874",1992-07-04,220,352,0,132
"11875",1992-07-05,231,366,0,135
"11876",1992-07-06,241,343,0,102
"11877",1992-07-07,196,355,0,159
"11878",1992-07-08,216,361,0,145
"11879",1992-07-09,207,351,0,144
"11880",1992-07-10,216,306,0,90
"11881",1992-07-11,203,278,552,75
"11882",1992-07-12,202,269,2,67
"11883",1992-07-13,218,265,19,47
"11884",1992-07-14,216,248,62,32
"11885",1992-07-15,211,238,220,27
"11886",1992-07-16,216,264,39,48
"11887",1992-07-17,208,350,0,142
"11888",1992-07-18,202,354,0,152
"11889",1992-07-19,263,321,0,58
"11890",1992-07-20,228,304,201,76
"11891",1992-07-21,237,347,0,110
"11892",1992-07-22,236,339,0,103
"11893",1992-07-23,247,347,3,100
"11894",1992-07-24,285,351,0,66
"11895",1992-07-25,268,354,0,86
"11896",1992-07-26,273,363,0,90
"11897",1992-07-27,266,358,0,92
"11898",1992-07-28,229,354,0,125
"11899",1992-07-29,273,355,0,82
"11900",1992-07-30,225,342,0,117
"11901",1992-07-31,209,346,0,137
"11902",1992-08-01,236,325,253,89
"11903",1992-08-02,236,331,0,95
"11904",1992-08-03,256,350,0,94
"11905",1992-08-04,239,347,153,108
"11906",1992-08-05,229,303,138,74
"11907",1992-08-06,244,308,0,64
"11908",1992-08-07,237,292,0,55
"11909",1992-08-08,222,305,0,83
"11910",1992-08-09,238,300,0,62
"11911",1992-08-10,249,324,5,75
"11912",1992-08-11,247,270,7,23
"11913",1992-08-12,225,253,384,28
"11914",1992-08-13,174,231,152,57
"11915",1992-08-14,175,247,24,72
"11916",1992-08-15,184,276,43,92
"11917",1992-08-16,183,273,0,90
"11918",1992-08-17,186,278,0,92
"11919",1992-08-18,212,272,0,60
"11920",1992-08-19,191,292,0,101
"11921",1992-08-20,193,295,0,102
"11922",1992-08-21,219,317,0,98
"11923",1992-08-22,221,305,0,84
"11924",1992-08-23,182,322,0,140
"11925",1992-08-24,195,327,0,132
"11926",1992-08-25,195,320,0,125
"11927",1992-08-26,213,302,0,89
"11928",1992-08-27,194,310,0,116
"11929",1992-08-28,194,307,0,113
"11930",1992-08-29,217,281,31,64
"11931",1992-08-30,218,250,177,32
"11932",1992-08-31,220,287,18,67
"11933",1992-09-01,213,256,173,43
"11934",1992-09-02,202,314,0,112
"11935",1992-09-03,193,332,0,139
"11936",1992-09-04,216,325,0,109
"11937",1992-09-05,193,322,0,129
"11938",1992-09-06,203,280,309,77
"11939",1992-09-07,168,302,0,134
"11940",1992-09-08,211,247,4,36
"11941",1992-09-09,147,287,0,140
"11942",1992-09-10,184,268,0,84
"11943",1992-09-11,176,237,24,61
"11944",1992-09-12,167,225,96,58
"11945",1992-09-13,168,239,3,71
"11946",1992-09-14,162,199,50,37
"11947",1992-09-15,171,234,0,63
"11948",1992-09-16,168,207,12,39
"11949",1992-09-17,131,215,14,84
"11950",1992-09-18,128,237,8,109
"11951",1992-09-19,155,190,452,35
"11952",1992-09-20,129,157,320,28
"11953",1992-09-21,143,188,51,45
"11954",1992-09-22,164,263,0,99
"11955",1992-09-23,144,264,0,120
"11956",1992-09-24,164,223,0,59
"11957",1992-09-25,139,237,0,98
"11958",1992-09-26,118,217,0,99
"11959",1992-09-27,119,191,5,72
"11960",1992-09-28,114,247,13,133
"11961",1992-09-29,87,270,0,183
"11962",1992-09-30,131,285,0,154
"11963",1992-10-01,152,293,0,141
"11964",1992-10-02,162,237,18,75
"11965",1992-10-03,100,164,100,64
"11966",1992-10-04,97,153,10,56
"11967",1992-10-05,85,158,0,73
"11968",1992-10-06,99,197,0,98
"11969",1992-10-07,60,223,0,163
"11970",1992-10-08,71,232,0,161
"11971",1992-10-09,100,197,0,97
"11972",1992-10-10,79,248,0,169
"11973",1992-10-11,84,183,0,99
"11974",1992-10-12,72,172,0,100
"11975",1992-10-13,122,190,0,68
"11976",1992-10-14,91,200,0,109
"11977",1992-10-15,59,210,0,151
"11978",1992-10-16,49,216,0,167
"11979",1992-10-17,51,230,0,179
"11980",1992-10-18,49,228,0,179
"11981",1992-10-19,57,216,0,159
"11982",1992-10-20,57,218,0,161
"11983",1992-10-21,86,216,1,130
"11984",1992-10-22,75,186,2,111
"11985",1992-10-23,69,147,0,78
"11986",1992-10-24,50,171,0,121
"11987",1992-10-25,2,198,0,196
"11988",1992-10-26,12,197,0,185
"11989",1992-10-27,20,193,0,173
"11990",1992-10-28,69,234,0,165
"11991",1992-10-29,117,224,0,107
"11992",1992-10-30,23,218,0,195
"11993",1992-10-31,55,245,0,190
"11994",1992-11-01,54,157,0,103
"11995",1992-11-02,38,137,3,99
"11996",1992-11-03,94,185,0,91
"11997",1992-11-04,29,202,0,173
"11998",1992-11-05,24,219,0,195
"11999",1992-11-06,64,192,0,128
"12000",1992-11-07,58,156,104,98
"12001",1992-11-08,28,85,0,57
"12002",1992-11-09,4,86,0,82
"12003",1992-11-10,1,144,0,143
"12004",1992-11-11,-1,166,0,167
"12005",1992-11-12,1,177,0,176
"12006",1992-11-13,-6,161,0,167
"12007",1992-11-14,5,186,0,181
"12008",1992-11-15,38,142,0,104
"12009",1992-11-16,-8,141,0,149
"12010",1992-11-17,35,159,0,124
"12011",1992-11-18,36,109,0,73
"12012",1992-11-19,46,133,0,87
"12013",1992-11-20,-23,89,0,112
"12014",1992-11-21,-36,160,0,196
"12015",1992-11-22,74,164,0,90
"12016",1992-11-23,25,192,0,167
"12017",1992-11-24,94,182,0,88
"12018",1992-11-25,63,161,0,98
"12019",1992-11-26,-12,107,0,119
"12020",1992-11-27,-20,76,0,96
"12021",1992-11-28,-34,155,0,189
"12022",1992-11-29,-16,158,0,174
"12023",1992-11-30,-7,167,0,174
"12024",1992-12-01,15,97,0,82
"12025",1992-12-02,-37,94,0,131
"12026",1992-12-03,-22,54,0,76
"12027",1992-12-04,38,83,0,45
"12028",1992-12-05,44,71,15,27
"12029",1992-12-06,46,106,40,60
"12030",1992-12-07,-4,141,0,145
"12031",1992-12-08,-10,69,0,79
"12032",1992-12-09,-17,146,0,163
"12033",1992-12-10,-18,108,0,126
"12034",1992-12-11,-57,129,0,186
"12035",1992-12-12,-19,160,0,179
"12036",1992-12-13,11,84,0,73
"12037",1992-12-14,-53,68,0,121
"12038",1992-12-15,-63,98,0,161
"12039",1992-12-16,-50,67,0,117
"12040",1992-12-17,-37,67,0,104
"12041",1992-12-18,2,46,2,44
"12042",1992-12-19,-42,41,0,83
"12043",1992-12-20,3,112,0,109
"12044",1992-12-21,-54,80,0,134
"12045",1992-12-22,-37,46,0,83
"12046",1992-12-23,-45,53,0,98
"12047",1992-12-24,-75,84,0,159
"12048",1992-12-25,-55,50,0,105
"12049",1992-12-26,-32,15,77,47
"12050",1992-12-27,-7,12,15,19
"12051",1992-12-28,-32,10,0,42
"12052",1992-12-29,-37,113,0,150
"12053",1992-12-30,-32,49,0,81
"12054",1992-12-31,-21,81,0,102
"12055",1993-01-01,5,93,0,88
"12056",1993-01-02,6,40,0,34
"12057",1993-01-03,5,41,0,36
"12058",1993-01-04,-56,34,0,90
"12059",1993-01-05,-57,35,0,92
"12060",1993-01-06,-42,48,0,90
"12061",1993-01-07,-25,17,0,42
"12062",1993-01-08,-15,3,40,18
"12063",1993-01-09,-14,2,17,16
"12064",1993-01-10,-42,4,1,46
"12065",1993-01-11,-55,21,0,76
"12066",1993-01-12,-44,9,16,53
"12067",1993-01-13,-19,9,73,28
"12068",1993-01-14,-82,-14,13,68
"12069",1993-01-15,-143,-32,0,111
"12070",1993-01-16,-142,1,0,143
"12071",1993-01-17,-94,6,0,100
"12072",1993-01-18,-119,-9,0,110
"12073",1993-01-19,-84,-8,0,76
"12074",1993-01-20,-67,0,0,67
"12075",1993-01-21,-79,31,0,110
"12076",1993-01-22,-57,51,0,108
"12077",1993-01-23,-24,38,0,62
"12078",1993-01-24,-74,66,0,140
"12079",1993-01-25,-53,97,0,150
"12080",1993-01-26,-16,61,0,77
"12081",1993-01-27,-53,42,0,95
"12082",1993-01-28,-69,72,0,141
"12083",1993-01-29,-18,80,0,98
"12084",1993-01-30,-45,152,0,197
"12085",1993-01-31,2,81,0,79
"12086",1993-02-01,-57,97,0,154
"12087",1993-02-02,-16,99,0,115
"12088",1993-02-03,-23,155,0,178
"12089",1993-02-04,-16,199,0,215
"12090",1993-02-05,12,252,0,240
"12091",1993-02-06,111,183,0,72
"12092",1993-02-07,-23,114,0,137
"12093",1993-02-08,8,118,0,110
"12094",1993-02-09,-30,89,0,119
"12095",1993-02-10,18,177,0,159
"12096",1993-02-11,20,133,0,113
"12097",1993-02-12,-4,160,0,164
"12098",1993-02-13,-2,165,0,167
"12099",1993-02-14,64,121,0,57
"12100",1993-02-15,64,94,96,30
"12101",1993-02-16,9,137,2,128
"12102",1993-02-17,41,91,2,50
"12103",1993-02-18,30,45,4,15
"12104",1993-02-19,4,42,37,38
"12105",1993-02-20,3,53,41,50
"12106",1993-02-21,-4,79,0,83
"12107",1993-02-22,-16,62,0,78
"12108",1993-02-23,-36,53,0,89
"12109",1993-02-24,-2,76,0,78
"12110",1993-02-25,-39,87,0,126
"12111",1993-02-26,-26,94,0,120
"12112",1993-02-27,11,106,0,95
"12113",1993-02-28,-7,96,0,103
"12114",1993-03-01,-29,91,0,120
"12115",1993-03-02,-22,124,0,146
"12116",1993-03-03,27,171,0,144
"12117",1993-03-04,6,199,0,193
"12118",1993-03-05,58,155,0,97
"12119",1993-03-06,3,108,0,105
"12120",1993-03-07,15,118,0,103
"12121",1993-03-08,-16,116,0,132
"12122",1993-03-09,7,167,0,160
"12123",1993-03-10,41,176,0,135
"12124",1993-03-11,61,163,0,102
"12125",1993-03-12,44,141,0,97
"12126",1993-03-13,69,121,74,52
"12127",1993-03-14,63,91,115,28
"12128",1993-03-15,71,96,10,25
"12129",1993-03-16,40,101,0,61
"12130",1993-03-17,8,113,0,105
"12131",1993-03-18,-13,106,0,119
"12132",1993-03-19,-5,121,0,126
"12133",1993-03-20,8,119,0,111
"12134",1993-03-21,-4,144,0,148
"12135",1993-03-22,16,129,0,113
"12136",1993-03-23,15,94,0,79
"12137",1993-03-24,35,186,0,151
"12138",1993-03-25,100,163,0,63
"12139",1993-03-26,101,152,0,51
"12140",1993-03-27,48,160,0,112
"12141",1993-03-28,76,160,0,84
"12142",1993-03-29,36,154,0,118
"12143",1993-03-30,33,253,0,220
"12144",1993-03-31,119,250,0,131
"12145",1993-04-01,87,239,0,152
"12146",1993-04-02,113,234,0,121
"12147",1993-04-03,64,196,26,132
"12148",1993-04-04,49,119,0,70
"12149",1993-04-05,57,171,0,114
"12150",1993-04-06,76,182,0,106
"12151",1993-04-07,56,134,0,78
"12152",1993-04-08,32,138,0,106
"12153",1993-04-09,35,192,0,157
"12154",1993-04-10,33,161,0,128
"12155",1993-04-11,17,166,0,149
"12156",1993-04-12,77,149,0,72
"12157",1993-04-13,42,177,0,135
"12158",1993-04-14,36,195,0,159
"12159",1993-04-15,79,217,0,138
"12160",1993-04-16,101,239,0,138
"12161",1993-04-17,91,277,0,186
"12162",1993-04-18,145,268,0,123
"12163",1993-04-19,112,291,0,179
"12164",1993-04-20,118,285,0,167
"12165",1993-04-21,143,303,0,160
"12166",1993-04-22,162,345,0,183
"12167",1993-04-23,168,372,0,204
"12168",1993-04-24,121,298,0,177
"12169",1993-04-25,81,218,0,137
"12170",1993-04-26,107,299,0,192
"12171",1993-04-27,140,240,0,100
"12172",1993-04-28,158,233,0,75
"12173",1993-04-29,138,262,0,124
"12174",1993-04-30,109,227,799,118
"12175",1993-05-01,102,141,21,39
"12176",1993-05-02,82,241,0,159
"12177",1993-05-03,113,238,0,125
"12178",1993-05-04,128,253,0,125
"12179",1993-05-05,139,240,0,101
"12180",1993-05-06,152,262,0,110
"12181",1993-05-07,134,214,2,80
"12182",1993-05-08,120,218,0,98
"12183",1993-05-09,73,244,0,171
"12184",1993-05-10,138,234,0,96
"12185",1993-05-11,195,300,0,105
"12186",1993-05-12,145,261,174,116
"12187",1993-05-13,131,170,44,39
"12188",1993-05-14,83,220,0,137
"12189",1993-05-15,150,185,5,35
"12190",1993-05-16,96,214,0,118
"12191",1993-05-17,123,257,0,134
"12192",1993-05-18,130,255,0,125
"12193",1993-05-19,142,218,0,76
"12194",1993-05-20,156,202,30,46
"12195",1993-05-21,163,280,0,117
"12196",1993-05-22,137,298,0,161
"12197",1993-05-23,146,310,0,164
"12198",1993-05-24,149,340,0,191
"12199",1993-05-25,157,278,0,121
"12200",1993-05-26,140,255,39,115
"12201",1993-05-27,155,234,0,79
"12202",1993-05-28,127,285,0,158
"12203",1993-05-29,123,303,0,180
"12204",1993-05-30,193,315,0,122
"12205",1993-05-31,183,301,0,118
"12206",1993-06-01,190,264,7,74
"12207",1993-06-02,130,315,0,185
"12208",1993-06-03,150,275,0,125
"12209",1993-06-04,180,292,0,112
"12210",1993-06-05,159,320,0,161
"12211",1993-06-06,188,320,0,132
"12212",1993-06-07,194,338,0,144
"12213",1993-06-08,182,347,0,165
"12214",1993-06-09,220,363,0,143
"12215",1993-06-10,236,335,0,99
"12216",1993-06-11,230,300,180,70
"12217",1993-06-12,211,331,0,120
"12218",1993-06-13,201,335,0,134
"12219",1993-06-14,199,357,0,158
"12220",1993-06-15,233,350,0,117
"12221",1993-06-16,207,337,9,130
"12222",1993-06-17,189,327,5,138
"12223",1993-06-18,195,358,0,163
"12224",1993-06-19,203,371,0,168
"12225",1993-06-20,220,346,0,126
"12226",1993-06-21,190,302,171,112
"12227",1993-06-22,194,333,3,139
"12228",1993-06-23,218,332,0,114
"12229",1993-06-24,208,297,55,89
"12230",1993-06-25,187,318,0,131
"12231",1993-06-26,197,325,0,128
"12232",1993-06-27,200,293,481,93
"12233",1993-06-28,204,256,63,52
"12234",1993-06-29,195,314,0,119
"12235",1993-06-30,208,278,0,70
"12236",1993-07-01,216,290,0,74
"12237",1993-07-02,201,327,0,126
"12238",1993-07-03,219,322,0,103
"12239",1993-07-04,217,324,0,107
"12240",1993-07-05,218,327,0,109
"12241",1993-07-06,242,330,0,88
"12242",1993-07-07,221,332,29,111
"12243",1993-07-08,211,362,0,151
"12244",1993-07-09,249,359,0,110
"12245",1993-07-10,211,332,0,121
"12246",1993-07-11,258,354,0,96
"12247",1993-07-12,249,340,0,91
"12248",1993-07-13,204,266,215,62
"12249",1993-07-14,227,322,7,95
"12250",1993-07-15,224,280,0,56
"12251",1993-07-16,208,289,0,81
"12252",1993-07-17,210,337,0,127
"12253",1993-07-18,230,319,0,89
"12254",1993-07-19,232,295,0,63
"12255",1993-07-20,211,265,3,54
"12256",1993-07-21,221,262,0,41
"12257",1993-07-22,183,236,221,53
"12258",1993-07-23,174,245,36,71
"12259",1993-07-24,186,274,0,88
"12260",1993-07-25,198,279,0,81
"12261",1993-07-26,193,308,0,115
"12262",1993-07-27,209,282,0,73
"12263",1993-07-28,203,294,0,91
"12264",1993-07-29,219,277,0,58
"12265",1993-07-30,200,307,0,107
"12266",1993-07-31,208,320,0,112
"12267",1993-08-01,221,333,0,112
"12268",1993-08-02,238,350,0,112
"12269",1993-08-03,246,347,0,101
"12270",1993-08-04,238,328,166,90
"12271",1993-08-05,242,282,26,40
"12272",1993-08-06,233,292,16,59
"12273",1993-08-07,229,322,0,93
"12274",1993-08-08,241,322,0,81
"12275",1993-08-09,221,318,0,97
"12276",1993-08-10,234,314,0,80
"12277",1993-08-11,203,279,80,76
"12278",1993-08-12,206,296,0,90
"12279",1993-08-13,221,297,0,76
"12280",1993-08-14,196,260,36,64
"12281",1993-08-15,173,210,270,37
"12282",1993-08-16,168,313,0,145
"12283",1993-08-17,209,317,160,108
"12284",1993-08-18,220,312,1,92
"12285",1993-08-19,192,292,0,100
"12286",1993-08-20,196,269,0,73
"12287",1993-08-21,172,274,0,102
"12288",1993-08-22,171,264,0,93
"12289",1993-08-23,228,297,153,69
"12290",1993-08-24,229,312,2,83
"12291",1993-08-25,208,259,25,51
"12292",1993-08-26,165,314,0,149
"12293",1993-08-27,210,286,0,76
"12294",1993-08-28,209,251,0,42
"12295",1993-08-29,165,268,0,103
"12296",1993-08-30,154,287,0,133
"12297",1993-08-31,160,289,0,129
"12298",1993-09-01,174,294,62,120
"12299",1993-09-02,178,275,0,97
"12300",1993-09-03,170,299,0,129
"12301",1993-09-04,187,313,0,126
"12302",1993-09-05,193,308,0,115
"12303",1993-09-06,184,303,0,119
"12304",1993-09-07,194,266,0,72
"12305",1993-09-08,186,263,0,77
"12306",1993-09-09,148,230,0,82
"12307",1993-09-10,185,213,35,28
"12308",1993-09-11,164,275,0,111
"12309",1993-09-12,156,320,0,164
"12310",1993-09-13,192,299,0,107
"12311",1993-09-14,200,265,0,65
"12312",1993-09-15,193,303,0,110
"12313",1993-09-16,197,247,234,50
"12314",1993-09-17,163,288,0,125
"12315",1993-09-18,200,267,0,67
"12316",1993-09-19,177,302,0,125
"12317",1993-09-20,200,304,0,104
"12318",1993-09-21,178,297,0,119
"12319",1993-09-22,167,293,0,126
"12320",1993-09-23,130,300,0,170
"12321",1993-09-24,130,301,0,171
"12322",1993-09-25,148,280,0,132
"12323",1993-09-26,139,297,0,158
"12324",1993-09-27,185,244,0,59
"12325",1993-09-28,135,264,0,129
"12326",1993-09-29,96,259,0,163
"12327",1993-09-30,89,241,0,152
"12328",1993-10-01,91,242,0,151
"12329",1993-10-02,86,261,0,175
"12330",1993-10-03,93,275,0,182
"12331",1993-10-04,148,244,0,96
"12332",1993-10-05,119,229,0,110
"12333",1993-10-06,106,261,0,155
"12334",1993-10-07,103,277,0,174
"12335",1993-10-08,102,286,0,184
"12336",1993-10-09,151,282,0,131
"12337",1993-10-10,104,234,0,130
"12338",1993-10-11,134,172,0,38
"12339",1993-10-12,135,146,64,11
"12340",1993-10-13,120,153,243,33
"12341",1993-10-14,84,144,0,60
"12342",1993-10-15,80,217,0,137
"12343",1993-10-16,64,227,0,163
"12344",1993-10-17,90,203,0,113
"12345",1993-10-18,53,247,0,194
"12346",1993-10-19,101,250,0,149
"12347",1993-10-20,86,253,0,167
"12348",1993-10-21,113,231,0,118
"12349",1993-10-22,91,238,0,147
"12350",1993-10-23,57,202,0,145
"12351",1993-10-24,50,239,0,189
"12352",1993-10-25,67,198,0,131
"12353",1993-10-26,90,180,0,90
"12354",1993-10-27,67,159,3,92
"12355",1993-10-28,124,165,44,41
"12356",1993-10-29,71,146,0,75
"12357",1993-10-30,56,184,0,128
"12358",1993-10-31,8,247,0,239
"12359",1993-11-01,28,253,0,225
"12360",1993-11-02,34,222,0,188
"12361",1993-11-03,22,243,0,221
"12362",1993-11-04,47,250,0,203
"12363",1993-11-05,70,184,0,114
"12364",1993-11-06,92,142,69,50
"12365",1993-11-07,73,108,10,35
"12366",1993-11-08,33,96,204,63
"12367",1993-11-09,34,64,150,30
"12368",1993-11-10,52,96,1,44
"12369",1993-11-11,78,124,122,46
"12370",1993-11-12,47,159,0,112
"12371",1993-11-13,54,217,0,163
"12372",1993-11-14,59,173,0,114
"12373",1993-11-15,100,136,4,36
"12374",1993-11-16,45,106,12,61
"12375",1993-11-17,-13,47,1,60
"12376",1993-11-18,-41,-7,15,34
"12377",1993-11-19,-53,-18,172,35
"12378",1993-11-20,-25,9,26,34
"12379",1993-11-21,-131,17,0,148
"12380",1993-11-22,-94,73,0,167
"12381",1993-11-23,-80,24,0,104
"12382",1993-11-24,-66,42,0,108
"12383",1993-11-25,-21,94,0,115
"12384",1993-11-26,-10,147,0,157
"12385",1993-11-27,28,122,0,94
"12386",1993-11-28,-35,77,0,112
"12387",1993-11-29,12,68,6,56
"12388",1993-11-30,12,96,12,84
"12389",1993-12-01,-15,62,0,77
"12390",1993-12-02,-1,69,0,70
"12391",1993-12-03,-28,56,0,84
"12392",1993-12-04,-11,62,0,73
"12393",1993-12-05,-41,91,0,132
"12394",1993-12-06,-57,86,0,143
"12395",1993-12-07,-35,100,0,135
"12396",1993-12-08,-37,100,0,137
"12397",1993-12-09,-2,89,0,91
"12398",1993-12-10,-48,92,0,140
"12399",1993-12-11,-9,26,0,35
"12400",1993-12-12,-22,72,0,94
"12401",1993-12-13,-15,54,0,69
"12402",1993-12-14,-30,13,0,43
"12403",1993-12-15,-63,24,0,87
"12404",1993-12-16,-42,74,0,116
"12405",1993-12-17,-67,64,0,131
"12406",1993-12-18,-33,92,0,125
"12407",1993-12-19,-50,152,0,202
"12408",1993-12-20,11,79,0,68
"12409",1993-12-21,-51,32,0,83
"12410",1993-12-22,-67,67,0,134
"12411",1993-12-23,-87,116,0,203
"12412",1993-12-24,41,128,0,87
"12413",1993-12-25,-31,188,0,219
"12414",1993-12-26,5,115,0,110
"12415",1993-12-27,-37,131,0,168
"12416",1993-12-28,-39,95,0,134
"12417",1993-12-29,-45,69,0,114
"12418",1993-12-30,5,110,0,105
"12419",1993-12-31,-79,69,0,148
"12420",1994-01-01,-20,121,0,141
"12421",1994-01-02,-45,109,0,154
"12422",1994-01-03,-40,93,0,133
"12423",1994-01-04,-46,56,0,102
"12424",1994-01-05,-21,127,0,148
"12425",1994-01-06,34,92,0,58
"12426",1994-01-07,-45,121,0,166
"12427",1994-01-08,-35,185,0,220
"12428",1994-01-09,-37,131,0,168
"12429",1994-01-10,-31,69,0,100
"12430",1994-01-11,-32,38,0,70
"12431",1994-01-12,-5,54,0,59
"12432",1994-01-13,-58,123,0,181
"12433",1994-01-14,-48,123,0,171
"12434",1994-01-15,-23,107,0,130
"12435",1994-01-16,13,79,5,66
"12436",1994-01-17,-28,41,20,69
"12437",1994-01-18,-43,10,1,53
"12438",1994-01-19,-63,32,0,95
"12439",1994-01-20,-41,46,0,87
"12440",1994-01-21,-22,62,0,84
"12441",1994-01-22,-14,95,0,109
"12442",1994-01-23,-21,49,0,70
"12443",1994-01-24,-61,118,0,179
"12444",1994-01-25,-44,151,0,195
"12445",1994-01-26,-11,126,0,137
"12446",1994-01-27,-51,92,0,143
"12447",1994-01-28,-35,89,0,124
"12448",1994-01-29,-55,70,0,125
"12449",1994-01-30,8,58,0,50
"12450",1994-01-31,-17,52,0,69
"12451",1994-02-01,-43,65,0,108
"12452",1994-02-02,-58,111,0,169
"12453",1994-02-03,-43,61,0,104
"12454",1994-02-04,-3,123,0,126
"12455",1994-02-05,-15,123,0,138
"12456",1994-02-06,3,133,0,130
"12457",1994-02-07,-35,149,0,184
"12458",1994-02-08,60,115,0,55
"12459",1994-02-09,-75,109,0,184
"12460",1994-02-10,-7,44,2,51
"12461",1994-02-11,-15,39,9,54
"12462",1994-02-12,-45,24,0,69
"12463",1994-02-13,-15,20,7,35
"12464",1994-02-14,-11,41,0,52
"12465",1994-02-15,-45,113,0,158
"12466",1994-02-16,-38,68,0,106
"12467",1994-02-17,8,100,0,92
"12468",1994-02-18,-23,84,0,107
"12469",1994-02-19,-42,116,0,158
"12470",1994-02-20,13,160,0,147
"12471",1994-02-21,-17,152,0,169
"12472",1994-02-22,37,105,0,68
"12473",1994-02-23,-31,83,36,114
"12474",1994-02-24,-36,24,13,60
"12475",1994-02-25,-50,67,0,117
"12476",1994-02-26,1,100,0,99
"12477",1994-02-27,23,93,0,70
"12478",1994-02-28,1,70,0,69
"12479",1994-03-01,-12,134,0,146
"12480",1994-03-02,-1,152,0,153
"12481",1994-03-03,9,191,0,182
"12482",1994-03-04,10,125,0,115
"12483",1994-03-05,-5,138,0,143
"12484",1994-03-06,57,115,80,58
"12485",1994-03-07,49,79,0,30
"12486",1994-03-08,34,77,0,43
"12487",1994-03-09,3,61,23,58
"12488",1994-03-10,2,91,0,89
"12489",1994-03-11,36,70,9,34
"12490",1994-03-12,1,51,5,50
"12491",1994-03-13,-14,83,0,97
"12492",1994-03-14,12,99,0,87
"12493",1994-03-15,-25,128,0,153
"12494",1994-03-16,16,148,0,132
"12495",1994-03-17,-10,169,0,179
"12496",1994-03-18,35,226,0,191
"12497",1994-03-19,70,213,0,143
"12498",1994-03-20,57,131,12,74
"12499",1994-03-21,21,181,32,160
"12500",1994-03-22,91,136,0,45
"12501",1994-03-23,0,199,0,199
"12502",1994-03-24,22,200,0,178
"12503",1994-03-25,41,154,0,113
"12504",1994-03-26,-28,138,0,166
"12505",1994-03-27,13,114,4,101
"12506",1994-03-28,25,211,0,186
"12507",1994-03-29,47,194,0,147
"12508",1994-03-30,54,206,0,152
"12509",1994-03-31,46,228,0,182
"12510",1994-04-01,60,253,1,193
"12511",1994-04-02,72,298,0,226
"12512",1994-04-03,136,276,0,140
"12513",1994-04-04,103,263,0,160
"12514",1994-04-05,132,249,0,117
"12515",1994-04-06,118,239,0,121
"12516",1994-04-07,115,230,0,115
"12517",1994-04-08,23,157,36,134
"12518",1994-04-09,37,72,118,35
"12519",1994-04-10,39,115,0,76
"12520",1994-04-11,77,105,189,28
"12521",1994-04-12,77,187,0,110
"12522",1994-04-13,95,207,0,112
"12523",1994-04-14,94,242,0,148
"12524",1994-04-15,82,264,0,182
"12525",1994-04-16,103,260,0,157
"12526",1994-04-17,131,196,52,65
"12527",1994-04-18,146,202,32,56
"12528",1994-04-19,123,170,539,47
"12529",1994-04-20,122,138,14,16
"12530",1994-04-21,124,216,0,92
"12531",1994-04-22,120,253,0,133
"12532",1994-04-23,155,197,0,42
"12533",1994-04-24,142,245,0,103
"12534",1994-04-25,134,266,0,132
"12535",1994-04-26,134,250,0,116
"12536",1994-04-27,145,256,0,111
"12537",1994-04-28,140,303,0,163
"12538",1994-04-29,157,348,0,191
"12539",1994-04-30,168,330,0,162
"12540",1994-05-01,190,291,0,101
"12541",1994-05-02,156,256,0,100
"12542",1994-05-03,137,212,0,75
"12543",1994-05-04,122,243,0,121
"12544",1994-05-05,113,275,0,162
"12545",1994-05-06,165,290,0,125
"12546",1994-05-07,129,323,0,194
"12547",1994-05-08,112,333,0,221
"12548",1994-05-09,202,312,0,110
"12549",1994-05-10,172,317,0,145
"12550",1994-05-11,134,303,0,169
"12551",1994-05-12,184,277,0,93
"12552",1994-05-13,190,284,4,94
"12553",1994-05-14,183,332,329,149
"12554",1994-05-15,178,348,0,170
"12555",1994-05-16,177,267,0,90
"12556",1994-05-17,152,272,0,120
"12557",1994-05-18,135,310,0,175
"12558",1994-05-19,160,302,0,142
"12559",1994-05-20,201,301,0,100
"12560",1994-05-21,154,310,0,156
"12561",1994-05-22,143,318,0,175
"12562",1994-05-23,202,298,0,96
"12563",1994-05-24,209,280,0,71
"12564",1994-05-25,182,290,79,108
"12565",1994-05-26,179,293,0,114
"12566",1994-05-27,156,317,0,161
"12567",1994-05-28,168,373,0,205
"12568",1994-05-29,204,307,0,103
"12569",1994-05-30,177,296,12,119
"12570",1994-05-31,208,326,0,118
"12571",1994-06-01,192,341,0,149
"12572",1994-06-02,231,353,0,122
"12573",1994-06-03,224,343,0,119
"12574",1994-06-04,226,317,0,91
"12575",1994-06-05,238,295,0,57
"12576",1994-06-06,200,277,31,77
"12577",1994-06-07,164,223,150,59
"12578",1994-06-08,157,264,3,107
"12579",1994-06-09,163,273,0,110
"12580",1994-06-10,172,292,0,120
"12581",1994-06-11,203,286,0,83
"12582",1994-06-12,203,322,222,119
"12583",1994-06-13,192,288,1,96
"12584",1994-06-14,197,324,0,127
"12585",1994-06-15,200,327,0,127
"12586",1994-06-16,232,301,0,69
"12587",1994-06-17,219,320,0,101
"12588",1994-06-18,185,350,0,165
"12589",1994-06-19,210,348,0,138
"12590",1994-06-20,226,316,0,90
"12591",1994-06-21,226,297,0,71
"12592",1994-06-22,184,316,0,132
"12593",1994-06-23,227,349,78,122
"12594",1994-06-24,218,308,857,90
"12595",1994-06-25,199,295,448,96
"12596",1994-06-26,215,315,0,100
"12597",1994-06-27,239,327,0,88
"12598",1994-06-28,250,329,0,79
"12599",1994-06-29,257,353,30,96
"12600",1994-06-30,236,289,62,53
"12601",1994-07-01,220,340,0,120
"12602",1994-07-02,245,351,0,106
"12603",1994-07-03,229,307,606,78
"12604",1994-07-04,244,335,0,91
"12605",1994-07-05,248,338,74,90
"12606",1994-07-06,242,318,32,76
"12607",1994-07-07,248,338,4,90
"12608",1994-07-08,253,340,122,87
"12609",1994-07-09,251,345,11,94
"12610",1994-07-10,257,342,3,85
"12611",1994-07-11,254,323,9,69
"12612",1994-07-12,218,296,1069,78
"12613",1994-07-13,218,322,6,104
"12614",1994-07-14,239,326,0,87
"12615",1994-07-15,234,315,0,81
"12616",1994-07-16,236,289,0,53
"12617",1994-07-17,234,303,0,69
"12618",1994-07-18,247,304,0,57
"12619",1994-07-19,235,314,0,79
"12620",1994-07-20,247,322,0,75
"12621",1994-07-21,252,334,0,82
"12622",1994-07-22,249,342,0,93
"12623",1994-07-23,250,350,0,100
"12624",1994-07-24,253,354,0,101
"12625",1994-07-25,263,349,0,86
"12626",1994-07-26,252,350,0,98
"12627",1994-07-27,247,348,0,101
"12628",1994-07-28,254,348,0,94
"12629",1994-07-29,243,295,0,52
"12630",1994-07-30,233,320,0,87
"12631",1994-07-31,234,323,0,89
"12632",1994-08-01,240,345,0,105
"12633",1994-08-02,255,353,0,98
"12634",1994-08-03,268,366,0,98
"12635",1994-08-04,268,372,0,104
"12636",1994-08-05,268,328,0,60
"12637",1994-08-06,259,301,1,42
"12638",1994-08-07,254,300,143,46
"12639",1994-08-08,220,287,0,67
"12640",1994-08-09,215,310,0,95
"12641",1994-08-10,236,330,0,94
"12642",1994-08-11,255,334,0,79
"12643",1994-08-12,268,351,0,83
"12644",1994-08-13,261,334,0,73
"12645",1994-08-14,245,314,40,69
"12646",1994-08-15,231,323,0,92
"12647",1994-08-16,213,336,0,123
"12648",1994-08-17,213,319,0,106
"12649",1994-08-18,223,312,0,89
"12650",1994-08-19,202,310,0,108
"12651",1994-08-20,237,301,10,64
"12652",1994-08-21,224,320,0,96
"12653",1994-08-22,204,310,0,106
"12654",1994-08-23,235,304,0,69
"12655",1994-08-24,224,332,0,108
"12656",1994-08-25,233,325,120,92
"12657",1994-08-26,204,237,145,33
"12658",1994-08-27,201,274,18,73
"12659",1994-08-28,185,283,0,98
"12660",1994-08-29,200,246,65,46
"12661",1994-08-30,225,292,0,67
"12662",1994-08-31,228,319,0,91
"12663",1994-09-01,234,342,0,108
"12664",1994-09-02,243,310,1,67
"12665",1994-09-03,253,280,15,27
"12666",1994-09-04,227,319,0,92
"12667",1994-09-05,191,301,0,110
"12668",1994-09-06,158,307,0,149
"12669",1994-09-07,162,303,0,141
"12670",1994-09-08,192,297,0,105
"12671",1994-09-09,218,297,3,79
"12672",1994-09-10,179,242,26,63
"12673",1994-09-11,158,223,0,65
"12674",1994-09-12,112,266,0,154
"12675",1994-09-13,112,268,0,156
"12676",1994-09-14,119,263,0,144
"12677",1994-09-15,168,212,9,44
"12678",1994-09-16,176,212,0,36
"12679",1994-09-17,169,277,0,108
"12680",1994-09-18,134,300,0,166
"12681",1994-09-19,154,267,0,113
"12682",1994-09-20,136,266,0,130
"12683",1994-09-21,158,280,0,122
"12684",1994-09-22,156,262,0,106
"12685",1994-09-23,102,288,0,186
"12686",1994-09-24,107,260,0,153
"12687",1994-09-25,157,270,0,113
"12688",1994-09-26,145,270,0,125
"12689",1994-09-27,125,312,0,187
"12690",1994-09-28,150,303,0,153
"12691",1994-09-29,93,274,0,181
"12692",1994-09-30,88,275,0,187
"12693",1994-10-01,102,323,0,221
"12694",1994-10-02,133,288,0,155
"12695",1994-10-03,124,217,0,93
"12696",1994-10-04,52,239,0,187
"12697",1994-10-05,77,277,0,200
"12698",1994-10-06,85,277,0,192
"12699",1994-10-07,119,278,0,159
"12700",1994-10-08,152,220,0,68
"12701",1994-10-09,162,205,10,43
"12702",1994-10-10,145,224,1,79
"12703",1994-10-11,157,222,0,65
"12704",1994-10-12,144,258,0,114
"12705",1994-10-13,88,287,0,199
"12706",1994-10-14,166,212,300,46
"12707",1994-10-15,135,167,157,32
"12708",1994-10-16,85,139,23,54
"12709",1994-10-17,87,160,54,73
"12710",1994-10-18,103,117,59,14
"12711",1994-10-19,72,193,0,121
"12712",1994-10-20,68,159,0,91
"12713",1994-10-21,53,193,0,140
"12714",1994-10-22,38,207,0,169
"12715",1994-10-23,35,221,0,186
"12716",1994-10-24,34,210,0,176
"12717",1994-10-25,51,205,0,154
"12718",1994-10-26,57,206,0,149
"12719",1994-10-27,59,224,0,165
"12720",1994-10-28,80,170,0,90
"12721",1994-10-29,36,188,0,152
"12722",1994-10-30,52,198,0,146
"12723",1994-10-31,25,222,0,197
"12724",1994-11-01,35,203,0,168
"12725",1994-11-02,75,226,0,151
"12726",1994-11-03,47,211,0,164
"12727",1994-11-04,99,195,0,96
"12728",1994-11-05,43,260,0,217
"12729",1994-11-06,80,237,0,157
"12730",1994-11-07,61,234,0,173
"12731",1994-11-08,94,251,0,157
"12732",1994-11-09,102,237,0,135
"12733",1994-11-10,76,183,0,107
"12734",1994-11-11,62,222,0,160
"12735",1994-11-12,101,162,0,61
"12736",1994-11-13,35,117,140,82
"12737",1994-11-14,0,37,80,37
"12738",1994-11-15,-7,2,71,9
"12739",1994-11-16,-6,23,44,29
"12740",1994-11-17,2,127,0,125
"12741",1994-11-18,3,175,0,172
"12742",1994-11-19,30,106,0,76
"12743",1994-11-20,50,70,1,20
"12744",1994-11-21,47,94,0,47
"12745",1994-11-22,37,78,7,41
"12746",1994-11-23,44,92,0,48
"12747",1994-11-24,2,83,0,81
"12748",1994-11-25,55,71,0,16
"12749",1994-11-26,25,133,0,108
"12750",1994-11-27,75,110,0,35
"12751",1994-11-28,59,97,6,38
"12752",1994-11-29,0,107,0,107
"12753",1994-11-30,58,165,0,107
"12754",1994-12-01,52,177,0,125
"12755",1994-12-02,9,116,0,107
"12756",1994-12-03,-24,82,0,106
"12757",1994-12-04,-15,144,0,159
"12758",1994-12-05,-28,76,0,104
"12759",1994-12-06,-15,173,0,188
"12760",1994-12-07,43,82,3,39
"12761",1994-12-08,69,96,1,27
"12762",1994-12-09,29,100,0,71
"12763",1994-12-10,23,78,35,55
"12764",1994-12-11,23,42,9,19
"12765",1994-12-12,23,64,0,41
"12766",1994-12-13,-12,111,0,123
"12767",1994-12-14,-11,50,0,61
"12768",1994-12-15,-53,42,0,95
"12769",1994-12-16,-20,7,0,27
"12770",1994-12-17,-27,63,0,90
"12771",1994-12-18,-38,19,0,57
"12772",1994-12-19,-21,7,5,28
"12773",1994-12-20,-23,69,0,92
"12774",1994-12-21,-62,96,0,158
"12775",1994-12-22,-40,134,0,174
"12776",1994-12-23,-38,128,0,166
"12777",1994-12-24,-12,59,0,71
"12778",1994-12-25,-5,25,0,30
"12779",1994-12-26,-23,70,3,93
"12780",1994-12-27,2,80,0,78
"12781",1994-12-28,-30,59,0,89
"12782",1994-12-29,-27,59,23,86
"12783",1994-12-30,3,26,80,23
"12784",1994-12-31,-28,19,0,47
"12785",1995-01-01,-44,29,0,73
"12786",1995-01-02,-28,61,0,89
"12787",1995-01-03,-4,76,0,80
"12788",1995-01-04,3,81,0,78
"12789",1995-01-05,30,123,0,93
"12790",1995-01-06,-6,159,0,165
"12791",1995-01-07,-19,152,0,171
"12792",1995-01-08,-23,157,0,180
"12793",1995-01-09,10,111,0,101
"12794",1995-01-10,-8,53,0,61
"12795",1995-01-11,-33,85,0,118
"12796",1995-01-12,-23,82,0,105
"12797",1995-01-13,-40,63,0,103
"12798",1995-01-14,-64,52,0,116
"12799",1995-01-15,-62,78,0,140
"12800",1995-01-16,-33,97,0,130
"12801",1995-01-17,-61,82,0,143
"12802",1995-01-18,-14,45,0,59
"12803",1995-01-19,-18,73,0,91
"12804",1995-01-20,-29,28,0,57
"12805",1995-01-21,-2,26,0,28
"12806",1995-01-22,-60,76,0,136
"12807",1995-01-23,-32,80,0,112
"12808",1995-01-24,-63,122,0,185
"12809",1995-01-25,-33,87,0,120
"12810",1995-01-26,-35,49,0,84
"12811",1995-01-27,-67,64,0,131
"12812",1995-01-28,-62,89,0,151
"12813",1995-01-29,-45,46,0,91
"12814",1995-01-30,-53,74,0,127
"12815",1995-01-31,-66,51,0,117
"12816",1995-02-01,-79,23,0,102
"12817",1995-02-02,-88,63,0,151
"12818",1995-02-03,-46,56,0,102
"12819",1995-02-04,-36,57,0,93
"12820",1995-02-05,-65,102,0,167
"12821",1995-02-06,-34,139,0,173
"12822",1995-02-07,-61,157,0,218
"12823",1995-02-08,15,126,0,111
"12824",1995-02-09,-28,116,0,144
"12825",1995-02-10,-15,121,0,136
"12826",1995-02-11,0,116,0,116
"12827",1995-02-12,-3,131,0,134
"12828",1995-02-13,-5,84,0,89
"12829",1995-02-14,-7,130,0,137
"12830",1995-02-15,35,132,0,97
"12831",1995-02-16,-43,119,0,162
"12832",1995-02-17,-8,111,0,119
"12833",1995-02-18,17,131,0,114
"12834",1995-02-19,-15,114,0,129
"12835",1995-02-20,-12,69,0,81
"12836",1995-02-21,-12,61,0,73
"12837",1995-02-22,-38,120,0,158
"12838",1995-02-23,3,119,0,116
"12839",1995-02-24,-6,136,0,142
"12840",1995-02-25,45,132,0,87
"12841",1995-02-26,-20,180,0,200
"12842",1995-02-27,50,114,0,64
"12843",1995-02-28,-54,116,0,170
"12844",1995-03-01,10,144,0,134
"12845",1995-03-02,31,122,0,91
"12846",1995-03-03,-13,125,0,138
"12847",1995-03-04,-33,NA,0,NA
"12848",1995-03-05,-30,193,0,223
"12849",1995-03-06,13,210,0,197
"12850",1995-03-07,21,202,0,181
"12851",1995-03-08,73,162,8,89
"12852",1995-03-09,72,121,24,49
"12853",1995-03-10,-20,194,0,214
"12854",1995-03-11,80,128,0,48
"12855",1995-03-12,9,158,0,149
"12856",1995-03-13,21,167,0,146
"12857",1995-03-14,18,177,0,159
"12858",1995-03-15,86,149,0,63
"12859",1995-03-16,37,112,41,75
"12860",1995-03-17,0,103,0,103
"12861",1995-03-18,-10,167,0,177
"12862",1995-03-19,39,204,0,165
"12863",1995-03-20,58,262,0,204
"12864",1995-03-21,97,211,0,114
"12865",1995-03-22,58,197,0,139
"12866",1995-03-23,33,126,10,93
"12867",1995-03-24,19,57,82,38
"12868",1995-03-25,18,137,2,119
"12869",1995-03-26,-5,200,0,205
"12870",1995-03-27,24,145,0,121
"12871",1995-03-28,47,122,6,75
"12872",1995-03-29,6,137,0,131
"12873",1995-03-30,33,177,0,144
"12874",1995-03-31,78,144,0,66
"12875",1995-04-01,23,203,0,180
"12876",1995-04-02,47,132,0,85
"12877",1995-04-03,-14,149,0,163
"12878",1995-04-04,42,205,0,163
"12879",1995-04-05,72,238,0,166
"12880",1995-04-06,124,227,0,103
"12881",1995-04-07,73,252,0,179
"12882",1995-04-08,77,206,0,129
"12883",1995-04-09,96,181,0,85
"12884",1995-04-10,53,216,0,163
"12885",1995-04-11,36,215,0,179
"12886",1995-04-12,50,235,0,185
"12887",1995-04-13,153,197,0,44
"12888",1995-04-14,114,197,0,83
"12889",1995-04-15,130,210,0,80
"12890",1995-04-16,130,207,2,77
"12891",1995-04-17,60,220,0,160
"12892",1995-04-18,140,192,0,52
"12893",1995-04-19,41,207,0,166
"12894",1995-04-20,97,227,0,130
"12895",1995-04-21,155,216,42,61
"12896",1995-04-22,107,173,91,66
"12897",1995-04-23,95,205,0,110
"12898",1995-04-24,90,246,0,156
"12899",1995-04-25,137,196,0,59
"12900",1995-04-26,65,174,0,109
"12901",1995-04-27,86,244,0,158
"12902",1995-04-28,87,280,0,193
"12903",1995-04-29,125,274,0,149
"12904",1995-04-30,167,290,0,123
"12905",1995-05-01,142,232,0,90
"12906",1995-05-02,97,267,0,170
"12907",1995-05-03,112,186,0,74
"12908",1995-05-04,102,247,0,145
"12909",1995-05-05,67,321,0,254
"12910",1995-05-06,126,261,0,135
"12911",1995-05-07,116,310,0,194
"12912",1995-05-08,175,352,0,177
"12913",1995-05-09,157,297,0,140
"12914",1995-05-10,72,240,0,168
"12915",1995-05-11,127,255,2,128
"12916",1995-05-12,136,208,3,72
"12917",1995-05-13,152,275,1,123
"12918",1995-05-14,128,214,0,86
"12919",1995-05-15,97,296,0,199
"12920",1995-05-16,163,317,0,154
"12921",1995-05-17,191,319,0,128
"12922",1995-05-18,175,278,0,103
"12923",1995-05-19,188,247,83,59
"12924",1995-05-20,175,217,4,42
"12925",1995-05-21,157,282,2,125
"12926",1995-05-22,139,327,0,188
"12927",1995-05-23,165,309,0,144
"12928",1995-05-24,207,337,0,130
"12929",1995-05-25,215,323,0,108
"12930",1995-05-26,205,284,0,79
"12931",1995-05-27,176,237,16,61
"12932",1995-05-28,155,317,14,162
"12933",1995-05-29,189,327,0,138
"12934",1995-05-30,206,350,0,144
"12935",1995-05-31,205,312,0,107
"12936",1995-06-01,205,315,0,110
"12937",1995-06-02,226,312,0,86
"12938",1995-06-03,221,330,0,109
"12939",1995-06-04,187,332,0,145
"12940",1995-06-05,213,345,0,132
"12941",1995-06-06,232,350,0,118
"12942",1995-06-07,189,342,107,153
"12943",1995-06-08,184,304,10,120
"12944",1995-06-09,178,286,105,108
"12945",1995-06-10,175,222,97,47
"12946",1995-06-11,173,268,55,95
"12947",1995-06-12,157,291,0,134
"12948",1995-06-13,166,305,0,139
"12949",1995-06-14,216,267,0,51
"12950",1995-06-15,175,317,0,142
"12951",1995-06-16,204,320,0,116
"12952",1995-06-17,210,320,0,110
"12953",1995-06-18,177,354,0,177
"12954",1995-06-19,193,366,0,173
"12955",1995-06-20,230,328,16,98
"12956",1995-06-21,203,323,0,120
"12957",1995-06-22,227,341,0,114
"12958",1995-06-23,234,332,0,98
"12959",1995-06-24,229,384,0,155
"12960",1995-06-25,241,365,0,124
"12961",1995-06-26,210,370,0,160
"12962",1995-06-27,195,327,0,132
"12963",1995-06-28,215,356,0,141
"12964",1995-06-29,219,320,29,101
"12965",1995-06-30,175,303,0,128
"12966",1995-07-01,212,320,0,108
"12967",1995-07-02,189,332,0,143
"12968",1995-07-03,203,350,47,147
"12969",1995-07-04,206,361,0,155
"12970",1995-07-05,233,363,0,130
"12971",1995-07-06,215,341,0,126
"12972",1995-07-07,230,294,1,64
"12973",1995-07-08,207,295,34,88
"12974",1995-07-09,193,335,0,142
"12975",1995-07-10,232,342,0,110
"12976",1995-07-11,234,324,348,90
"12977",1995-07-12,247,344,0,97
"12978",1995-07-13,263,344,165,81
"12979",1995-07-14,260,343,10,83
"12980",1995-07-15,266,348,0,82
"12981",1995-07-16,264,338,0,74
"12982",1995-07-17,246,307,321,61
"12983",1995-07-18,207,283,34,76
"12984",1995-07-19,188,273,0,85
"12985",1995-07-20,218,274,5,56
"12986",1995-07-21,237,297,0,60
"12987",1995-07-22,252,314,0,62
"12988",1995-07-23,240,327,179,87
"12989",1995-07-24,206,253,170,47
"12990",1995-07-25,208,248,639,40
"12991",1995-07-26,174,294,0,120
"12992",1995-07-27,236,312,116,76
"12993",1995-07-28,242,332,0,90
"12994",1995-07-29,250,336,0,86
"12995",1995-07-30,265,342,0,77
"12996",1995-07-31,243,328,0,85
"12997",1995-08-01,268,329,0,61
"12998",1995-08-02,256,321,0,65
"12999",1995-08-03,257,307,2,50
"13000",1995-08-04,237,281,4,44
"13001",1995-08-05,244,284,63,40
"13002",1995-08-06,220,308,205,88
"13003",1995-08-07,213,297,26,84
"13004",1995-08-08,209,316,0,107
"13005",1995-08-09,213,323,0,110
"13006",1995-08-10,242,324,0,82
"13007",1995-08-11,249,327,0,78
"13008",1995-08-12,234,304,0,70
"13009",1995-08-13,207,280,39,73
"13010",1995-08-14,222,264,0,42
"13011",1995-08-15,210,240,114,30
"13012",1995-08-16,214,300,34,86
"13013",1995-08-17,225,304,0,79
"13014",1995-08-18,225,320,0,95
"13015",1995-08-19,200,321,0,121
"13016",1995-08-20,195,334,18,139
"13017",1995-08-21,205,293,422,88
"13018",1995-08-22,197,272,543,75
"13019",1995-08-23,191,300,0,109
"13020",1995-08-24,211,307,0,96
"13021",1995-08-25,224,311,0,87
"13022",1995-08-26,222,315,0,93
"13023",1995-08-27,215,313,0,98
"13024",1995-08-28,215,310,0,95
"13025",1995-08-29,217,266,66,49
"13026",1995-08-30,217,247,1,30
"13027",1995-08-31,227,290,0,63
"13028",1995-09-01,222,307,0,85
"13029",1995-09-02,242,347,0,105
"13030",1995-09-03,216,301,0,85
"13031",1995-09-04,183,220,81,37
"13032",1995-09-05,180,248,7,68
"13033",1995-09-06,217,241,1,24
"13034",1995-09-07,168,222,0,54
"13035",1995-09-08,165,201,0,36
"13036",1995-09-09,170,217,5,47
"13037",1995-09-10,170,211,19,41
"13038",1995-09-11,149,253,0,104
"13039",1995-09-12,124,213,0,89
"13040",1995-09-13,125,294,0,169
"13041",1995-09-14,152,266,0,114
"13042",1995-09-15,149,292,0,143
"13043",1995-09-16,165,283,0,118
"13044",1995-09-17,135,288,0,153
"13045",1995-09-18,145,286,0,141
"13046",1995-09-19,178,250,0,72
"13047",1995-09-20,139,259,0,120
"13048",1995-09-21,132,289,0,157
"13049",1995-09-22,138,293,0,155
"13050",1995-09-23,151,298,0,147
"13051",1995-09-24,75,235,0,160
"13052",1995-09-25,94,258,0,164
"13053",1995-09-26,68,215,0,147
"13054",1995-09-27,73,234,0,161
"13055",1995-09-28,102,282,0,180
"13056",1995-09-29,130,293,0,163
"13057",1995-09-30,159,283,0,124
"13058",1995-10-01,148,246,6,98
"13059",1995-10-02,133,201,442,68
"13060",1995-10-03,115,225,13,110
"13061",1995-10-04,117,233,0,116
"13062",1995-10-05,105,218,0,113
"13063",1995-10-06,105,163,0,58
"13064",1995-10-07,80,220,0,140
"13065",1995-10-08,90,239,0,149
"13066",1995-10-09,89,245,0,156
"13067",1995-10-10,102,242,0,140
"13068",1995-10-11,117,258,0,141
"13069",1995-10-12,157,263,21,106
"13070",1995-10-13,173,204,171,31
"13071",1995-10-14,142,272,0,130
"13072",1995-10-15,149,217,0,68
"13073",1995-10-16,124,237,0,113
"13074",1995-10-17,132,212,0,80
"13075",1995-10-18,140,185,18,45
"13076",1995-10-19,123,144,13,21
"13077",1995-10-20,112,146,59,34
"13078",1995-10-21,118,196,0,78
"13079",1995-10-22,110,197,10,87
"13080",1995-10-23,136,172,127,36
"13081",1995-10-24,94,194,0,100
"13082",1995-10-25,45,218,0,173
"13083",1995-10-26,73,203,0,130
"13084",1995-10-27,125,225,0,100
"13085",1995-10-28,80,220,0,140
"13086",1995-10-29,105,199,0,94
"13087",1995-10-30,97,187,0,90
"13088",1995-10-31,95,170,0,75
"13089",1995-11-01,-1,125,0,126
"13090",1995-11-02,0,184,0,184
"13091",1995-11-03,32,211,0,179
"13092",1995-11-04,31,237,0,206
"13093",1995-11-05,62,250,0,188
"13094",1995-11-06,50,256,0,206
"13095",1995-11-07,75,176,0,101
"13096",1995-11-08,31,175,0,144
"13097",1995-11-09,9,208,0,199
"13098",1995-11-10,55,194,0,139
"13099",1995-11-11,21,227,0,206
"13100",1995-11-12,10,243,0,233
"13101",1995-11-13,102,213,0,111
"13102",1995-11-14,20,202,0,182
"13103",1995-11-15,18,196,0,178
"13104",1995-11-16,23,186,0,163
"13105",1995-11-17,20,150,0,130
"13106",1995-11-18,28,157,2,129
"13107",1995-11-19,27,118,20,91
"13108",1995-11-20,-34,122,0,156
"13109",1995-11-21,-32,153,0,185
"13110",1995-11-22,41,133,0,92
"13111",1995-11-23,12,100,0,88
"13112",1995-11-24,40,143,0,103
"13113",1995-11-25,1,179,0,178
"13114",1995-11-26,62,124,0,62
"13115",1995-11-27,-10,123,0,133
"13116",1995-11-28,-13,117,0,130
"13117",1995-11-29,50,108,0,58
"13118",1995-11-30,24,131,0,107
"13119",1995-12-01,60,103,0,43
"13120",1995-12-02,17,72,0,55
"13121",1995-12-03,2,78,0,76
"13122",1995-12-04,-27,105,0,132
"13123",1995-12-05,-52,84,0,136
"13124",1995-12-06,-73,71,0,144
"13125",1995-12-07,-75,82,0,157
"13126",1995-12-08,-65,77,0,142
"13127",1995-12-09,-8,88,0,96
"13128",1995-12-10,-27,50,0,77
"13129",1995-12-11,32,82,0,50
"13130",1995-12-12,-46,78,0,124
"13131",1995-12-13,-4,87,3,91
"13132",1995-12-14,-7,113,0,120
"13133",1995-12-15,0,54,0,54
"13134",1995-12-16,4,62,10,58
"13135",1995-12-17,-21,63,0,84
"13136",1995-12-18,-38,81,0,119
"13137",1995-12-19,-59,103,0,162
"13138",1995-12-20,-56,121,0,177
"13139",1995-12-21,-58,123,0,181
"13140",1995-12-22,-23,91,0,114
"13141",1995-12-23,-54,120,0,174
"13142",1995-12-24,-31,90,0,121
"13143",1995-12-25,-42,9,0,51
"13144",1995-12-26,-34,57,0,91
"13145",1995-12-27,-23,94,0,117
"13146",1995-12-28,-40,83,0,123
"13147",1995-12-29,-35,112,0,147
"13148",1995-12-30,13,137,0,124
"13149",1995-12-31,25,98,0,73
"13150",1996-01-01,-48,167,0,215
"13151",1996-01-02,46,157,0,111
"13152",1996-01-03,-38,104,0,142
"13153",1996-01-04,-68,68,0,136
"13154",1996-01-05,-45,70,0,115
"13155",1996-01-06,-60,78,0,138
"13156",1996-01-07,4,104,0,100
"13157",1996-01-08,-70,40,0,110
"13158",1996-01-09,-98,56,0,154
"13159",1996-01-10,-78,60,0,138
"13160",1996-01-11,-75,74,0,149
"13161",1996-01-12,-27,25,0,52
"13162",1996-01-13,-14,22,6,36
"13163",1996-01-14,-40,3,4,43
"13164",1996-01-15,-43,48,0,91
"13165",1996-01-16,-51,32,0,83
"13166",1996-01-17,-21,22,0,43
"13167",1996-01-18,-39,14,0,53
"13168",1996-01-19,-62,62,0,124
"13169",1996-01-20,-67,29,0,96
"13170",1996-01-21,-6,27,0,33
"13171",1996-01-22,-40,56,0,96
"13172",1996-01-23,-45,51,0,96
"13173",1996-01-24,-35,32,0,67
"13174",1996-01-25,-54,38,0,92
"13175",1996-01-26,-51,85,0,136
"13176",1996-01-27,-24,87,0,111
"13177",1996-01-28,15,99,0,84
"13178",1996-01-29,-16,92,0,108
"13179",1996-01-30,-25,23,0,48
"13180",1996-01-31,-25,47,0,72
"13181",1996-02-01,-54,65,0,119
"13182",1996-02-02,-93,63,0,156
"13183",1996-02-03,-62,117,0,179
"13184",1996-02-04,-19,87,0,106
"13185",1996-02-05,-74,77,0,151
"13186",1996-02-06,-61,76,0,137
"13187",1996-02-07,-13,116,0,129
"13188",1996-02-08,-34,55,0,89
"13189",1996-02-09,-85,79,0,164
"13190",1996-02-10,-76,123,0,199
"13191",1996-02-11,-26,192,0,218
"13192",1996-02-12,-12,191,0,203
"13193",1996-02-13,12,241,0,229
"13194",1996-02-14,62,176,0,114
"13195",1996-02-15,12,92,0,80
"13196",1996-02-16,-44,33,155,77
"13197",1996-02-17,-50,-11,22,39
"13198",1996-02-18,-109,3,0,112
"13199",1996-02-19,-84,14,0,98
"13200",1996-02-20,-71,21,0,92
"13201",1996-02-21,-52,37,0,89
"13202",1996-02-22,-49,71,0,120
"13203",1996-02-23,-38,83,0,121
"13204",1996-02-24,-7,78,0,85
"13205",1996-02-25,-32,99,0,131
"13206",1996-02-26,24,112,0,88
"13207",1996-02-27,-60,87,0,147
"13208",1996-02-28,-18,138,0,156
"13209",1996-02-29,35,173,0,138
"13210",1996-03-01,-40,128,0,168
"13211",1996-03-02,11,124,0,113
"13212",1996-03-03,-17,164,0,181
"13213",1996-03-04,-16,138,0,154
"13214",1996-03-05,17,106,0,89
"13215",1996-03-06,10,152,0,142
"13216",1996-03-07,22,127,0,105
"13217",1996-03-08,38,104,0,66
"13218",1996-03-09,1,87,0,86
"13219",1996-03-10,-15,144,0,159
"13220",1996-03-11,27,87,0,60
"13221",1996-03-12,-15,167,0,182
"13222",1996-03-13,37,212,0,175
"13223",1996-03-14,94,163,0,69
"13224",1996-03-15,47,148,0,101
"13225",1996-03-16,84,163,0,79
"13226",1996-03-17,46,114,0,68
"13227",1996-03-18,-10,121,0,131
"13228",1996-03-19,14,99,0,85
"13229",1996-03-20,18,73,5,55
"13230",1996-03-21,38,97,3,59
"13231",1996-03-22,20,76,0,56
"13232",1996-03-23,9,43,0,34
"13233",1996-03-24,10,82,8,72
"13234",1996-03-25,1,132,0,131
"13235",1996-03-26,30,107,0,77
"13236",1996-03-27,45,122,0,77
"13237",1996-03-28,51,107,40,56
"13238",1996-03-29,44,67,81,23
"13239",1996-03-30,4,167,0,163
"13240",1996-03-31,81,127,0,46
"13241",1996-04-01,58,123,0,65
"13242",1996-04-02,41,127,0,86
"13243",1996-04-03,20,156,0,136
"13244",1996-04-04,24,174,0,150
"13245",1996-04-05,59,155,0,96
"13246",1996-04-06,81,195,0,114
"13247",1996-04-07,60,182,0,122
"13248",1996-04-08,98,199,0,101
"13249",1996-04-09,98,150,1,52
"13250",1996-04-10,67,143,0,76
"13251",1996-04-11,33,167,0,134
"13252",1996-04-12,89,134,0,45
"13253",1996-04-13,52,116,0,64
"13254",1996-04-14,57,178,0,121
"13255",1996-04-15,99,237,0,138
"13256",1996-04-16,142,296,0,154
"13257",1996-04-17,145,245,0,100
"13258",1996-04-18,97,172,3,75
"13259",1996-04-19,54,218,0,164
"13260",1996-04-20,54,181,0,127
"13261",1996-04-21,49,248,0,199
"13262",1996-04-22,60,291,0,231
"13263",1996-04-23,113,283,0,170
"13264",1996-04-24,148,242,0,94
"13265",1996-04-25,109,257,0,148
"13266",1996-04-26,122,283,0,161
"13267",1996-04-27,179,233,11,54
"13268",1996-04-28,170,183,331,13
"13269",1996-04-29,152,225,5,73
"13270",1996-04-30,156,249,0,93
"13271",1996-05-01,165,255,0,90
"13272",1996-05-02,145,201,1,56
"13273",1996-05-03,113,165,107,52
"13274",1996-05-04,118,247,0,129
"13275",1996-05-05,127,234,0,107
"13276",1996-05-06,152,251,0,99
"13277",1996-05-07,173,246,0,73
"13278",1996-05-08,107,266,0,159
"13279",1996-05-09,95,304,0,209
"13280",1996-05-10,142,230,0,88
"13281",1996-05-11,119,260,0,141
"13282",1996-05-12,92,285,0,193
"13283",1996-05-13,147,262,0,115
"13284",1996-05-14,166,232,0,66
"13285",1996-05-15,159,256,0,97
"13286",1996-05-16,138,249,0,111
"13287",1996-05-17,118,272,0,154
"13288",1996-05-18,147,284,0,137
"13289",1996-05-19,175,329,0,154
"13290",1996-05-20,163,356,0,193
"13291",1996-05-21,169,302,0,133
"13292",1996-05-22,146,296,0,150
"13293",1996-05-23,190,281,0,91
"13294",1996-05-24,175,275,27,100
"13295",1996-05-25,164,314,0,150
"13296",1996-05-26,193,326,0,133
"13297",1996-05-27,177,274,37,97
"13298",1996-05-28,179,266,0,87
"13299",1996-05-29,160,294,0,134
"13300",1996-05-30,167,306,0,139
"13301",1996-05-31,185,286,4,101
"13302",1996-06-01,214,299,0,85
"13303",1996-06-02,216,274,19,58
"13304",1996-06-03,210,263,10,53
"13305",1996-06-04,143,245,71,102
"13306",1996-06-05,142,281,0,139
"13307",1996-06-06,190,235,2,45
"13308",1996-06-07,163,257,12,94
"13309",1996-06-08,168,281,2,113
"13310",1996-06-09,183,296,0,113
"13311",1996-06-10,169,362,0,193
"13312",1996-06-11,214,325,0,111
"13313",1996-06-12,193,381,0,188
"13314",1996-06-13,229,384,0,155
"13315",1996-06-14,235,354,0,119
"13316",1996-06-15,263,374,0,111
"13317",1996-06-16,220,309,0,89
"13318",1996-06-17,202,316,4,114
"13319",1996-06-18,217,344,0,127
"13320",1996-06-19,210,344,12,134
"13321",1996-06-20,236,332,0,96
"13322",1996-06-21,236,335,0,99
"13323",1996-06-22,191,364,0,173
"13324",1996-06-23,237,318,10,81
"13325",1996-06-24,195,286,2,91
"13326",1996-06-25,186,315,0,129
"13327",1996-06-26,211,311,0,100
"13328",1996-06-27,212,379,0,167
"13329",1996-06-28,211,333,9,122
"13330",1996-06-29,188,378,0,190
"13331",1996-06-30,214,379,0,165
"13332",1996-07-01,231,380,0,149
"13333",1996-07-02,240,355,0,115
"13334",1996-07-03,245,311,238,66
"13335",1996-07-04,236,330,0,94
"13336",1996-07-05,238,349,0,111
"13337",1996-07-06,246,364,0,118
"13338",1996-07-07,243,345,0,102
"13339",1996-07-08,229,298,28,69
"13340",1996-07-09,216,243,118,27
"13341",1996-07-10,192,261,27,69
"13342",1996-07-11,183,238,67,55
"13343",1996-07-12,186,264,0,78
"13344",1996-07-13,188,261,151,73
"13345",1996-07-14,221,247,4,26
"13346",1996-07-15,210,305,0,95
"13347",1996-07-16,220,311,0,91
"13348",1996-07-17,226,278,2,52
"13349",1996-07-18,220,294,0,74
"13350",1996-07-19,220,323,0,103
"13351",1996-07-20,240,326,0,86
"13352",1996-07-21,238,308,0,70
"13353",1996-07-22,241,336,0,95
"13354",1996-07-23,260,340,0,80
"13355",1996-07-24,275,369,0,94
"13356",1996-07-25,251,327,0,76
"13357",1996-07-26,245,292,12,47
"13358",1996-07-27,263,312,67,49
"13359",1996-07-28,259,325,36,66
"13360",1996-07-29,259,331,41,72
"13361",1996-07-30,253,342,360,89
"13362",1996-07-31,238,282,184,44
"13363",1996-08-01,227,303,0,76
"13364",1996-08-02,256,284,165,28
"13365",1996-08-03,245,272,928,27
"13366",1996-08-04,243,312,349,69
"13367",1996-08-05,251,294,247,43
"13368",1996-08-06,246,339,0,93
"13369",1996-08-07,265,331,20,66
"13370",1996-08-08,257,331,0,74
"13371",1996-08-09,254,313,0,59
"13372",1996-08-10,257,317,11,60
"13373",1996-08-11,236,300,94,64
"13374",1996-08-12,222,305,0,83
"13375",1996-08-13,221,324,13,103
"13376",1996-08-14,205,306,0,101
"13377",1996-08-15,228,325,0,97
"13378",1996-08-16,238,328,0,90
"13379",1996-08-17,233,329,0,96
"13380",1996-08-18,224,316,0,92
"13381",1996-08-19,217,309,0,92
"13382",1996-08-20,199,309,0,110
"13383",1996-08-21,228,288,0,60
"13384",1996-08-22,221,312,0,91
"13385",1996-08-23,179,238,18,59
"13386",1996-08-24,178,221,0,43
"13387",1996-08-25,172,208,0,36
"13388",1996-08-26,169,202,18,33
"13389",1996-08-27,175,251,4,76
"13390",1996-08-28,156,297,0,141
"13391",1996-08-29,195,311,0,116
"13392",1996-08-30,180,297,0,117
"13393",1996-08-31,195,297,0,102
"13394",1996-09-01,181,314,0,133
"13395",1996-09-02,188,304,0,116
"13396",1996-09-03,171,217,0,46
"13397",1996-09-04,163,211,10,48
"13398",1996-09-05,163,190,283,27
"13399",1996-09-06,148,249,0,101
"13400",1996-09-07,163,243,0,80
"13401",1996-09-08,188,219,112,31
"13402",1996-09-09,148,247,5,99
"13403",1996-09-10,187,225,14,38
"13404",1996-09-11,190,237,22,47
"13405",1996-09-12,192,299,0,107
"13406",1996-09-13,195,301,0,106
"13407",1996-09-14,208,298,0,90
"13408",1996-09-15,188,265,0,77
"13409",1996-09-16,192,286,0,94
"13410",1996-09-17,182,237,776,55
"13411",1996-09-18,165,197,44,32
"13412",1996-09-19,153,250,0,97
"13413",1996-09-20,150,253,0,103
"13414",1996-09-21,150,283,0,133
"13415",1996-09-22,149,306,0,157
"13416",1996-09-23,157,315,0,158
"13417",1996-09-24,175,304,0,129
"13418",1996-09-25,155,282,0,127
"13419",1996-09-26,183,253,0,70
"13420",1996-09-27,173,238,0,65
"13421",1996-09-28,147,256,0,109
"13422",1996-09-29,135,260,0,125
"13423",1996-09-30,145,259,0,114
"13424",1996-10-01,148,215,14,67
"13425",1996-10-02,115,275,0,160
"13426",1996-10-03,130,236,0,106
"13427",1996-10-04,106,252,0,146
"13428",1996-10-05,121,193,89,72
"13429",1996-10-06,88,161,10,73
"13430",1996-10-07,115,192,0,77
"13431",1996-10-08,73,230,0,157
"13432",1996-10-09,80,224,0,144
"13433",1996-10-10,83,225,0,142
"13434",1996-10-11,122,231,0,109
"13435",1996-10-12,96,241,0,145
"13436",1996-10-13,119,261,0,142
"13437",1996-10-14,131,261,0,130
"13438",1996-10-15,92,245,0,153
"13439",1996-10-16,132,186,0,54
"13440",1996-10-17,130,222,22,92
"13441",1996-10-18,99,236,0,137
"13442",1996-10-19,128,178,0,50
"13443",1996-10-20,97,224,0,127
"13444",1996-10-21,60,206,0,146
"13445",1996-10-22,83,212,0,129
"13446",1996-10-23,123,177,24,54
"13447",1996-10-24,115,157,29,42
"13448",1996-10-25,107,189,0,82
"13449",1996-10-26,34,169,0,135
"13450",1996-10-27,40,223,0,183
"13451",1996-10-28,72,272,0,200
"13452",1996-10-29,101,262,0,161
"13453",1996-10-30,100,180,2,80
"13454",1996-10-31,57,101,305,44
"13455",1996-11-01,43,104,101,61
"13456",1996-11-02,42,158,0,116
"13457",1996-11-03,68,115,4,47
"13458",1996-11-04,100,150,3,50
"13459",1996-11-05,78,171,0,93
"13460",1996-11-06,29,128,16,99
"13461",1996-11-07,27,60,123,33
"13462",1996-11-08,55,148,3,93
"13463",1996-11-09,30,199,0,169
"13464",1996-11-10,87,143,0,56
"13465",1996-11-11,98,118,0,20
"13466",1996-11-12,34,107,0,73
"13467",1996-11-13,28,60,2,32
"13468",1996-11-14,26,58,21,32
"13469",1996-11-15,37,77,1,40
"13470",1996-11-16,12,66,41,54
"13471",1996-11-17,46,102,0,56
"13472",1996-11-18,47,135,0,88
"13473",1996-11-19,-3,157,0,160
"13474",1996-11-20,21,175,0,154
"13475",1996-11-21,14,128,0,114
"13476",1996-11-22,-15,164,0,179
"13477",1996-11-23,67,136,0,69
"13478",1996-11-24,15,154,0,139
"13479",1996-11-25,35,134,0,99
"13480",1996-11-26,54,141,1,87
"13481",1996-11-27,-27,97,0,124
"13482",1996-11-28,-17,41,0,58
"13483",1996-11-29,-26,75,0,101
"13484",1996-11-30,-6,64,0,70
"13485",1996-12-01,-59,74,0,133
"13486",1996-12-02,-4,79,0,83
"13487",1996-12-03,-13,70,0,83
"13488",1996-12-04,18,68,0,50
"13489",1996-12-05,-4,49,0,53
"13490",1996-12-06,-40,78,0,118
"13491",1996-12-07,-15,115,0,130
"13492",1996-12-08,5,103,0,98
"13493",1996-12-09,13,112,0,99
"13494",1996-12-10,47,130,0,83
"13495",1996-12-11,32,124,0,92
"13496",1996-12-12,11,137,0,126
"13497",1996-12-13,-18,166,0,184
"13498",1996-12-14,-20,161,0,181
"13499",1996-12-15,10,123,0,113
"13500",1996-12-16,0,68,0,68
"13501",1996-12-17,-13,50,0,63
"13502",1996-12-18,-52,67,0,119
"13503",1996-12-19,-47,100,0,147
"13504",1996-12-20,-43,118,0,161
"13505",1996-12-21,2,172,0,170
"13506",1996-12-22,4,101,0,97
"13507",1996-12-23,-43,136,0,179
"13508",1996-12-24,-13,191,0,204
"13509",1996-12-25,1,124,0,123
"13510",1996-12-26,-32,89,0,121
"13511",1996-12-27,-13,66,0,79
"13512",1996-12-28,-44,124,0,168
"13513",1996-12-29,-30,107,0,137
"13514",1996-12-30,-16,22,0,38
"13515",1996-12-31,-4,18,0,22
"13516",1997-01-01,0,59,0,59
"13517",1997-01-02,-47,61,0,108
"13518",1997-01-03,-42,26,0,68
"13519",1997-01-04,-57,82,0,139
"13520",1997-01-05,-89,20,0,109
"13521",1997-01-06,-87,11,0,98
"13522",1997-01-07,-101,4,0,105
"13523",1997-01-08,-92,-5,0,87
"13524",1997-01-09,-48,62,0,110
"13525",1997-01-10,-53,24,0,77
"13526",1997-01-11,-79,77,0,156
"13527",1997-01-12,-61,101,0,162
"13528",1997-01-13,-18,47,0,65
"13529",1997-01-14,-48,17,0,65
"13530",1997-01-15,-37,27,0,64
"13531",1997-01-16,-69,83,0,152
"13532",1997-01-17,7,61,0,54
"13533",1997-01-18,-55,94,0,149
"13534",1997-01-19,-50,146,0,196
"13535",1997-01-20,-36,47,0,83
"13536",1997-01-21,-20,30,0,50
"13537",1997-01-22,-22,18,36,40
"13538",1997-01-23,-42,3,41,45
"13539",1997-01-24,-97,39,0,136
"13540",1997-01-25,-77,86,0,163
"13541",1997-01-26,14,115,0,101
"13542",1997-01-27,0,122,0,122
"13543",1997-01-28,-25,126,0,151
"13544",1997-01-29,-24,102,0,126
"13545",1997-01-30,18,76,0,58
"13546",1997-01-31,-24,26,0,50
"13547",1997-02-01,7,53,3,46
"13548",1997-02-02,-20,34,0,54
"13549",1997-02-03,-27,15,0,42
"13550",1997-02-04,-27,56,0,83
"13551",1997-02-05,-45,68,0,113
"13552",1997-02-06,-33,42,0,75
"13553",1997-02-07,-55,87,0,142
"13554",1997-02-08,-30,113,0,143
"13555",1997-02-09,-16,138,0,154
"13556",1997-02-10,-14,87,0,101
"13557",1997-02-11,-56,97,0,153
"13558",1997-02-12,-42,120,0,162
"13559",1997-02-13,-32,101,0,133
"13560",1997-02-14,4,127,0,123
"13561",1997-02-15,49,111,0,62
"13562",1997-02-16,-40,57,0,97
"13563",1997-02-17,-39,136,0,175
"13564",1997-02-18,-23,142,0,165
"13565",1997-02-19,-40,167,0,207
"13566",1997-02-20,39,173,0,134
"13567",1997-02-21,-9,137,0,146
"13568",1997-02-22,25,125,0,100
"13569",1997-02-23,52,95,7,43
"13570",1997-02-24,42,104,21,62
"13571",1997-02-25,19,97,8,78
"13572",1997-02-26,58,90,13,32
"13573",1997-02-27,53,67,77,14
"13574",1997-02-28,21,142,7,121
"13575",1997-03-01,-6,164,0,170
"13576",1997-03-02,-6,131,0,137
"13577",1997-03-03,-4,177,0,181
"13578",1997-03-04,13,218,0,205
"13579",1997-03-05,34,197,0,163
"13580",1997-03-06,118,220,0,102
"13581",1997-03-07,83,207,0,124
"13582",1997-03-08,69,224,0,155
"13583",1997-03-09,34,142,37,108
"13584",1997-03-10,58,98,0,40
"13585",1997-03-11,75,98,73,23
"13586",1997-03-12,52,87,55,35
"13587",1997-03-13,59,77,209,18
"13588",1997-03-14,36,73,34,37
"13589",1997-03-15,29,110,14,81
"13590",1997-03-16,59,117,0,58
"13591",1997-03-17,-1,145,0,146
"13592",1997-03-18,49,94,0,45
"13593",1997-03-19,64,126,0,62
"13594",1997-03-20,22,147,0,125
"13595",1997-03-21,33,162,0,129
"13596",1997-03-22,44,151,0,107
"13597",1997-03-23,50,118,0,68
"13598",1997-03-24,43,104,0,61
"13599",1997-03-25,50,172,0,122
"13600",1997-03-26,52,189,0,137
"13601",1997-03-27,56,194,0,138
"13602",1997-03-28,89,217,0,128
"13603",1997-03-29,128,270,0,142
"13604",1997-03-30,60,208,0,148
"13605",1997-03-31,65,198,0,133
"13606",1997-04-01,118,187,23,69
"13607",1997-04-02,84,121,17,37
"13608",1997-04-03,59,86,0,27
"13609",1997-04-04,13,179,0,166
"13610",1997-04-05,62,247,0,185
"13611",1997-04-06,64,262,0,198
"13612",1997-04-07,133,182,22,49
"13613",1997-04-08,86,146,33,60
"13614",1997-04-09,70,168,0,98
"13615",1997-04-10,57,201,0,144
"13616",1997-04-11,65,223,0,158
"13617",1997-04-12,57,242,0,185
"13618",1997-04-13,104,266,0,162
"13619",1997-04-14,134,220,0,86
"13620",1997-04-15,120,199,123,79
"13621",1997-04-16,83,164,0,81
"13622",1997-04-17,73,141,42,68
"13623",1997-04-18,56,187,0,131
"13624",1997-04-19,70,208,0,138
"13625",1997-04-20,129,200,0,71
"13626",1997-04-21,134,204,0,70
"13627",1997-04-22,117,191,0,74
"13628",1997-04-23,115,162,27,47
"13629",1997-04-24,97,212,0,115
"13630",1997-04-25,82,233,0,151
"13631",1997-04-26,102,255,0,153
"13632",1997-04-27,122,286,0,164
"13633",1997-04-28,144,325,0,181
"13634",1997-04-29,183,306,0,123
"13635",1997-04-30,156,247,0,91
"13636",1997-05-01,147,316,0,169
"13637",1997-05-02,177,267,0,90
"13638",1997-05-03,145,309,0,164
"13639",1997-05-04,204,263,0,59
"13640",1997-05-05,168,258,0,90
"13641",1997-05-06,111,222,562,111
"13642",1997-05-07,100,178,16,78
"13643",1997-05-08,94,219,0,125
"13644",1997-05-09,97,214,0,117
"13645",1997-05-10,148,233,22,85
"13646",1997-05-11,164,187,82,23
"13647",1997-05-12,168,198,1,30
"13648",1997-05-13,155,257,0,102
"13649",1997-05-14,170,317,0,147
"13650",1997-05-15,213,286,0,73
"13651",1997-05-16,181,269,0,88
"13652",1997-05-17,119,313,0,194
"13653",1997-05-18,149,311,0,162
"13654",1997-05-19,173,284,0,111
"13655",1997-05-20,130,280,0,150
"13656",1997-05-21,146,272,0,126
"13657",1997-05-22,158,300,12,142
"13658",1997-05-23,156,295,22,139
"13659",1997-05-24,155,322,0,167
"13660",1997-05-25,154,333,0,179
"13661",1997-05-26,188,308,0,120
"13662",1997-05-27,185,250,19,65
"13663",1997-05-28,135,291,0,156
"13664",1997-05-29,155,329,0,174
"13665",1997-05-30,148,331,0,183
"13666",1997-05-31,157,359,0,202
"13667",1997-06-01,132,311,0,179
"13668",1997-06-02,134,333,0,199
"13669",1997-06-03,162,303,0,141
"13670",1997-06-04,142,308,0,166
"13671",1997-06-05,211,315,0,104
"13672",1997-06-06,208,272,0,64
"13673",1997-06-07,197,242,35,45
"13674",1997-06-08,174,236,54,62
"13675",1997-06-09,173,303,0,130
"13676",1997-06-10,144,326,0,182
"13677",1997-06-11,156,354,0,198
"13678",1997-06-12,179,359,0,180
"13679",1997-06-13,178,358,0,180
"13680",1997-06-14,191,333,0,142
"13681",1997-06-15,195,335,0,140
"13682",1997-06-16,212,331,0,119
"13683",1997-06-17,186,310,0,124
"13684",1997-06-18,207,327,0,120
"13685",1997-06-19,203,344,0,141
"13686",1997-06-20,199,344,0,145
"13687",1997-06-21,184,384,0,200
"13688",1997-06-22,198,389,0,191
"13689",1997-06-23,221,383,0,162
"13690",1997-06-24,233,302,6,69
"13691",1997-06-25,205,312,2,107
"13692",1997-06-26,216,317,0,101
"13693",1997-06-27,231,332,0,101
"13694",1997-06-28,233,338,63,105
"13695",1997-06-29,229,285,18,56
"13696",1997-06-30,221,300,14,79
"13697",1997-07-01,230,320,0,90
"13698",1997-07-02,241,340,0,99
"13699",1997-07-03,255,369,0,114
"13700",1997-07-04,214,278,79,64
"13701",1997-07-05,226,282,0,56
"13702",1997-07-06,177,352,0,175
"13703",1997-07-07,219,345,0,126
"13704",1997-07-08,204,345,0,141
"13705",1997-07-09,210,354,0,144
"13706",1997-07-10,226,324,0,98
"13707",1997-07-11,211,350,0,139
"13708",1997-07-12,206,350,0,144
"13709",1997-07-13,218,315,0,97
"13710",1997-07-14,203,262,41,59
"13711",1997-07-15,201,346,0,145
"13712",1997-07-16,220,332,0,112
"13713",1997-07-17,233,291,0,58
"13714",1997-07-18,247,318,0,71
"13715",1997-07-19,239,313,137,74
"13716",1997-07-20,231,332,0,101
"13717",1997-07-21,236,339,0,103
"13718",1997-07-22,258,321,21,63
"13719",1997-07-23,242,334,0,92
"13720",1997-07-24,248,335,0,87
"13721",1997-07-25,225,337,0,112
"13722",1997-07-26,235,352,0,117
"13723",1997-07-27,233,358,0,125
"13724",1997-07-28,243,354,0,111
"13725",1997-07-29,255,353,0,98
"13726",1997-07-30,252,354,0,102
"13727",1997-07-31,250,352,125,102
"13728",1997-08-01,258,360,98,102
"13729",1997-08-02,225,297,165,72
"13730",1997-08-03,250,320,4,70
"13731",1997-08-04,250,315,23,65
"13732",1997-08-05,230,307,23,77
"13733",1997-08-06,236,322,0,86
"13734",1997-08-07,264,333,19,69
"13735",1997-08-08,276,370,0,94
"13736",1997-08-09,246,339,0,93
"13737",1997-08-10,218,348,0,130
"13738",1997-08-11,230,370,0,140
"13739",1997-08-12,228,352,0,124
"13740",1997-08-13,215,316,0,101
"13741",1997-08-14,203,325,0,122
"13742",1997-08-15,203,338,0,135
"13743",1997-08-16,230,314,0,84
"13744",1997-08-17,212,332,0,120
"13745",1997-08-18,203,340,0,137
"13746",1997-08-19,237,323,0,86
"13747",1997-08-20,231,290,3,59
"13748",1997-08-21,189,343,0,154
"13749",1997-08-22,231,344,0,113
"13750",1997-08-23,221,357,0,136
"13751",1997-08-24,231,350,0,119
"13752",1997-08-25,223,336,0,113
"13753",1997-08-26,208,319,0,111
"13754",1997-08-27,216,327,0,111
"13755",1997-08-28,221,349,0,128
"13756",1997-08-29,237,346,0,109
"13757",1997-08-30,245,355,0,110
"13758",1997-08-31,241,354,0,113
"13759",1997-09-01,270,331,0,61
"13760",1997-09-02,204,281,0,77
"13761",1997-09-03,166,257,0,91
"13762",1997-09-04,120,320,0,200
"13763",1997-09-05,165,337,0,172
"13764",1997-09-06,195,326,0,131
"13765",1997-09-07,189,327,0,138
"13766",1997-09-08,198,351,0,153
"13767",1997-09-09,208,379,0,171
"13768",1997-09-10,187,274,0,87
"13769",1997-09-11,157,197,11,40
"13770",1997-09-12,144,158,271,14
"13771",1997-09-13,139,155,211,16
"13772",1997-09-14,135,176,214,41
"13773",1997-09-15,143,222,52,79
"13774",1997-09-16,127,277,0,150
"13775",1997-09-17,156,226,0,70
"13776",1997-09-18,120,243,20,123
"13777",1997-09-19,101,260,0,159
"13778",1997-09-20,137,215,0,78
"13779",1997-09-21,78,252,0,174
"13780",1997-09-22,86,258,0,172
"13781",1997-09-23,111,233,0,122
"13782",1997-09-24,144,228,0,84
"13783",1997-09-25,132,251,0,119
"13784",1997-09-26,133,234,0,101
"13785",1997-09-27,87,253,0,166
"13786",1997-09-28,84,281,0,197
"13787",1997-09-29,88,292,0,204
"13788",1997-09-30,137,277,0,140
"13789",1997-10-01,154,284,0,130
"13790",1997-10-02,129,276,0,147
"13791",1997-10-03,115,227,22,112
"13792",1997-10-04,117,194,0,77
"13793",1997-10-05,66,243,0,177
"13794",1997-10-06,89,279,0,190
"13795",1997-10-07,105,267,0,162
"13796",1997-10-08,102,232,0,130
"13797",1997-10-09,110,287,0,177
"13798",1997-10-10,147,290,0,143
"13799",1997-10-11,110,262,0,152
"13800",1997-10-12,95,255,0,160
"13801",1997-10-13,98,302,0,204
"13802",1997-10-14,139,246,0,107
"13803",1997-10-15,113,271,0,158
"13804",1997-10-16,119,290,0,171
"13805",1997-10-17,129,286,0,157
"13806",1997-10-18,103,296,0,193
"13807",1997-10-19,128,292,0,164
"13808",1997-10-20,123,296,0,173
"13809",1997-10-21,127,268,0,141
"13810",1997-10-22,101,280,0,179
"13811",1997-10-23,124,198,0,74
"13812",1997-10-24,100,158,1,58
"13813",1997-10-25,86,131,0,45
"13814",1997-10-26,71,178,0,107
"13815",1997-10-27,67,172,0,105
"13816",1997-10-28,16,207,0,191
"13817",1997-10-29,78,202,0,124
"13818",1997-10-30,31,187,0,156
"13819",1997-10-31,8,177,0,169
"13820",1997-11-01,8,181,0,173
"13821",1997-11-02,26,203,0,177
"13822",1997-11-03,51,214,0,163
"13823",1997-11-04,59,161,0,102
"13824",1997-11-05,14,207,0,193
"13825",1997-11-06,29,166,0,137
"13826",1997-11-07,38,167,0,129
"13827",1997-11-08,75,128,0,53
"13828",1997-11-09,62,142,2,80
"13829",1997-11-10,71,113,7,42
"13830",1997-11-11,90,107,192,17
"13831",1997-11-12,81,126,34,45
"13832",1997-11-13,52,96,84,44
"13833",1997-11-14,7,169,0,162
"13834",1997-11-15,23,96,0,73
"13835",1997-11-16,-6,92,5,98
"13836",1997-11-17,-14,102,0,116
"13837",1997-11-18,-26,102,0,128
"13838",1997-11-19,25,139,0,114
"13839",1997-11-20,1,94,0,93
"13840",1997-11-21,15,112,0,97
"13841",1997-11-22,-3,142,0,145
"13842",1997-11-23,46,122,0,76
"13843",1997-11-24,45,75,0,30
"13844",1997-11-25,59,118,0,59
"13845",1997-11-26,51,107,0,56
"13846",1997-11-27,34,66,15,32
"13847",1997-11-28,5,35,32,30
"13848",1997-11-29,-12,73,0,85
"13849",1997-11-30,32,70,0,38
"13850",1997-12-01,-29,57,6,86
"13851",1997-12-02,-23,53,0,76
"13852",1997-12-03,-25,58,0,83
"13853",1997-12-04,-37,83,0,120
"13854",1997-12-05,21,42,15,21
"13855",1997-12-06,20,61,1,41
"13856",1997-12-07,28,65,0,37
"13857",1997-12-08,-17,71,0,88
"13858",1997-12-09,-25,38,0,63
"13859",1997-12-10,-74,62,0,136
"13860",1997-12-11,1,53,0,52
"13861",1997-12-12,-17,93,0,110
"13862",1997-12-13,-51,112,0,163
"13863",1997-12-14,-9,120,0,129
"13864",1997-12-15,-22,66,0,88
"13865",1997-12-16,13,65,19,52
"13866",1997-12-17,-30,158,0,188
"13867",1997-12-18,1,182,0,181
"13868",1997-12-19,-32,94,0,126
"13869",1997-12-20,20,58,0,38
"13870",1997-12-21,0,55,0,55
"13871",1997-12-22,0,39,0,39
"13872",1997-12-23,-39,63,0,102
"13873",1997-12-24,-44,66,0,110
"13874",1997-12-25,7,73,1,66
"13875",1997-12-26,2,121,0,119
"13876",1997-12-27,0,73,0,73
"13877",1997-12-28,-14,44,0,58
"13878",1997-12-29,11,84,3,73
"13879",1997-12-30,-4,95,0,99
"13880",1997-12-31,-11,104,0,115
"13881",1998-01-01,0,138,0,138
"13882",1998-01-02,-26,133,0,159
"13883",1998-01-03,12,87,0,75
"13884",1998-01-04,-43,36,0,79
"13885",1998-01-05,-60,97,0,157
"13886",1998-01-06,-26,88,0,114
"13887",1998-01-07,16,86,0,70
"13888",1998-01-08,-40,116,0,156
"13889",1998-01-09,11,66,0,55
"13890",1998-01-10,14,51,8,37
"13891",1998-01-11,1,26,15,25
"13892",1998-01-12,5,18,5,13
"13893",1998-01-13,-5,11,10,16
"13894",1998-01-14,-36,1,52,37
"13895",1998-01-15,-70,-36,0,34
"13896",1998-01-16,-65,-45,8,20
"13897",1998-01-17,-77,-4,1,73
"13898",1998-01-18,-90,-6,0,84
"13899",1998-01-19,-85,6,0,91
"13900",1998-01-20,-61,44,0,105
"13901",1998-01-21,-54,93,0,147
"13902",1998-01-22,-19,51,0,70
"13903",1998-01-23,-50,23,0,73
"13904",1998-01-24,-74,48,0,122
"13905",1998-01-25,-46,84,0,130
"13906",1998-01-26,-35,92,0,127
"13907",1998-01-27,-28,64,0,92
"13908",1998-01-28,-60,58,0,118
"13909",1998-01-29,-54,78,0,132
"13910",1998-01-30,-43,62,0,105
"13911",1998-01-31,1,33,0,32
"13912",1998-02-01,-11,48,0,59
"13913",1998-02-02,8,52,0,44
"13914",1998-02-03,-29,59,0,88
"13915",1998-02-04,-19,72,0,91
"13916",1998-02-05,-32,106,0,138
"13917",1998-02-06,-12,118,0,130
"13918",1998-02-07,-21,127,0,148
"13919",1998-02-08,-52,90,0,142
"13920",1998-02-09,-16,137,0,153
"13921",1998-02-10,-41,130,0,171
"13922",1998-02-11,-1,220,0,221
"13923",1998-02-12,51,158,0,107
"13924",1998-02-13,55,99,0,44
"13925",1998-02-14,-20,125,0,145
"13926",1998-02-15,-2,115,0,117
"13927",1998-02-16,44,120,0,76
"13928",1998-02-17,15,92,0,77
"13929",1998-02-18,1,77,118,76
"13930",1998-02-19,1,42,120,41
"13931",1998-02-20,20,87,2,67
"13932",1998-02-21,39,72,0,33
"13933",1998-02-22,8,56,0,48
"13934",1998-02-23,18,87,0,69
"13935",1998-02-24,7,126,0,119
"13936",1998-02-25,14,179,0,165
"13937",1998-02-26,68,182,0,114
"13938",1998-02-27,46,146,0,100
"13939",1998-02-28,-1,143,0,144
"13940",1998-03-01,28,142,0,114
"13941",1998-03-02,29,157,0,128
"13942",1998-03-03,27,178,0,151
"13943",1998-03-04,28,159,0,131
"13944",1998-03-05,61,142,0,81
"13945",1998-03-06,65,138,0,73
"13946",1998-03-07,63,137,0,74
"13947",1998-03-08,51,88,0,37
"13948",1998-03-09,3,54,293,51
"13949",1998-03-10,20,106,27,86
"13950",1998-03-11,-2,129,0,131
"13951",1998-03-12,51,161,0,110
"13952",1998-03-13,67,201,0,134
"13953",1998-03-14,69,158,0,89
"13954",1998-03-15,43,97,0,54
"13955",1998-03-16,27,218,0,191
"13956",1998-03-17,72,215,0,143
"13957",1998-03-18,135,177,0,42
"13958",1998-03-19,19,145,0,126
"13959",1998-03-20,0,27,0,27
"13960",1998-03-21,5,100,0,95
"13961",1998-03-22,-14,107,0,121
"13962",1998-03-23,38,78,7,40
"13963",1998-03-24,1,83,2,82
"13964",1998-03-25,16,112,0,96
"13965",1998-03-26,53,184,0,131
"13966",1998-03-27,55,238,0,183
"13967",1998-03-28,84,272,0,188
"13968",1998-03-29,105,238,0,133
"13969",1998-03-30,112,207,32,95
"13970",1998-03-31,9,138,282,129
"13971",1998-04-01,7,87,55,80
"13972",1998-04-02,37,124,0,87
"13973",1998-04-03,65,129,0,64
"13974",1998-04-04,108,147,2,39
"13975",1998-04-05,112,197,53,85
"13976",1998-04-06,132,167,16,35
"13977",1998-04-07,118,173,46,55
"13978",1998-04-08,79,208,0,129
"13979",1998-04-09,117,218,0,101
"13980",1998-04-10,143,203,0,60
"13981",1998-04-11,150,186,12,36
"13982",1998-04-12,138,238,0,100
"13983",1998-04-13,123,254,0,131
"13984",1998-04-14,86,249,0,163
"13985",1998-04-15,106,272,0,166
"13986",1998-04-16,184,238,0,54
"13987",1998-04-17,82,242,0,160
"13988",1998-04-18,127,296,0,169
"13989",1998-04-19,156,321,0,165
"13990",1998-04-20,185,305,0,120
"13991",1998-04-21,165,295,0,130
"13992",1998-04-22,189,287,0,98
"13993",1998-04-23,184,248,194,64
"13994",1998-04-24,114,206,5,92
"13995",1998-04-25,70,198,0,128
"13996",1998-04-26,118,251,0,133
"13997",1998-04-27,170,277,0,107
"13998",1998-04-28,181,306,0,125
"13999",1998-04-29,135,183,0,48
"14000",1998-04-30,116,142,8,26
"14001",1998-05-01,127,220,321,93
"14002",1998-05-02,171,281,0,110
"14003",1998-05-03,127,245,0,118
"14004",1998-05-04,154,256,0,102
"14005",1998-05-05,127,256,0,129
"14006",1998-05-06,148,267,0,119
"14007",1998-05-07,181,237,285,56
"14008",1998-05-08,165,202,2,37
"14009",1998-05-09,97,177,199,80
"14010",1998-05-10,97,126,238,29
"14011",1998-05-11,116,197,1,81
"14012",1998-05-12,109,235,0,126
"14013",1998-05-13,154,237,0,83
"14014",1998-05-14,159,237,0,78
"14015",1998-05-15,124,204,0,80
"14016",1998-05-16,121,236,0,115
"14017",1998-05-17,129,299,0,170
"14018",1998-05-18,147,294,0,147
"14019",1998-05-19,197,272,0,75
"14020",1998-05-20,209,260,1,51
"14021",1998-05-21,184,234,373,50
"14022",1998-05-22,180,239,1,59
"14023",1998-05-23,153,202,3,49
"14024",1998-05-24,130,251,0,121
"14025",1998-05-25,132,288,0,156
"14026",1998-05-26,114,333,0,219
"14027",1998-05-27,162,317,0,155
"14028",1998-05-28,198,276,0,78
"14029",1998-05-29,175,304,0,129
"14030",1998-05-30,167,311,0,144
"14031",1998-05-31,142,266,252,124
"14032",1998-06-01,143,217,256,74
"14033",1998-06-02,142,312,0,170
"14034",1998-06-03,150,320,0,170
"14035",1998-06-04,154,314,0,160
"14036",1998-06-05,148,277,0,129
"14037",1998-06-06,157,307,0,150
"14038",1998-06-07,200,291,0,91
"14039",1998-06-08,196,247,5,51
"14040",1998-06-09,159,298,0,139
"14041",1998-06-10,182,315,0,133
"14042",1998-06-11,205,309,0,104
"14043",1998-06-12,184,275,33,91
"14044",1998-06-13,166,268,0,102
"14045",1998-06-14,191,304,0,113
"14046",1998-06-15,211,333,0,122
"14047",1998-06-16,223,377,0,154
"14048",1998-06-17,247,348,0,101
"14049",1998-06-18,260,333,0,73
"14050",1998-06-19,200,362,0,162
"14051",1998-06-20,212,364,0,152
"14052",1998-06-21,240,362,0,122
"14053",1998-06-22,227,326,0,99
"14054",1998-06-23,211,295,0,84
"14055",1998-06-24,223,301,0,78
"14056",1998-06-25,226,321,0,95
"14057",1998-06-26,218,347,0,129
"14058",1998-06-27,216,364,0,148
"14059",1998-06-28,245,359,0,114
"14060",1998-06-29,262,317,0,55
"14061",1998-06-30,214,334,0,120
"14062",1998-07-01,235,299,0,64
"14063",1998-07-02,221,318,0,97
"14064",1998-07-03,218,315,0,97
"14065",1998-07-04,244,324,0,80
"14066",1998-07-05,248,294,19,46
"14067",1998-07-06,267,335,0,68
"14068",1998-07-07,241,307,14,66
"14069",1998-07-08,216,252,154,36
"14070",1998-07-09,210,251,0,41
"14071",1998-07-10,227,313,0,86
"14072",1998-07-11,259,359,0,100
"14073",1998-07-12,235,323,460,88
"14074",1998-07-13,250,355,0,105
"14075",1998-07-14,276,349,0,73
"14076",1998-07-15,266,352,66,86
"14077",1998-07-16,244,289,1102,45
"14078",1998-07-17,248,319,0,71
"14079",1998-07-18,238,344,0,106
"14080",1998-07-19,254,351,0,97
"14081",1998-07-20,284,354,0,70
"14082",1998-07-21,226,358,346,132
"14083",1998-07-22,223,315,30,92
"14084",1998-07-23,261,305,0,44
"14085",1998-07-24,238,314,0,76
"14086",1998-07-25,238,323,0,85
"14087",1998-07-26,237,326,0,89
"14088",1998-07-27,224,324,0,100
"14089",1998-07-28,234,285,177,51
"14090",1998-07-29,238,315,72,77
"14091",1998-07-30,246,282,48,36
"14092",1998-07-31,235,315,0,80
"14093",1998-08-01,243,326,0,83
"14094",1998-08-02,252,322,0,70
"14095",1998-08-03,229,316,0,87
"14096",1998-08-04,248,292,338,44
"14097",1998-08-05,223,335,0,112
"14098",1998-08-06,264,306,5,42
"14099",1998-08-07,221,287,90,66
"14100",1998-08-08,223,317,0,94
"14101",1998-08-09,247,312,57,65
"14102",1998-08-10,224,335,69,111
"14103",1998-08-11,218,327,0,109
"14104",1998-08-12,235,321,0,86
"14105",1998-08-13,258,330,0,72
"14106",1998-08-14,224,286,178,62
"14107",1998-08-15,216,302,213,86
"14108",1998-08-16,228,295,0,67
"14109",1998-08-17,203,307,0,104
"14110",1998-08-18,206,312,0,106
"14111",1998-08-19,214,326,0,112
"14112",1998-08-20,238,292,0,54
"14113",1998-08-21,223,271,28,48
"14114",1998-08-22,207,265,728,58
"14115",1998-08-23,223,307,0,84
"14116",1998-08-24,247,307,8,60
"14117",1998-08-25,224,293,0,69
"14118",1998-08-26,210,260,106,50
"14119",1998-08-27,197,296,0,99
"14120",1998-08-28,216,287,0,71
"14121",1998-08-29,202,320,0,118
"14122",1998-08-30,216,284,0,68
"14123",1998-08-31,178,256,43,78
"14124",1998-09-01,186,278,0,92
"14125",1998-09-02,203,301,0,98
"14126",1998-09-03,209,328,0,119
"14127",1998-09-04,193,325,0,132
"14128",1998-09-05,195,350,0,155
"14129",1998-09-06,207,354,0,147
"14130",1998-09-07,215,345,0,130
"14131",1998-09-08,220,332,0,112
"14132",1998-09-09,202,334,0,132
"14133",1998-09-10,183,323,0,140
"14134",1998-09-11,188,315,0,127
"14135",1998-09-12,190,310,0,120
"14136",1998-09-13,227,299,0,72
"14137",1998-09-14,225,330,0,105
"14138",1998-09-15,194,237,6,43
"14139",1998-09-16,173,262,0,89
"14140",1998-09-17,182,289,0,107
"14141",1998-09-18,210,293,0,83
"14142",1998-09-19,197,250,0,53
"14143",1998-09-20,176,260,0,84
"14144",1998-09-21,141,292,0,151
"14145",1998-09-22,134,262,0,128
"14146",1998-09-23,176,285,0,109
"14147",1998-09-24,156,285,0,129
"14148",1998-09-25,183,268,0,85
"14149",1998-09-26,168,272,0,104
"14150",1998-09-27,154,297,0,143
"14151",1998-09-28,154,301,0,147
"14152",1998-09-29,146,315,0,169
"14153",1998-09-30,149,331,0,182
"14154",1998-10-01,136,340,0,204
"14155",1998-10-02,198,289,0,91
"14156",1998-10-03,186,223,1,37
"14157",1998-10-04,163,250,0,87
"14158",1998-10-05,148,262,0,114
"14159",1998-10-06,178,237,0,59
"14160",1998-10-07,152,278,0,126
"14161",1998-10-08,141,315,0,174
"14162",1998-10-09,176,261,0,85
"14163",1998-10-10,153,256,0,103
"14164",1998-10-11,150,228,0,78
"14165",1998-10-12,148,221,0,73
"14166",1998-10-13,154,205,72,51
"14167",1998-10-14,137,232,0,95
"14168",1998-10-15,83,271,0,188
"14169",1998-10-16,90,259,0,169
"14170",1998-10-17,159,234,1,75
"14171",1998-10-18,110,254,0,144
"14172",1998-10-19,119,202,0,83
"14173",1998-10-20,76,236,0,160
"14174",1998-10-21,73,238,0,165
"14175",1998-10-22,103,222,0,119
"14176",1998-10-23,100,219,0,119
"14177",1998-10-24,92,198,0,106
"14178",1998-10-25,108,176,0,68
"14179",1998-10-26,100,205,0,105
"14180",1998-10-27,38,161,0,123
"14181",1998-10-28,109,164,0,55
"14182",1998-10-29,74,174,0,100
"14183",1998-10-30,57,261,0,204
"14184",1998-10-31,140,208,0,68
"14185",1998-11-01,58,262,0,204
"14186",1998-11-02,132,233,0,101
"14187",1998-11-03,71,266,0,195
"14188",1998-11-04,120,203,0,83
"14189",1998-11-05,55,187,0,132
"14190",1998-11-06,72,210,0,138
"14191",1998-11-07,43,236,0,193
"14192",1998-11-08,123,261,0,138
"14193",1998-11-09,109,183,0,74
"14194",1998-11-10,35,203,0,168
"14195",1998-11-11,51,223,0,172
"14196",1998-11-12,71,229,0,158
"14197",1998-11-13,54,262,0,208
"14198",1998-11-14,63,257,0,194
"14199",1998-11-15,87,194,0,107
"14200",1998-11-16,80,142,0,62
"14201",1998-11-17,19,146,0,127
"14202",1998-11-18,-20,68,0,88
"14203",1998-11-19,-21,108,0,129
"14204",1998-11-20,-18,168,0,186
"14205",1998-11-21,42,190,0,148
"14206",1998-11-22,-4,119,0,123
"14207",1998-11-23,8,92,0,84
"14208",1998-11-24,1,45,0,44
"14209",1998-11-25,17,55,0,38
"14210",1998-11-26,45,70,5,25
"14211",1998-11-27,18,166,0,148
"14212",1998-11-28,-7,137,0,144
"14213",1998-11-29,28,123,0,95
"14214",1998-11-30,4,74,0,70
"14215",1998-12-01,-26,46,38,72
"14216",1998-12-02,-43,-20,1,23
"14217",1998-12-03,-42,36,0,78
"14218",1998-12-04,-21,57,0,78
"14219",1998-12-05,-19,16,0,35
"14220",1998-12-06,-37,72,0,109
"14221",1998-12-07,-6,89,0,95
"14222",1998-12-08,-35,77,0,112
"14223",1998-12-09,-44,67,0,111
"14224",1998-12-10,-50,97,0,147
"14225",1998-12-11,-28,94,0,122
"14226",1998-12-12,-40,157,0,197
"14227",1998-12-13,13,162,0,149
"14228",1998-12-14,47,129,0,82
"14229",1998-12-15,-4,173,0,177
"14230",1998-12-16,61,172,0,111
"14231",1998-12-17,-9,167,0,176
"14232",1998-12-18,3,145,0,142
"14233",1998-12-19,-5,149,0,154
"14234",1998-12-20,-10,153,0,163
"14235",1998-12-21,14,77,0,63
"14236",1998-12-22,-7,88,0,95
"14237",1998-12-23,-17,104,0,121
"14238",1998-12-24,-13,82,0,95
"14239",1998-12-25,2,142,0,140
"14240",1998-12-26,20,112,0,92
"14241",1998-12-27,-22,158,0,180
"14242",1998-12-28,40,132,0,92
"14243",1998-12-29,-38,82,0,120
"14244",1998-12-30,23,59,0,36
"14245",1998-12-31,-7,44,0,51
"14246",1999-01-01,-25,125,0,150
"14247",1999-01-02,44,137,0,93
"14248",1999-01-03,-22,123,0,145
"14249",1999-01-04,-41,112,0,153
"14250",1999-01-05,-12,72,0,84
"14251",1999-01-06,-10,92,0,102
"14252",1999-01-07,-21,61,0,82
"14253",1999-01-08,-45,42,0,87
"14254",1999-01-09,-78,27,0,105
"14255",1999-01-10,-67,81,0,148
"14256",1999-01-11,-39,52,0,91
"14257",1999-01-12,-70,22,0,92
"14258",1999-01-13,-64,17,0,81
"14259",1999-01-14,-50,37,0,87
"14260",1999-01-15,-34,79,0,113
"14261",1999-01-16,-77,94,0,171
"14262",1999-01-17,-28,124,0,152
"14263",1999-01-18,-21,89,0,110
"14264",1999-01-19,-16,44,0,60
"14265",1999-01-20,-60,82,0,142
"14266",1999-01-21,-41,127,0,168
"14267",1999-01-22,-31,131,0,162
"14268",1999-01-23,20,102,0,82
"14269",1999-01-24,1,137,0,136
"14270",1999-01-25,60,154,0,94
"14271",1999-01-26,-3,164,0,167
"14272",1999-01-27,51,131,0,80
"14273",1999-01-28,-17,180,0,197
"14274",1999-01-29,25,112,0,87
"14275",1999-01-30,20,105,0,85
"14276",1999-01-31,-24,106,0,130
"14277",1999-02-01,6,138,0,132
"14278",1999-02-02,29,106,0,77
"14279",1999-02-03,-18,107,0,125
"14280",1999-02-04,-29,131,0,160
"14281",1999-02-05,-16,132,0,148
"14282",1999-02-06,11,147,0,136
"14283",1999-02-07,27,155,0,128
"14284",1999-02-08,-26,138,0,164
"14285",1999-02-09,-17,114,0,131
"14286",1999-02-10,13,74,0,61
"14287",1999-02-11,-35,157,0,192
"14288",1999-02-12,-37,135,0,172
"14289",1999-02-13,-24,161,0,185
"14290",1999-02-14,-2,162,0,164
"14291",1999-02-15,-15,109,0,124
"14292",1999-02-16,-13,194,0,207
"14293",1999-02-17,49,127,0,78
"14294",1999-02-18,33,112,0,79
"14295",1999-02-19,-26,79,0,105
"14296",1999-02-20,4,113,0,109
"14297",1999-02-21,-53,123,0,176
"14298",1999-02-22,-21,144,0,165
"14299",1999-02-23,58,157,0,99
"14300",1999-02-24,4,143,0,139
"14301",1999-02-25,43,96,0,53
"14302",1999-02-26,84,175,0,91
"14303",1999-02-27,40,122,0,82
"14304",1999-02-28,19,178,0,159
"14305",1999-03-01,34,223,0,189
"14306",1999-03-02,63,218,0,155
"14307",1999-03-03,28,223,0,195
"14308",1999-03-04,69,234,0,165
"14309",1999-03-05,103,181,0,78
"14310",1999-03-06,62,114,31,52
"14311",1999-03-07,23,97,3,74
"14312",1999-03-08,38,86,0,48
"14313",1999-03-09,36,108,0,72
"14314",1999-03-10,32,82,0,50
"14315",1999-03-11,18,67,0,49
"14316",1999-03-12,26,123,0,97
"14317",1999-03-13,19,145,0,126
"14318",1999-03-14,69,127,0,58
"14319",1999-03-15,27,173,0,146
"14320",1999-03-16,78,155,15,77
"14321",1999-03-17,62,104,0,42
"14322",1999-03-18,46,76,142,30
"14323",1999-03-19,-1,56,132,57
"14324",1999-03-20,-1,88,26,89
"14325",1999-03-21,27,84,0,57
"14326",1999-03-22,1,73,0,72
"14327",1999-03-23,15,117,0,102
"14328",1999-03-24,14,148,0,134
"14329",1999-03-25,93,166,0,73
"14330",1999-03-26,104,153,0,49
"14331",1999-03-27,33,182,0,149
"14332",1999-03-28,86,173,0,87
"14333",1999-03-29,43,124,0,81
"14334",1999-03-30,30,137,0,107
"14335",1999-03-31,61,131,0,70
"14336",1999-04-01,84,150,0,66
"14337",1999-04-02,65,157,0,92
"14338",1999-04-03,92,218,0,126
"14339",1999-04-04,93,253,0,160
"14340",1999-04-05,161,252,0,91
"14341",1999-04-06,53,219,0,166
"14342",1999-04-07,80,237,0,157
"14343",1999-04-08,108,192,99,84
"14344",1999-04-09,104,234,23,130
"14345",1999-04-10,107,252,0,145
"14346",1999-04-11,137,198,104,61
"14347",1999-04-12,118,223,0,105
"14348",1999-04-13,73,198,0,125
"14349",1999-04-14,72,228,0,156
"14350",1999-04-15,104,253,0,149
"14351",1999-04-16,122,203,0,81
"14352",1999-04-17,134,241,0,107
"14353",1999-04-18,142,259,0,117
"14354",1999-04-19,136,273,0,137
"14355",1999-04-20,107,228,0,121
"14356",1999-04-21,132,242,0,110
"14357",1999-04-22,139,283,0,144
"14358",1999-04-23,171,236,0,65
"14359",1999-04-24,137,183,39,46
"14360",1999-04-25,152,241,0,89
"14361",1999-04-26,120,204,48,84
"14362",1999-04-27,108,167,70,59
"14363",1999-04-28,82,254,0,172
"14364",1999-04-29,111,253,0,142
"14365",1999-04-30,125,250,0,125
"14366",1999-05-01,115,225,0,110
"14367",1999-05-02,128,238,0,110
"14368",1999-05-03,137,215,123,78
"14369",1999-05-04,152,288,0,136
"14370",1999-05-05,173,246,0,73
"14371",1999-05-06,118,291,0,173
"14372",1999-05-07,176,296,0,120
"14373",1999-05-08,127,304,0,177
"14374",1999-05-09,158,270,0,112
"14375",1999-05-10,167,248,0,81
"14376",1999-05-11,145,271,0,126
"14377",1999-05-12,157,307,0,150
"14378",1999-05-13,163,325,0,162
"14379",1999-05-14,163,256,0,93
"14380",1999-05-15,181,217,56,36
"14381",1999-05-16,176,247,1,71
"14382",1999-05-17,178,219,13,41
"14383",1999-05-18,162,188,2,26
"14384",1999-05-19,97,281,0,184
"14385",1999-05-20,142,294,0,152
"14386",1999-05-21,140,292,0,152
"14387",1999-05-22,173,295,0,122
"14388",1999-05-23,183,237,0,54
"14389",1999-05-24,136,255,94,119
"14390",1999-05-25,138,267,15,129
"14391",1999-05-26,131,307,0,176
"14392",1999-05-27,229,371,0,142
"14393",1999-05-28,178,304,0,126
"14394",1999-05-29,167,342,0,175
"14395",1999-05-30,209,334,0,125
"14396",1999-05-31,217,279,0,62
"14397",1999-06-01,183,325,0,142
"14398",1999-06-02,213,349,0,136
"14399",1999-06-03,247,316,0,69
"14400",1999-06-04,217,271,1,54
"14401",1999-06-05,206,238,1,32
"14402",1999-06-06,210,245,0,35
"14403",1999-06-07,190,313,0,123
"14404",1999-06-08,207,316,0,109
"14405",1999-06-09,206,291,0,85
"14406",1999-06-10,211,295,0,84
"14407",1999-06-11,184,301,0,117
"14408",1999-06-12,206,312,0,106
"14409",1999-06-13,198,325,0,127
"14410",1999-06-14,252,358,0,106
"14411",1999-06-15,202,333,94,131
"14412",1999-06-16,201,292,0,91
"14413",1999-06-17,207,319,0,112
"14414",1999-06-18,183,361,0,178
"14415",1999-06-19,210,327,0,117
"14416",1999-06-20,237,380,0,143
"14417",1999-06-21,212,305,0,93
"14418",1999-06-22,218,284,145,66
"14419",1999-06-23,210,296,37,86
"14420",1999-06-24,212,335,0,123
"14421",1999-06-25,217,341,0,124
"14422",1999-06-26,219,340,0,121
"14423",1999-06-27,211,320,0,109
"14424",1999-06-28,215,307,0,92
"14425",1999-06-29,224,314,0,90
"14426",1999-06-30,211,310,0,99
"14427",1999-07-01,214,348,0,134
"14428",1999-07-02,226,374,0,148
"14429",1999-07-03,238,339,0,101
"14430",1999-07-04,191,277,275,86
"14431",1999-07-05,192,217,838,25
"14432",1999-07-06,192,211,275,19
"14433",1999-07-07,197,261,0,64
"14434",1999-07-08,219,288,0,69
"14435",1999-07-09,216,298,0,82
"14436",1999-07-10,206,310,0,104
"14437",1999-07-11,233,296,0,63
"14438",1999-07-12,228,273,2,45
"14439",1999-07-13,206,282,0,76
"14440",1999-07-14,219,293,0,74
"14441",1999-07-15,232,310,0,78
"14442",1999-07-16,214,324,0,110
"14443",1999-07-17,216,332,0,116
"14444",1999-07-18,227,348,0,121
"14445",1999-07-19,226,345,0,119
"14446",1999-07-20,226,348,0,122
"14447",1999-07-21,226,330,0,104
"14448",1999-07-22,228,325,0,97
"14449",1999-07-23,232,341,0,109
"14450",1999-07-24,227,362,0,135
"14451",1999-07-25,243,362,0,119
"14452",1999-07-26,247,340,5,93
"14453",1999-07-27,220,335,727,115
"14454",1999-07-28,223,325,5,102
"14455",1999-07-29,253,345,0,92
"14456",1999-07-30,257,362,0,105
"14457",1999-07-31,256,360,0,104
"14458",1999-08-01,244,307,53,63
"14459",1999-08-02,241,311,0,70
"14460",1999-08-03,227,315,0,88
"14461",1999-08-04,197,325,0,128
"14462",1999-08-05,207,311,0,104
"14463",1999-08-06,222,331,0,109
"14464",1999-08-07,246,343,145,97
"14465",1999-08-08,257,314,183,57
"14466",1999-08-09,248,308,4,60
"14467",1999-08-10,221,324,0,103
"14468",1999-08-11,232,302,0,70
"14469",1999-08-12,202,302,0,100
"14470",1999-08-13,206,284,0,78
"14471",1999-08-14,241,309,0,68
"14472",1999-08-15,253,312,0,59
"14473",1999-08-16,249,331,0,82
"14474",1999-08-17,236,338,0,102
"14475",1999-08-18,224,339,0,115
"14476",1999-08-19,211,287,547,76
"14477",1999-08-20,191,282,0,91
"14478",1999-08-21,179,299,0,120
"14479",1999-08-22,193,299,0,106
"14480",1999-08-23,170,297,0,127
"14481",1999-08-24,199,272,0,73
"14482",1999-08-25,206,286,0,80
"14483",1999-08-26,198,302,33,104
"14484",1999-08-27,204,283,9,79
"14485",1999-08-28,199,302,0,103
"14486",1999-08-29,206,340,0,134
"14487",1999-08-30,212,320,0,108
"14488",1999-08-31,200,319,0,119
"14489",1999-09-01,207,321,0,114
"14490",1999-09-02,201,305,0,104
"14491",1999-09-03,194,267,0,73
"14492",1999-09-04,209,245,62,36
"14493",1999-09-05,206,296,0,90
"14494",1999-09-06,221,320,0,99
"14495",1999-09-07,227,355,0,128
"14496",1999-09-08,247,353,0,106
"14497",1999-09-09,248,373,0,125
"14498",1999-09-10,266,338,0,72
"14499",1999-09-11,212,308,501,96
"14500",1999-09-12,204,280,0,76
"14501",1999-09-13,214,255,9,41
"14502",1999-09-14,184,215,337,31
"14503",1999-09-15,157,271,0,114
"14504",1999-09-16,183,261,0,78
"14505",1999-09-17,172,248,0,76
"14506",1999-09-18,192,227,1,35
"14507",1999-09-19,189,248,1,59
"14508",1999-09-20,154,212,0,58
"14509",1999-09-21,133,219,0,86
"14510",1999-09-22,127,241,0,114
"14511",1999-09-23,126,253,0,127
"14512",1999-09-24,142,309,0,167
"14513",1999-09-25,169,306,0,137
"14514",1999-09-26,142,296,0,154
"14515",1999-09-27,151,271,0,120
"14516",1999-09-28,200,257,0,57
"14517",1999-09-29,203,261,0,58
"14518",1999-09-30,165,242,95,77
"14519",1999-10-01,148,200,50,52
"14520",1999-10-02,97,174,61,77
"14521",1999-10-03,96,157,1,61
"14522",1999-10-04,101,133,171,32
"14523",1999-10-05,75,177,7,102
"14524",1999-10-06,75,250,0,175
"14525",1999-10-07,129,250,0,121
"14526",1999-10-08,119,247,0,128
"14527",1999-10-09,161,194,70,33
"14528",1999-10-10,143,187,24,44
"14529",1999-10-11,148,247,0,99
"14530",1999-10-12,136,232,0,96
"14531",1999-10-13,152,237,7,85
"14532",1999-10-14,134,191,70,57
"14533",1999-10-15,131,172,0,41
"14534",1999-10-16,100,165,0,65
"14535",1999-10-17,62,212,0,150
"14536",1999-10-18,50,217,0,167
"14537",1999-10-19,81,258,0,177
"14538",1999-10-20,143,232,0,89
"14539",1999-10-21,141,260,0,119
"14540",1999-10-22,101,242,0,141
"14541",1999-10-23,92,203,0,111
"14542",1999-10-24,95,242,0,147
"14543",1999-10-25,98,222,0,124
"14544",1999-10-26,135,225,6,90
"14545",1999-10-27,111,264,0,153
"14546",1999-10-28,135,207,0,72
"14547",1999-10-29,75,147,0,72
"14548",1999-10-30,75,123,129,48
"14549",1999-10-31,53,112,99,59
"14550",1999-11-01,39,159,0,120
"14551",1999-11-02,22,175,0,153
"14552",1999-11-03,26,197,0,171
"14553",1999-11-04,72,180,0,108
"14554",1999-11-05,93,182,0,89
"14555",1999-11-06,115,205,0,90
"14556",1999-11-07,89,203,0,114
"14557",1999-11-08,61,167,0,106
"14558",1999-11-09,34,169,0,135
"14559",1999-11-10,58,122,42,64
"14560",1999-11-11,67,191,3,124
"14561",1999-11-12,65,226,0,161
"14562",1999-11-13,68,190,0,122
"14563",1999-11-14,83,141,6,58
"14564",1999-11-15,31,84,0,53
"14565",1999-11-16,34,61,0,27
"14566",1999-11-17,35,140,0,105
"14567",1999-11-18,-17,150,0,167
"14568",1999-11-19,28,182,0,154
"14569",1999-11-20,13,180,0,167
"14570",1999-11-21,87,192,0,105
"14571",1999-11-22,66,212,0,146
"14572",1999-11-23,74,178,0,104
"14573",1999-11-24,102,173,0,71
"14574",1999-11-25,37,146,0,109
"14575",1999-11-26,17,72,2,55
"14576",1999-11-27,30,75,0,45
"14577",1999-11-28,2,97,0,95
"14578",1999-11-29,17,125,0,108
"14579",1999-11-30,-23,115,0,138
"14580",1999-12-01,25,140,0,115
"14581",1999-12-02,-15,122,0,137
"14582",1999-12-03,9,73,0,64
"14583",1999-12-04,27,115,0,88
"14584",1999-12-05,26,109,0,83
"14585",1999-12-06,-3,78,0,81
"14586",1999-12-07,-46,127,0,173
"14587",1999-12-08,45,145,0,100
"14588",1999-12-09,27,163,0,136
"14589",1999-12-10,18,149,0,131
"14590",1999-12-11,-18,103,0,121
"14591",1999-12-12,2,133,0,131
"14592",1999-12-13,10,138,0,128
"14593",1999-12-14,2,156,0,154
"14594",1999-12-15,-10,143,0,153
"14595",1999-12-16,11,86,0,75
"14596",1999-12-17,-37,62,0,99
"14597",1999-12-18,-30,36,0,66
"14598",1999-12-19,-70,7,0,77
"14599",1999-12-20,-53,37,0,90
"14600",1999-12-21,-87,22,0,109
"14601",1999-12-22,-80,63,0,143
"14602",1999-12-23,-56,93,0,149
"14603",1999-12-24,40,134,0,94
"14604",1999-12-25,12,112,0,100
"14605",1999-12-26,-42,97,0,139
"14606",1999-12-27,-30,133,0,163
"14607",1999-12-28,-30,111,0,141
"14608",1999-12-29,-38,143,0,181
"14609",1999-12-30,-13,88,0,101
"14610",1999-12-31,-9,34,0,43
"14611",2000-01-01,2,43,0,41
"14612",2000-01-02,-16,99,0,115
"14613",2000-01-03,-8,44,0,52
"14614",2000-01-04,3,17,0,14
"14615",2000-01-05,-3,16,0,19
"14616",2000-01-06,-15,83,0,98
"14617",2000-01-07,-62,4,0,66
"14618",2000-01-08,-52,-4,0,48
"14619",2000-01-09,-23,67,1,90
"14620",2000-01-10,-15,7,60,22
"14621",2000-01-11,-34,-8,140,26
"14622",2000-01-12,-41,-7,8,34
"14623",2000-01-13,-57,-7,1,50
"14624",2000-01-14,-63,-16,1,47
"14625",2000-01-15,-43,-22,43,21
"14626",2000-01-16,-38,-8,0,30
"14627",2000-01-17,-64,6,2,70
"14628",2000-01-18,-102,62,0,164
"14629",2000-01-19,-61,30,0,91
"14630",2000-01-20,-68,-3,0,65
"14631",2000-01-21,-67,-17,3,50
"14632",2000-01-22,-44,36,4,80
"14633",2000-01-23,-52,-13,0,39
"14634",2000-01-24,-60,-32,0,28
"14635",2000-01-25,-73,-14,0,59
"14636",2000-01-26,-86,5,0,91
"14637",2000-01-27,-98,32,0,130
"14638",2000-01-28,-65,18,0,83
"14639",2000-01-29,-53,53,0,106
"14640",2000-01-30,-75,16,0,91
"14641",2000-01-31,-55,-18,0,37
"14642",2000-02-01,-99,2,0,101
"14643",2000-02-02,-84,43,0,127
"14644",2000-02-03,-54,23,0,77
"14645",2000-02-04,-43,15,0,58
"14646",2000-02-05,-53,93,1,146
"14647",2000-02-06,-8,122,0,130
"14648",2000-02-07,-1,66,0,67
"14649",2000-02-08,-30,29,0,59
"14650",2000-02-09,-46,61,0,107
"14651",2000-02-10,-40,120,0,160
"14652",2000-02-11,-18,92,0,110
"14653",2000-02-12,-11,133,0,144
"14654",2000-02-13,19,63,3,44
"14655",2000-02-14,-27,117,0,144
"14656",2000-02-15,-14,92,0,106
"14657",2000-02-16,-29,101,0,130
"14658",2000-02-17,-14,94,0,108
"14659",2000-02-18,27,59,8,32
"14660",2000-02-19,16,55,0,39
"14661",2000-02-20,6,58,0,52
"14662",2000-02-21,-35,70,0,105
"14663",2000-02-22,26,82,3,56
"14664",2000-02-23,-8,86,0,94
"14665",2000-02-24,27,55,0,28
"14666",2000-02-25,17,97,3,80
"14667",2000-02-26,-6,143,0,149
"14668",2000-02-27,-5,169,0,174
"14669",2000-02-28,32,97,0,65
"14670",2000-02-29,-27,134,0,161
"14671",2000-03-01,30,148,0,118
"14672",2000-03-02,13,158,0,145
"14673",2000-03-03,39,163,0,124
"14674",2000-03-04,47,129,0,82
"14675",2000-03-05,23,166,0,143
"14676",2000-03-06,55,136,0,81
"14677",2000-03-07,25,158,0,133
"14678",2000-03-08,17,143,0,126
"14679",2000-03-09,23,167,0,144
"14680",2000-03-10,27,128,0,101
"14681",2000-03-11,24,152,0,128
"14682",2000-03-12,33,152,0,119
"14683",2000-03-13,48,142,0,94
"14684",2000-03-14,48,167,0,119
"14685",2000-03-15,95,175,0,80
"14686",2000-03-16,34,207,0,173
"14687",2000-03-17,54,213,0,159
"14688",2000-03-18,55,253,0,198
"14689",2000-03-19,60,177,0,117
"14690",2000-03-20,36,152,0,116
"14691",2000-03-21,89,134,0,45
"14692",2000-03-22,73,127,0,54
"14693",2000-03-23,103,176,0,73
"14694",2000-03-24,51,193,0,142
"14695",2000-03-25,100,227,0,127
"14696",2000-03-26,81,251,0,170
"14697",2000-03-27,131,245,0,114
"14698",2000-03-28,116,208,0,92
"14699",2000-03-29,49,207,0,158
"14700",2000-03-30,83,249,0,166
"14701",2000-03-31,145,227,0,82
"14702",2000-04-01,76,191,23,115
"14703",2000-04-02,36,138,18,102
"14704",2000-04-03,50,178,0,128
"14705",2000-04-04,73,246,0,173
"14706",2000-04-05,83,177,0,94
"14707",2000-04-06,85,239,0,154
"14708",2000-04-07,103,212,0,109
"14709",2000-04-08,76,205,3,129
"14710",2000-04-09,89,248,16,159
"14711",2000-04-10,54,187,0,133
"14712",2000-04-11,43,236,0,193
"14713",2000-04-12,133,308,0,175
"14714",2000-04-13,131,243,0,112
"14715",2000-04-14,77,159,11,82
"14716",2000-04-15,50,217,0,167
"14717",2000-04-16,60,258,0,198
"14718",2000-04-17,104,262,0,158
"14719",2000-04-18,168,245,13,77
"14720",2000-04-19,142,239,0,97
"14721",2000-04-20,167,251,2,84
"14722",2000-04-21,155,286,0,131
"14723",2000-04-22,154,268,0,114
"14724",2000-04-23,128,245,0,117
"14725",2000-04-24,134,289,0,155
"14726",2000-04-25,183,256,0,73
"14727",2000-04-26,129,255,0,126
"14728",2000-04-27,106,259,0,153
"14729",2000-04-28,127,282,0,155
"14730",2000-04-29,155,263,0,108
"14731",2000-04-30,134,315,0,181
"14732",2000-05-01,121,298,0,177
"14733",2000-05-02,134,307,0,173
"14734",2000-05-03,164,334,0,170
"14735",2000-05-04,146,362,0,216
"14736",2000-05-05,186,297,0,111
"14737",2000-05-06,122,235,10,113
"14738",2000-05-07,96,276,0,180
"14739",2000-05-08,143,256,10,113
"14740",2000-05-09,172,297,40,125
"14741",2000-05-10,121,294,0,173
"14742",2000-05-11,131,265,141,134
"14743",2000-05-12,147,286,0,139
"14744",2000-05-13,130,248,0,118
"14745",2000-05-14,159,232,0,73
"14746",2000-05-15,161,210,0,49
"14747",2000-05-16,151,254,0,103
"14748",2000-05-17,164,329,0,165
"14749",2000-05-18,218,310,0,92
"14750",2000-05-19,157,329,0,172
"14751",2000-05-20,140,370,0,230
"14752",2000-05-21,206,384,0,178
"14753",2000-05-22,203,312,0,109
"14754",2000-05-23,201,353,0,152
"14755",2000-05-24,206,355,0,149
"14756",2000-05-25,228,285,0,57
"14757",2000-05-26,206,274,0,68
"14758",2000-05-27,176,268,0,92
"14759",2000-05-28,188,274,0,86
"14760",2000-05-29,188,235,0,47
"14761",2000-05-30,154,337,0,183
"14762",2000-05-31,182,375,0,193
"14763",2000-06-01,235,316,0,81
"14764",2000-06-02,199,264,54,65
"14765",2000-06-03,188,231,99,43
"14766",2000-06-04,190,290,0,100
"14767",2000-06-05,186,310,0,124
"14768",2000-06-06,184,329,0,145
"14769",2000-06-07,199,350,0,151
"14770",2000-06-08,228,363,0,135
"14771",2000-06-09,203,313,0,110
"14772",2000-06-10,212,290,0,78
"14773",2000-06-11,193,325,0,132
"14774",2000-06-12,171,298,62,127
"14775",2000-06-13,165,339,0,174
"14776",2000-06-14,204,344,0,140
"14777",2000-06-15,228,352,0,124
"14778",2000-06-16,204,329,0,125
"14779",2000-06-17,211,319,0,108
"14780",2000-06-18,203,334,0,131
"14781",2000-06-19,228,335,0,107
"14782",2000-06-20,228,314,6,86
"14783",2000-06-21,207,315,115,108
"14784",2000-06-22,204,262,61,58
"14785",2000-06-23,196,315,0,119
"14786",2000-06-24,226,332,0,106
"14787",2000-06-25,229,269,0,40
"14788",2000-06-26,223,282,9,59
"14789",2000-06-27,227,321,16,94
"14790",2000-06-28,234,280,13,46
"14791",2000-06-29,214,351,0,137
"14792",2000-06-30,237,365,0,128
"14793",2000-07-01,233,370,0,137
"14794",2000-07-02,248,345,12,97
"14795",2000-07-03,222,294,84,72
"14796",2000-07-04,227,250,265,23
"14797",2000-07-05,230,274,106,44
"14798",2000-07-06,217,253,612,36
"14799",2000-07-07,226,290,693,64
"14800",2000-07-08,238,319,0,81
"14801",2000-07-09,239,316,3,77
"14802",2000-07-10,203,310,411,107
"14803",2000-07-11,230,324,0,94
"14804",2000-07-12,233,287,8,54
"14805",2000-07-13,232,324,0,92
"14806",2000-07-14,244,290,34,46
"14807",2000-07-15,226,282,10,56
"14808",2000-07-16,238,339,154,101
"14809",2000-07-17,265,354,0,89
"14810",2000-07-18,258,334,2,76
"14811",2000-07-19,247,324,0,77
"14812",2000-07-20,259,314,34,55
"14813",2000-07-21,258,331,0,73
"14814",2000-07-22,274,342,0,68
"14815",2000-07-23,268,321,0,53
"14816",2000-07-24,262,343,0,81
"14817",2000-07-25,263,339,0,76
"14818",2000-07-26,270,336,0,66
"14819",2000-07-27,269,346,0,77
"14820",2000-07-28,261,322,3,61
"14821",2000-07-29,247,304,0,57
"14822",2000-07-30,225,334,0,109
"14823",2000-07-31,205,370,0,165
"14824",2000-08-01,223,342,0,119
"14825",2000-08-02,233,315,0,82
"14826",2000-08-03,222,276,21,54
"14827",2000-08-04,230,259,488,29
"14828",2000-08-05,213,242,175,29
"14829",2000-08-06,211,230,168,19
"14830",2000-08-07,213,279,0,66
"14831",2000-08-08,237,278,1,41
"14832",2000-08-09,240,329,0,89
"14833",2000-08-10,244,337,0,93
"14834",2000-08-11,247,328,0,81
"14835",2000-08-12,251,317,0,66
"14836",2000-08-13,246,307,0,61
"14837",2000-08-14,247,335,0,88
"14838",2000-08-15,257,305,0,48
"14839",2000-08-16,230,344,0,114
"14840",2000-08-17,238,322,0,84
"14841",2000-08-18,247,284,14,37
"14842",2000-08-19,223,304,0,81
"14843",2000-08-20,233,299,0,66
"14844",2000-08-21,206,296,0,90
"14845",2000-08-22,198,305,0,107
"14846",2000-08-23,211,314,15,103
"14847",2000-08-24,220,316,0,96
"14848",2000-08-25,234,324,0,90
"14849",2000-08-26,212,324,0,112
"14850",2000-08-27,193,314,0,121
"14851",2000-08-28,219,301,0,82
"14852",2000-08-29,222,300,0,78
"14853",2000-08-30,224,290,0,66
"14854",2000-08-31,221,299,0,78
"14855",2000-09-01,202,329,0,127
"14856",2000-09-02,205,318,0,113
"14857",2000-09-03,242,296,10,54
"14858",2000-09-04,237,302,28,65
"14859",2000-09-05,186,270,345,84
"14860",2000-09-06,133,240,1,107
"14861",2000-09-07,169,263,6,94
"14862",2000-09-08,144,267,0,123
"14863",2000-09-09,137,235,0,98
"14864",2000-09-10,153,235,0,82
"14865",2000-09-11,154,238,0,84
"14866",2000-09-12,164,286,0,122
"14867",2000-09-13,164,281,0,117
"14868",2000-09-14,171,275,0,104
"14869",2000-09-15,174,295,0,121
"14870",2000-09-16,164,330,0,166
"14871",2000-09-17,175,344,0,169
"14872",2000-09-18,178,338,0,160
"14873",2000-09-19,206,310,0,104
"14874",2000-09-20,190,286,2,96
"14875",2000-09-21,179,216,1,37
"14876",2000-09-22,167,250,0,83
"14877",2000-09-23,197,294,0,97
"14878",2000-09-24,165,250,609,85
"14879",2000-09-25,164,235,0,71
"14880",2000-09-26,160,210,0,50
"14881",2000-09-27,148,162,26,14
"14882",2000-09-28,149,205,1,56
"14883",2000-09-29,160,249,0,89
"14884",2000-09-30,178,249,21,71
"14885",2000-10-01,179,209,127,30
"14886",2000-10-02,160,250,0,90
"14887",2000-10-03,142,264,0,122
"14888",2000-10-04,151,269,0,118
"14889",2000-10-05,167,247,0,80
"14890",2000-10-06,147,266,0,119
"14891",2000-10-07,178,282,0,104
"14892",2000-10-08,165,235,0,70
"14893",2000-10-09,138,180,0,42
"14894",2000-10-10,126,146,80,20
"14895",2000-10-11,112,174,118,62
"14896",2000-10-12,101,128,0,27
"14897",2000-10-13,64,125,0,61
"14898",2000-10-14,76,195,0,119
"14899",2000-10-15,82,207,0,125
"14900",2000-10-16,126,161,0,35
"14901",2000-10-17,84,231,0,147
"14902",2000-10-18,101,154,0,53
"14903",2000-10-19,103,197,0,94
"14904",2000-10-20,92,175,0,83
"14905",2000-10-21,116,172,6,56
"14906",2000-10-22,119,147,165,28
"14907",2000-10-23,122,154,0,32
"14908",2000-10-24,121,174,112,53
"14909",2000-10-25,68,124,49,56
"14910",2000-10-26,64,109,0,45
"14911",2000-10-27,76,118,61,42
"14912",2000-10-28,82,120,17,38
"14913",2000-10-29,87,156,0,69
"14914",2000-10-30,31,175,0,144
"14915",2000-10-31,66,174,0,108
"14916",2000-11-01,31,181,0,150
"14917",2000-11-02,36,199,0,163
"14918",2000-11-03,53,200,0,147
"14919",2000-11-04,126,215,0,89
"14920",2000-11-05,81,232,0,151
"14921",2000-11-06,113,192,0,79
"14922",2000-11-07,36,164,0,128
"14923",2000-11-08,-17,36,84,53
"14924",2000-11-09,-9,15,10,24
"14925",2000-11-10,4,28,5,24
"14926",2000-11-11,13,89,0,76
"14927",2000-11-12,15,117,0,102
"14928",2000-11-13,-6,116,0,122
"14929",2000-11-14,29,77,0,48
"14930",2000-11-15,33,76,47,43
"14931",2000-11-16,8,59,58,51
"14932",2000-11-17,5,134,0,129
"14933",2000-11-18,37,77,0,40
"14934",2000-11-19,50,98,1,48
"14935",2000-11-20,13,120,0,107
"14936",2000-11-21,-13,134,0,147
"14937",2000-11-22,10,134,0,124
"14938",2000-11-23,11,129,0,118
"14939",2000-11-24,36,93,0,57
"14940",2000-11-25,32,134,0,102
"14941",2000-11-26,24,105,0,81
"14942",2000-11-27,39,167,0,128
"14943",2000-11-28,26,88,0,62
"14944",2000-11-29,43,106,4,63
"14945",2000-11-30,24,75,12,51
"14946",2000-12-01,-5,83,10,88
"14947",2000-12-02,44,107,21,63
"14948",2000-12-03,-11,104,0,115
"14949",2000-12-04,-13,159,0,172
"14950",2000-12-05,12,117,0,105
"14951",2000-12-06,7,130,0,123
"14952",2000-12-07,43,84,0,41
"14953",2000-12-08,23,76,0,53
"14954",2000-12-09,41,95,0,54
"14955",2000-12-10,25,61,0,36
"14956",2000-12-11,-17,28,16,45
"14957",2000-12-12,-27,82,0,109
"14958",2000-12-13,-28,107,0,135
"14959",2000-12-14,-2,105,0,107
"14960",2000-12-15,-16,99,0,115
"14961",2000-12-16,1,72,0,71
"14962",2000-12-17,-8,85,0,93
"14963",2000-12-18,-13,80,0,93
"14964",2000-12-19,24,53,0,29
"14965",2000-12-20,4,113,2,109
"14966",2000-12-21,42,164,0,122
"14967",2000-12-22,9,128,0,119
"14968",2000-12-23,26,118,0,92
"14969",2000-12-24,-1,149,0,150
"14970",2000-12-25,-14,76,0,90
"14971",2000-12-26,-4,31,0,35
"14972",2000-12-27,-3,32,0,35
"14973",2000-12-28,-33,32,0,65
"14974",2000-12-29,0,55,0,55
"14975",2000-12-30,-25,136,0,161
"14976",2000-12-31,-24,47,0,71
"14977",2001-01-01,-7,113,0,120
"14978",2001-01-02,-10,104,0,114
"14979",2001-01-03,-26,54,0,80
"14980",2001-01-04,-26,1,0,27
"14981",2001-01-05,-18,-4,0,14
"14982",2001-01-06,-33,-9,198,24
"14983",2001-01-07,-57,18,0,75
"14984",2001-01-08,-6,6,94,12
"14985",2001-01-09,-50,28,1,78
"14986",2001-01-10,-83,84,0,167
"14987",2001-01-11,-59,-30,0,29
"14988",2001-01-12,-43,57,0,100
"14989",2001-01-13,-48,38,0,86
"14990",2001-01-14,-102,1,0,103
"14991",2001-01-15,-82,4,0,86
"14992",2001-01-16,-87,8,0,95
"14993",2001-01-17,-64,-4,0,60
"14994",2001-01-18,-45,-16,0,29
"14995",2001-01-19,-31,-11,2,20
"14996",2001-01-20,-57,4,0,61
"14997",2001-01-21,-22,-5,1,17
"14998",2001-01-22,-23,-12,0,11
"14999",2001-01-23,-41,-17,76,24
"15000",2001-01-24,-37,3,39,40
"15001",2001-01-25,-34,-8,6,26
"15002",2001-01-26,-91,27,4,118
"15003",2001-01-27,-66,55,0,121
"15004",2001-01-28,-26,38,0,64
"15005",2001-01-29,-72,83,0,155
"15006",2001-01-30,-25,67,0,92
"15007",2001-01-31,7,62,0,55
"15008",2001-02-01,-6,59,0,65
"15009",2001-02-02,-23,93,0,116
"15010",2001-02-03,-4,48,0,52
"15011",2001-02-04,-23,6,0,29
"15012",2001-02-05,-29,3,54,32
"15013",2001-02-06,-47,-24,7,23
"15014",2001-02-07,-60,-16,0,44
"15015",2001-02-08,-59,48,0,107
"15016",2001-02-09,-34,67,0,101
"15017",2001-02-10,-27,35,0,62
"15018",2001-02-11,-37,3,34,40
"15019",2001-02-12,-38,-8,41,30
"15020",2001-02-13,-52,82,8,134
"15021",2001-02-14,-25,135,0,160
"15022",2001-02-15,15,125,0,110
"15023",2001-02-16,-24,98,0,122
"15024",2001-02-17,22,96,0,74
"15025",2001-02-18,-3,164,0,167
"15026",2001-02-19,23,141,0,118
"15027",2001-02-20,61,103,0,42
"15028",2001-02-21,24,197,0,173
"15029",2001-02-22,71,118,2,47
"15030",2001-02-23,-2,81,49,83
"15031",2001-02-24,-5,65,0,70
"15032",2001-02-25,-25,77,0,102
"15033",2001-02-26,-9,47,5,56
"15034",2001-02-27,21,129,1,108
"15035",2001-02-28,8,160,0,152
"15036",2001-03-01,52,202,0,150
"15037",2001-03-02,91,170,0,79
"15038",2001-03-03,63,146,0,83
"15039",2001-03-04,12,180,0,168
"15040",2001-03-05,55,189,0,134
"15041",2001-03-06,72,136,0,64
"15042",2001-03-07,-15,103,0,118
"15043",2001-03-08,16,108,0,92
"15044",2001-03-09,-19,203,0,222
"15045",2001-03-10,52,138,0,86
"15046",2001-03-11,13,200,0,187
"15047",2001-03-12,28,216,0,188
"15048",2001-03-13,98,232,0,134
"15049",2001-03-14,90,194,0,104
"15050",2001-03-15,65,115,0,50
"15051",2001-03-16,16,74,15,58
"15052",2001-03-17,18,203,0,185
"15053",2001-03-18,87,225,0,138
"15054",2001-03-19,89,238,0,149
"15055",2001-03-20,142,244,0,102
"15056",2001-03-21,83,292,0,209
"15057",2001-03-22,103,230,0,127
"15058",2001-03-23,80,193,0,113
"15059",2001-03-24,111,254,0,143
"15060",2001-03-25,109,200,0,91
"15061",2001-03-26,65,145,0,80
"15062",2001-03-27,31,118,1,87
"15063",2001-03-28,-2,151,0,153
"15064",2001-03-29,18,230,0,212
"15065",2001-03-30,75,169,0,94
"15066",2001-03-31,24,149,0,125
"15067",2001-04-01,29,200,0,171
"15068",2001-04-02,80,242,0,162
"15069",2001-04-03,94,174,0,80
"15070",2001-04-04,53,191,0,138
"15071",2001-04-05,82,189,0,107
"15072",2001-04-06,57,150,0,93
"15073",2001-04-07,49,226,0,177
"15074",2001-04-08,121,229,0,108
"15075",2001-04-09,98,197,0,99
"15076",2001-04-10,27,114,59,87
"15077",2001-04-11,73,175,0,102
"15078",2001-04-12,57,239,0,182
"15079",2001-04-13,109,179,0,70
"15080",2001-04-14,75,241,0,166
"15081",2001-04-15,96,275,0,179
"15082",2001-04-16,128,302,0,174
"15083",2001-04-17,127,290,0,163
"15084",2001-04-18,154,290,0,136
"15085",2001-04-19,126,235,0,109
"15086",2001-04-20,78,139,20,61
"15087",2001-04-21,111,180,0,69
"15088",2001-04-22,58,216,0,158
"15089",2001-04-23,108,175,2,67
"15090",2001-04-24,112,187,0,75
"15091",2001-04-25,60,214,0,154
"15092",2001-04-26,125,240,0,115
"15093",2001-04-27,137,221,0,84
"15094",2001-04-28,134,200,0,66
"15095",2001-04-29,149,211,1,62
"15096",2001-04-30,113,241,0,128
"15097",2001-05-01,121,279,0,158
"15098",2001-05-02,132,284,0,152
"15099",2001-05-03,143,291,0,148
"15100",2001-05-04,172,241,0,69
"15101",2001-05-05,140,276,0,136
"15102",2001-05-06,142,261,0,119
"15103",2001-05-07,165,275,0,110
"15104",2001-05-08,133,320,0,187
"15105",2001-05-09,136,267,0,131
"15106",2001-05-10,129,324,0,195
"15107",2001-05-11,150,279,0,129
"15108",2001-05-12,183,304,0,121
"15109",2001-05-13,199,319,0,120
"15110",2001-05-14,178,331,0,153
"15111",2001-05-15,204,299,0,95
"15112",2001-05-16,173,281,0,108
"15113",2001-05-17,178,320,0,142
"15114",2001-05-18,212,346,0,134
"15115",2001-05-19,167,364,0,197
"15116",2001-05-20,200,364,0,164
"15117",2001-05-21,195,314,0,119
"15118",2001-05-22,188,306,0,118
"15119",2001-05-23,172,339,0,167
"15120",2001-05-24,211,287,0,76
"15121",2001-05-25,187,298,0,111
"15122",2001-05-26,224,303,0,79
"15123",2001-05-27,190,316,0,126
"15124",2001-05-28,179,353,0,174
"15125",2001-05-29,217,311,0,94
"15126",2001-05-30,160,255,6,95
"15127",2001-05-31,152,314,0,162
"15128",2001-06-01,189,355,0,166
"15129",2001-06-02,187,343,0,156
"15130",2001-06-03,213,320,0,107
"15131",2001-06-04,159,311,0,152
"15132",2001-06-05,184,338,0,154
"15133",2001-06-06,224,346,0,122
"15134",2001-06-07,243,354,0,111
"15135",2001-06-08,219,329,0,110
"15136",2001-06-09,210,299,96,89
"15137",2001-06-10,219,322,0,103
"15138",2001-06-11,212,327,0,115
"15139",2001-06-12,220,281,11,61
"15140",2001-06-13,168,325,0,157
"15141",2001-06-14,204,329,0,125
"15142",2001-06-15,231,312,0,81
"15143",2001-06-16,236,302,0,66
"15144",2001-06-17,197,325,0,128
"15145",2001-06-18,217,342,3,125
"15146",2001-06-19,173,314,265,141
"15147",2001-06-20,229,300,0,71
"15148",2001-06-21,220,331,0,111
"15149",2001-06-22,203,334,134,131
"15150",2001-06-23,204,305,38,101
"15151",2001-06-24,215,290,0,75
"15152",2001-06-25,212,316,0,104
"15153",2001-06-26,208,353,0,145
"15154",2001-06-27,262,380,0,118
"15155",2001-06-28,258,344,38,86
"15156",2001-06-29,224,296,167,72
"15157",2001-06-30,236,374,0,138
"15158",2001-07-01,241,384,0,143
"15159",2001-07-02,255,346,0,91
"15160",2001-07-03,240,280,69,40
"15161",2001-07-04,234,350,0,116
"15162",2001-07-05,235,352,0,117
"15163",2001-07-06,257,329,0,72
"15164",2001-07-07,220,335,0,115
"15165",2001-07-08,234,365,0,131
"15166",2001-07-09,290,391,0,101
"15167",2001-07-10,247,321,2,74
"15168",2001-07-11,204,299,131,95
"15169",2001-07-12,190,356,0,166
"15170",2001-07-13,235,338,0,103
"15171",2001-07-14,228,317,0,89
"15172",2001-07-15,233,334,0,101
"15173",2001-07-16,238,337,0,99
"15174",2001-07-17,209,334,0,125
"15175",2001-07-18,208,330,0,122
"15176",2001-07-19,231,349,0,118
"15177",2001-07-20,245,329,124,84
"15178",2001-07-21,233,291,78,58
"15179",2001-07-22,234,300,0,66
"15180",2001-07-23,250,291,4,41
"15181",2001-07-24,238,306,77,68
"15182",2001-07-25,246,329,4,83
"15183",2001-07-26,256,315,9,59
"15184",2001-07-27,206,260,29,54
"15185",2001-07-28,196,276,201,80
"15186",2001-07-29,233,264,52,31
"15187",2001-07-30,194,264,194,70
"15188",2001-07-31,197,304,0,107
"15189",2001-08-01,242,313,0,71
"15190",2001-08-02,227,304,0,77
"15191",2001-08-03,226,311,0,85
"15192",2001-08-04,234,324,0,90
"15193",2001-08-05,242,335,0,93
"15194",2001-08-06,263,364,0,101
"15195",2001-08-07,244,347,100,103
"15196",2001-08-08,236,295,16,59
"15197",2001-08-09,229,278,0,49
"15198",2001-08-10,202,313,0,111
"15199",2001-08-11,208,302,0,94
"15200",2001-08-12,191,312,0,121
"15201",2001-08-13,199,312,0,113
"15202",2001-08-14,220,316,0,96
"15203",2001-08-15,207,298,532,91
"15204",2001-08-16,213,290,0,77
"15205",2001-08-17,217,305,0,88
"15206",2001-08-18,230,304,1,74
"15207",2001-08-19,245,307,0,62
"15208",2001-08-20,233,293,0,60
"15209",2001-08-21,224,342,0,118
"15210",2001-08-22,196,364,0,168
"15211",2001-08-23,203,319,0,116
"15212",2001-08-24,234,324,0,90
"15213",2001-08-25,239,305,0,66
"15214",2001-08-26,215,286,0,71
"15215",2001-08-27,221,279,0,58
"15216",2001-08-28,186,262,0,76
"15217",2001-08-29,205,263,9,58
"15218",2001-08-30,188,248,0,60
"15219",2001-08-31,206,260,0,54
"15220",2001-09-01,179,300,0,121
"15221",2001-09-02,187,297,0,110
"15222",2001-09-03,205,274,0,69
"15223",2001-09-04,185,302,0,117
"15224",2001-09-05,196,320,0,124
"15225",2001-09-06,193,300,0,107
"15226",2001-09-07,177,274,0,97
"15227",2001-09-08,210,274,0,64
"15228",2001-09-09,177,267,0,90
"15229",2001-09-10,201,277,0,76
"15230",2001-09-11,147,275,0,128
"15231",2001-09-12,158,282,0,124
"15232",2001-09-13,175,307,0,132
"15233",2001-09-14,181,303,0,122
"15234",2001-09-15,202,295,0,93
"15235",2001-09-16,187,326,0,139
"15236",2001-09-17,207,270,15,63
"15237",2001-09-18,202,248,0,46
"15238",2001-09-19,147,205,1,58
"15239",2001-09-20,157,176,0,19
"15240",2001-09-21,154,170,29,16
"15241",2001-09-22,149,225,26,76
"15242",2001-09-23,172,258,4,86
"15243",2001-09-24,183,274,34,91
"15244",2001-09-25,169,255,0,86
"15245",2001-09-26,171,259,0,88
"15246",2001-09-27,140,265,0,125
"15247",2001-09-28,165,246,0,81
"15248",2001-09-29,163,217,40,54
"15249",2001-09-30,133,272,0,139
"15250",2001-10-01,122,283,0,161
"15251",2001-10-02,134,221,0,87
"15252",2001-10-03,158,242,0,84
"15253",2001-10-04,75,220,0,145
"15254",2001-10-05,107,235,0,128
"15255",2001-10-06,109,202,0,93
"15256",2001-10-07,142,186,18,44
"15257",2001-10-08,119,238,0,119
"15258",2001-10-09,136,259,0,123
"15259",2001-10-10,90,240,0,150
"15260",2001-10-11,120,205,0,85
"15261",2001-10-12,127,212,1,85
"15262",2001-10-13,145,177,57,32
"15263",2001-10-14,152,170,14,18
"15264",2001-10-15,119,234,6,115
"15265",2001-10-16,155,205,0,50
"15266",2001-10-17,119,209,0,90
"15267",2001-10-18,99,236,0,137
"15268",2001-10-19,139,208,1,69
"15269",2001-10-20,142,212,1,70
"15270",2001-10-21,131,246,0,115
"15271",2001-10-22,123,261,0,138
"15272",2001-10-23,108,253,0,145
"15273",2001-10-24,136,236,0,100
"15274",2001-10-25,132,187,268,55
"15275",2001-10-26,130,175,8,45
"15276",2001-10-27,145,230,2,85
"15277",2001-10-28,119,196,0,77
"15278",2001-10-29,54,190,0,136
"15279",2001-10-30,73,199,0,126
"15280",2001-10-31,113,215,0,102
"15281",2001-11-01,87,172,0,85
"15282",2001-11-02,83,108,4,25
"15283",2001-11-03,86,155,0,69
"15284",2001-11-04,96,149,1,53
"15285",2001-11-05,83,168,0,85
"15286",2001-11-06,23,154,0,131
"15287",2001-11-07,59,158,0,99
"15288",2001-11-08,38,174,0,136
"15289",2001-11-09,75,137,0,62
"15290",2001-11-10,20,164,0,144
"15291",2001-11-11,66,196,0,130
"15292",2001-11-12,41,141,0,100
"15293",2001-11-13,65,153,0,88
"15294",2001-11-14,0,161,0,161
"15295",2001-11-15,23,149,0,126
"15296",2001-11-16,19,160,0,141
"15297",2001-11-17,16,161,0,145
"15298",2001-11-18,6,183,0,177
"15299",2001-11-19,73,181,0,108
"15300",2001-11-20,16,200,0,184
"15301",2001-11-21,24,202,0,178
"15302",2001-11-22,47,194,0,147
"15303",2001-11-23,47,210,0,163
"15304",2001-11-24,118,190,0,72
"15305",2001-11-25,42,128,0,86
"15306",2001-11-26,-8,92,0,100
"15307",2001-11-27,-25,106,0,131
"15308",2001-11-28,44,109,0,65
"15309",2001-11-29,38,107,0,69
"15310",2001-11-30,-3,109,0,112
"15311",2001-12-01,23,99,0,76
"15312",2001-12-02,1,47,64,46
"15313",2001-12-03,2,40,87,38
"15314",2001-12-04,-5,34,44,39
"15315",2001-12-05,-8,24,23,32
"15316",2001-12-06,-7,37,0,44
"15317",2001-12-07,-23,15,0,38
"15318",2001-12-08,-41,17,0,58
"15319",2001-12-09,1,21,32,20
"15320",2001-12-10,2,15,18,13
"15321",2001-12-11,-1,7,88,8
"15322",2001-12-12,0,35,16,35
"15323",2001-12-13,-15,21,0,36
"15324",2001-12-14,-30,69,0,99
"15325",2001-12-15,-34,6,0,40
"15326",2001-12-16,-31,71,0,102
"15327",2001-12-17,-11,34,0,45
"15328",2001-12-18,-12,12,0,24
"15329",2001-12-19,-13,5,1,18
"15330",2001-12-20,-36,35,5,71
"15331",2001-12-21,-16,52,0,68
"15332",2001-12-22,-50,83,0,133
"15333",2001-12-23,-41,50,0,91
"15334",2001-12-24,-39,8,0,47
"15335",2001-12-25,-89,24,0,113
"15336",2001-12-26,-35,40,0,75
"15337",2001-12-27,-64,55,0,119
"15338",2001-12-28,-31,91,0,122
"15339",2001-12-29,31,118,0,87
"15340",2001-12-30,-30,139,0,169
"15341",2001-12-31,-8,85,0,93
"15342",2002-01-01,-45,86,0,131
"15343",2002-01-02,-9,142,0,151
"15344",2002-01-03,27,137,0,110
"15345",2002-01-04,70,161,0,91
"15346",2002-01-05,53,169,0,116
"15347",2002-01-06,34,177,0,143
"15348",2002-01-07,-5,130,0,135
"15349",2002-01-08,-32,96,0,128
"15350",2002-01-09,-18,175,0,193
"15351",2002-01-10,65,197,0,132
"15352",2002-01-11,5,203,0,198
"15353",2002-01-12,37,111,88,74
"15354",2002-01-13,27,63,1,36
"15355",2002-01-14,22,47,1,25
"15356",2002-01-15,20,61,7,41
"15357",2002-01-16,3,44,11,41
"15358",2002-01-17,0,59,0,59
"15359",2002-01-18,-10,74,0,84
"15360",2002-01-19,-8,103,0,111
"15361",2002-01-20,48,89,0,41
"15362",2002-01-21,-3,91,0,94
"15363",2002-01-22,-10,71,0,81
"15364",2002-01-23,-61,69,0,130
"15365",2002-01-24,-17,84,0,101
"15366",2002-01-25,-45,55,0,100
"15367",2002-01-26,-34,76,0,110
"15368",2002-01-27,-15,59,0,74
"15369",2002-01-28,-24,75,0,99
"15370",2002-01-29,2,97,0,95
"15371",2002-01-30,28,99,0,71
"15372",2002-01-31,-19,98,0,117
"15373",2002-02-01,17,113,0,96
"15374",2002-02-02,-35,144,0,179
"15375",2002-02-03,-7,129,0,136
"15376",2002-02-04,28,149,0,121
"15377",2002-02-05,8,170,0,162
"15378",2002-02-06,29,125,0,96
"15379",2002-02-07,-20,150,0,170
"15380",2002-02-08,45,108,0,63
"15381",2002-02-09,-9,116,0,125
"15382",2002-02-10,49,140,0,91
"15383",2002-02-11,14,162,0,148
"15384",2002-02-12,34,193,0,159
"15385",2002-02-13,15,105,0,90
"15386",2002-02-14,11,99,0,88
"15387",2002-02-15,51,134,0,83
"15388",2002-02-16,31,174,0,143
"15389",2002-02-17,35,188,0,153
"15390",2002-02-18,30,119,0,89
"15391",2002-02-19,-29,111,0,140
"15392",2002-02-20,20,108,0,88
"15393",2002-02-21,43,176,0,133
"15394",2002-02-22,21,125,0,104
"15395",2002-02-23,32,147,0,115
"15396",2002-02-24,18,139,0,121
"15397",2002-02-25,70,149,0,79
"15398",2002-02-26,85,135,0,50
"15399",2002-02-27,63,115,0,52
"15400",2002-02-28,24,165,0,141
"15401",2002-03-01,37,106,0,69
"15402",2002-03-02,11,94,60,83
"15403",2002-03-03,7,37,0,30
"15404",2002-03-04,1,36,83,35
"15405",2002-03-05,12,128,0,116
"15406",2002-03-06,34,170,0,136
"15407",2002-03-07,51,151,0,100
"15408",2002-03-08,15,185,0,170
"15409",2002-03-09,57,231,0,174
"15410",2002-03-10,108,168,0,60
"15411",2002-03-11,93,196,0,103
"15412",2002-03-12,74,222,0,148
"15413",2002-03-13,117,171,84,54
"15414",2002-03-14,99,237,5,138
"15415",2002-03-15,130,213,0,83
"15416",2002-03-16,90,216,0,126
"15417",2002-03-17,80,185,0,105
"15418",2002-03-18,48,220,0,172
"15419",2002-03-19,86,258,0,172
"15420",2002-03-20,100,194,3,94
"15421",2002-03-21,87,146,0,59
"15422",2002-03-22,92,170,0,78
"15423",2002-03-23,39,173,0,134
"15424",2002-03-24,89,172,0,83
"15425",2002-03-25,68,184,0,116
"15426",2002-03-26,79,221,0,142
"15427",2002-03-27,99,186,0,87
"15428",2002-03-28,91,251,0,160
"15429",2002-03-29,108,291,0,183
"15430",2002-03-30,179,245,17,66
"15431",2002-03-31,85,279,0,194
"15432",2002-04-01,122,278,0,156
"15433",2002-04-02,147,303,0,156
"15434",2002-04-03,144,235,0,91
"15435",2002-04-04,114,180,0,66
"15436",2002-04-05,121,172,122,51
"15437",2002-04-06,76,259,0,183
"15438",2002-04-07,80,231,37,151
"15439",2002-04-08,62,179,0,117
"15440",2002-04-09,78,162,0,84
"15441",2002-04-10,114,190,0,76
"15442",2002-04-11,56,259,0,203
"15443",2002-04-12,121,229,0,108
"15444",2002-04-13,104,320,0,216
"15445",2002-04-14,178,342,0,164
"15446",2002-04-15,164,291,0,127
"15447",2002-04-16,116,217,14,101
"15448",2002-04-17,100,195,0,95
"15449",2002-04-18,59,213,0,154
"15450",2002-04-19,106,240,0,134
"15451",2002-04-20,117,259,0,142
"15452",2002-04-21,142,284,0,142
"15453",2002-04-22,135,238,0,103
"15454",2002-04-23,101,143,0,42
"15455",2002-04-24,98,159,0,61
"15456",2002-04-25,105,145,0,40
"15457",2002-04-26,104,147,0,43
"15458",2002-04-27,104,135,0,31
"15459",2002-04-28,109,123,73,14
"15460",2002-04-29,115,201,15,86
"15461",2002-04-30,145,205,0,60
"15462",2002-05-01,115,190,38,75
"15463",2002-05-02,106,188,103,82
"15464",2002-05-03,104,238,0,134
"15465",2002-05-04,159,219,4,60
"15466",2002-05-05,126,186,217,60
"15467",2002-05-06,106,149,135,43
"15468",2002-05-07,86,211,0,125
"15469",2002-05-08,119,219,0,100
"15470",2002-05-09,149,217,0,68
"15471",2002-05-10,155,251,3,96
"15472",2002-05-11,155,293,0,138
"15473",2002-05-12,179,296,0,117
"15474",2002-05-13,183,247,51,64
"15475",2002-05-14,145,187,497,42
"15476",2002-05-15,140,210,1,70
"15477",2002-05-16,136,240,0,104
"15478",2002-05-17,125,246,0,121
"15479",2002-05-18,134,235,0,101
"15480",2002-05-19,163,269,0,106
"15481",2002-05-20,164,230,17,66
"15482",2002-05-21,161,201,3,40
"15483",2002-05-22,152,269,0,117
"15484",2002-05-23,152,299,0,147
"15485",2002-05-24,208,314,0,106
"15486",2002-05-25,191,327,0,136
"15487",2002-05-26,163,334,0,171
"15488",2002-05-27,189,321,4,132
"15489",2002-05-28,169,316,0,147
"15490",2002-05-29,195,324,0,129
"15491",2002-05-30,191,343,0,152
"15492",2002-05-31,212,366,0,154
"15493",2002-06-01,231,384,55,153
"15494",2002-06-02,196,350,3,154
"15495",2002-06-03,226,367,0,141
"15496",2002-06-04,203,376,0,173
"15497",2002-06-05,247,379,0,132
"15498",2002-06-06,246,374,0,128
"15499",2002-06-07,236,378,0,142
"15500",2002-06-08,203,325,2,122
"15501",2002-06-09,154,207,137,53
"15502",2002-06-10,162,326,1,164
"15503",2002-06-11,208,349,0,141
"15504",2002-06-12,201,366,0,165
"15505",2002-06-13,186,354,0,168
"15506",2002-06-14,213,371,0,158
"15507",2002-06-15,219,323,26,104
"15508",2002-06-16,232,350,0,118
"15509",2002-06-17,234,374,0,140
"15510",2002-06-18,233,354,0,121
"15511",2002-06-19,233,354,0,121
"15512",2002-06-20,257,345,0,88
"15513",2002-06-21,245,330,0,85
"15514",2002-06-22,185,299,502,114
"15515",2002-06-23,191,232,114,41
"15516",2002-06-24,188,269,0,81
"15517",2002-06-25,195,265,0,70
"15518",2002-06-26,225,282,8,57
"15519",2002-06-27,205,257,146,52
"15520",2002-06-28,199,297,0,98
"15521",2002-06-29,219,309,0,90
"15522",2002-06-30,232,319,0,87
"15523",2002-07-01,236,336,0,100
"15524",2002-07-02,215,305,116,90
"15525",2002-07-03,234,326,0,92
"15526",2002-07-04,247,298,2,51
"15527",2002-07-05,228,297,62,69
"15528",2002-07-06,239,320,0,81
"15529",2002-07-07,237,324,0,87
"15530",2002-07-08,245,336,0,91
"15531",2002-07-09,235,341,0,106
"15532",2002-07-10,225,354,0,129
"15533",2002-07-11,227,356,0,129
"15534",2002-07-12,257,355,0,98
"15535",2002-07-13,274,354,0,80
"15536",2002-07-14,266,392,0,126
"15537",2002-07-15,255,415,0,160
"15538",2002-07-16,282,372,0,90
"15539",2002-07-17,255,364,0,109
"15540",2002-07-18,201,316,222,115
"15541",2002-07-19,185,297,85,112
"15542",2002-07-20,209,288,50,79
"15543",2002-07-21,225,276,18,51
"15544",2002-07-22,231,289,34,58
"15545",2002-07-23,229,283,153,54
"15546",2002-07-24,237,308,0,71
"15547",2002-07-25,233,304,0,71
"15548",2002-07-26,211,261,28,50
"15549",2002-07-27,221,256,31,35
"15550",2002-07-28,218,254,101,36
"15551",2002-07-29,233,304,0,71
"15552",2002-07-30,237,338,0,101
"15553",2002-07-31,258,348,0,90
"15554",2002-08-01,247,351,0,104
"15555",2002-08-02,266,345,0,79
"15556",2002-08-03,267,347,0,80
"15557",2002-08-04,273,360,0,87
"15558",2002-08-05,248,350,52,102
"15559",2002-08-06,237,307,176,70
"15560",2002-08-07,237,294,0,57
"15561",2002-08-08,213,279,0,66
"15562",2002-08-09,227,288,0,61
"15563",2002-08-10,194,275,0,81
"15564",2002-08-11,193,296,0,103
"15565",2002-08-12,222,282,0,60
"15566",2002-08-13,192,281,0,89
"15567",2002-08-14,180,289,0,109
"15568",2002-08-15,203,290,0,87
"15569",2002-08-16,208,294,110,86
"15570",2002-08-17,199,284,184,85
"15571",2002-08-18,200,295,0,95
"15572",2002-08-19,216,286,0,70
"15573",2002-08-20,214,260,22,46
"15574",2002-08-21,217,308,0,91
"15575",2002-08-22,237,366,0,129
"15576",2002-08-23,250,363,0,113
"15577",2002-08-24,215,307,926,92
"15578",2002-08-25,228,301,0,73
"15579",2002-08-26,231,311,2,80
"15580",2002-08-27,228,335,0,107
"15581",2002-08-28,237,339,0,102
"15582",2002-08-29,237,330,0,93
"15583",2002-08-30,227,337,0,110
"15584",2002-08-31,222,354,0,132
"15585",2002-09-01,206,378,0,172
"15586",2002-09-02,216,352,0,136
"15587",2002-09-03,224,281,0,57
"15588",2002-09-04,196,270,0,74
"15589",2002-09-05,171,233,0,62
"15590",2002-09-06,159,264,0,105
"15591",2002-09-07,164,285,0,121
"15592",2002-09-08,158,313,0,155
"15593",2002-09-09,199,314,0,115
"15594",2002-09-10,228,319,0,91
"15595",2002-09-11,172,301,0,129
"15596",2002-09-12,146,190,76,44
"15597",2002-09-13,135,184,115,49
"15598",2002-09-14,134,200,88,66
"15599",2002-09-15,145,237,90,92
"15600",2002-09-16,140,265,0,125
"15601",2002-09-17,146,272,0,126
"15602",2002-09-18,166,278,0,112
"15603",2002-09-19,185,266,0,81
"15604",2002-09-20,169,236,72,67
"15605",2002-09-21,156,191,17,35
"15606",2002-09-22,112,292,0,180
"15607",2002-09-23,155,299,0,144
"15608",2002-09-24,135,299,0,164
"15609",2002-09-25,135,300,0,165
"15610",2002-09-26,154,275,0,121
"15611",2002-09-27,188,283,0,95
"15612",2002-09-28,147,266,0,119
"15613",2002-09-29,130,269,0,139
"15614",2002-09-30,137,297,0,160
"15615",2002-10-01,172,290,0,118
"15616",2002-10-02,131,323,0,192
"15617",2002-10-03,142,259,0,117
"15618",2002-10-04,142,326,0,184
"15619",2002-10-05,188,259,0,71
"15620",2002-10-06,129,227,0,98
"15621",2002-10-07,103,237,0,134
"15622",2002-10-08,73,254,0,181
"15623",2002-10-09,128,275,0,147
"15624",2002-10-10,147,253,0,106
"15625",2002-10-11,147,259,0,112
"15626",2002-10-12,156,272,0,116
"15627",2002-10-13,145,246,0,101
"15628",2002-10-14,154,297,0,143
"15629",2002-10-15,138,299,0,161
"15630",2002-10-16,139,304,0,165
"15631",2002-10-17,174,258,0,84
"15632",2002-10-18,99,210,0,111
"15633",2002-10-19,61,102,163,41
"15634",2002-10-20,56,136,14,80
"15635",2002-10-21,54,114,0,60
"15636",2002-10-22,64,107,0,43
"15637",2002-10-23,63,196,0,133
"15638",2002-10-24,64,180,0,116
"15639",2002-10-25,70,129,0,59
"15640",2002-10-26,25,177,0,152
"15641",2002-10-27,59,115,0,56
"15642",2002-10-28,46,81,0,35
"15643",2002-10-29,1,139,0,138
"15644",2002-10-30,72,114,0,42
"15645",2002-10-31,84,105,0,21
"15646",2002-11-01,70,154,0,84
"15647",2002-11-02,61,160,0,99
"15648",2002-11-03,56,158,0,102
"15649",2002-11-04,17,229,0,212
"15650",2002-11-05,29,195,0,166
"15651",2002-11-06,43,172,0,129
"15652",2002-11-07,70,167,0,97
"15653",2002-11-08,14,124,0,110
"15654",2002-11-09,-2,129,0,131
"15655",2002-11-10,31,250,0,219
"15656",2002-11-11,107,214,0,107
"15657",2002-11-12,73,147,0,74
"15658",2002-11-13,30,106,0,76
"15659",2002-11-14,41,120,0,79
"15660",2002-11-15,44,147,0,103
"15661",2002-11-16,19,198,0,179
"15662",2002-11-17,18,85,0,67
"15663",2002-11-18,-11,37,27,48
"15664",2002-11-19,-9,39,2,48
"15665",2002-11-20,13,137,0,124
"15666",2002-11-21,13,106,0,93
"15667",2002-11-22,15,110,0,95
"15668",2002-11-23,37,76,0,39
"15669",2002-11-24,-5,147,0,152
"15670",2002-11-25,11,149,0,138
"15671",2002-11-26,-24,108,0,132
"15672",2002-11-27,-16,139,0,155
"15673",2002-11-28,2,104,0,102
"15674",2002-11-29,30,116,0,86
"15675",2002-11-30,-7,184,0,191
"15676",2002-12-01,14,108,0,94
"15677",2002-12-02,44,73,0,29
"15678",2002-12-03,56,138,2,82
"15679",2002-12-04,23,79,0,56
"15680",2002-12-05,35,72,0,37
"15681",2002-12-06,-4,35,75,39
"15682",2002-12-07,-1,13,17,14
"15683",2002-12-08,-20,48,0,68
"15684",2002-12-09,-34,73,0,107
"15685",2002-12-10,-30,104,0,134
"15686",2002-12-11,-16,29,0,45
"15687",2002-12-12,-11,46,0,57
"15688",2002-12-13,-20,21,0,41
"15689",2002-12-14,15,42,0,27
"15690",2002-12-15,21,62,0,41
"15691",2002-12-16,-25,70,0,95
"15692",2002-12-17,11,91,0,80
"15693",2002-12-18,20,53,0,33
"15694",2002-12-19,9,36,2,27
"15695",2002-12-20,4,22,24,18
"15696",2002-12-21,2,17,55,15
"15697",2002-12-22,-12,8,33,20
"15698",2002-12-23,-21,-7,55,14
"15699",2002-12-24,-40,-19,4,21
"15700",2002-12-25,-80,-22,0,58
"15701",2002-12-26,-89,-3,0,86
"15702",2002-12-27,-99,22,0,121
"15703",2002-12-28,-18,38,0,56
"15704",2002-12-29,-46,30,0,76
"15705",2002-12-30,-33,44,0,77
"15706",2002-12-31,-75,37,0,112
"15707",2003-01-01,-64,4,0,68
"15708",2003-01-02,-30,57,0,87
"15709",2003-01-03,-40,24,0,64
"15710",2003-01-04,-78,15,0,93
"15711",2003-01-05,-94,17,0,111
"15712",2003-01-06,-84,16,0,100
"15713",2003-01-07,-87,27,0,114
"15714",2003-01-08,-72,63,0,135
"15715",2003-01-09,3,95,0,92
"15716",2003-01-10,-48,107,0,155
"15717",2003-01-11,19,114,0,95
"15718",2003-01-12,39,137,0,98
"15719",2003-01-13,62,151,0,89
"15720",2003-01-14,13,82,0,69
"15721",2003-01-15,-30,76,0,106
"15722",2003-01-16,-31,128,0,159
"15723",2003-01-17,-15,68,0,83
"15724",2003-01-18,-25,115,0,140
"15725",2003-01-19,-41,84,0,125
"15726",2003-01-20,-25,62,0,87
"15727",2003-01-21,-46,54,0,100
"15728",2003-01-22,24,118,0,94
"15729",2003-01-23,-39,93,0,132
"15730",2003-01-24,-25,63,0,88
"15731",2003-01-25,-5,38,18,43
"15732",2003-01-26,4,61,27,57
"15733",2003-01-27,-19,49,0,68
"15734",2003-01-28,-51,84,0,135
"15735",2003-01-29,-67,56,0,123
"15736",2003-01-30,-36,20,2,56
"15737",2003-01-31,-25,9,30,34
"15738",2003-02-01,-45,69,0,114
"15739",2003-02-02,-23,99,0,122
"15740",2003-02-03,6,124,0,118
"15741",2003-02-04,42,113,0,71
"15742",2003-02-05,-34,95,0,129
"15743",2003-02-06,-29,135,0,164
"15744",2003-02-07,-2,120,0,122
"15745",2003-02-08,-6,106,0,112
"15746",2003-02-09,-16,67,73,83
"15747",2003-02-10,-54,-15,62,39
"15748",2003-02-11,-75,2,0,77
"15749",2003-02-12,-67,55,0,122
"15750",2003-02-13,-41,77,0,118
"15751",2003-02-14,11,47,1,36
"15752",2003-02-15,-2,106,0,108
"15753",2003-02-16,-16,123,0,139
"15754",2003-02-17,11,150,0,139
"15755",2003-02-18,9,145,0,136
"15756",2003-02-19,15,129,0,114
"15757",2003-02-20,-3,98,0,101
"15758",2003-02-21,23,88,97,65
"15759",2003-02-22,27,65,12,38
"15760",2003-02-23,24,97,5,73
"15761",2003-02-24,15,144,0,129
"15762",2003-02-25,60,123,0,63
"15763",2003-02-26,51,110,0,59
"15764",2003-02-27,30,75,0,45
"15765",2003-02-28,21,99,0,78
"15766",2003-03-01,-1,120,0,121
"15767",2003-03-02,59,189,0,130
"15768",2003-03-03,10,100,0,90
"15769",2003-03-04,-8,32,1,40
"15770",2003-03-05,-26,-7,49,19
"15771",2003-03-06,-45,77,2,122
"15772",2003-03-07,21,134,0,113
"15773",2003-03-08,38,156,0,118
"15774",2003-03-09,26,147,0,121
"15775",2003-03-10,27,142,0,115
"15776",2003-03-11,34,109,0,75
"15777",2003-03-12,44,86,0,42
"15778",2003-03-13,44,76,3,32
"15779",2003-03-14,20,56,172,36
"15780",2003-03-15,16,33,42,17
"15781",2003-03-16,14,60,35,46
"15782",2003-03-17,38,80,0,42
"15783",2003-03-18,17,128,0,111
"15784",2003-03-19,30,143,0,113
"15785",2003-03-20,32,202,0,170
"15786",2003-03-21,47,138,0,91
"15787",2003-03-22,11,127,0,116
"15788",2003-03-23,47,192,0,145
"15789",2003-03-24,43,209,0,166
"15790",2003-03-25,86,226,0,140
"15791",2003-03-26,126,196,0,70
"15792",2003-03-27,52,169,0,117
"15793",2003-03-28,82,206,0,124
"15794",2003-03-29,92,254,0,162
"15795",2003-03-30,123,247,0,124
"15796",2003-03-31,122,217,21,95
"15797",2003-04-01,94,132,2,38
"15798",2003-04-02,85,127,2,42
"15799",2003-04-03,71,146,5,75
"15800",2003-04-04,55,181,0,126
"15801",2003-04-05,51,200,0,149
"15802",2003-04-06,70,206,2,136
"15803",2003-04-07,133,240,13,107
"15804",2003-04-08,119,201,0,82
"15805",2003-04-09,106,182,0,76
"15806",2003-04-10,86,175,8,89
"15807",2003-04-11,71,192,0,121
"15808",2003-04-12,83,226,0,143
"15809",2003-04-13,132,219,0,87
"15810",2003-04-14,69,273,0,204
"15811",2003-04-15,120,267,0,147
"15812",2003-04-16,138,293,0,155
"15813",2003-04-17,152,254,2,102
"15814",2003-04-18,101,157,13,56
"15815",2003-04-19,85,128,94,43
"15816",2003-04-20,75,189,0,114
"15817",2003-04-21,91,153,0,62
"15818",2003-04-22,94,151,30,57
"15819",2003-04-23,107,214,0,107
"15820",2003-04-24,139,189,0,50
"15821",2003-04-25,106,236,0,130
"15822",2003-04-26,127,305,0,178
"15823",2003-04-27,158,278,0,120
"15824",2003-04-28,129,243,0,114
"15825",2003-04-29,170,235,0,65
"15826",2003-04-30,140,310,0,170
"15827",2003-05-01,158,307,0,149
"15828",2003-05-02,150,293,0,143
"15829",2003-05-03,170,251,0,81
"15830",2003-05-04,172,224,0,52
"15831",2003-05-05,171,201,0,30
"15832",2003-05-06,167,194,98,27
"15833",2003-05-07,136,187,119,51
"15834",2003-05-08,125,181,0,56
"15835",2003-05-09,109,223,0,114
"15836",2003-05-10,113,253,0,140
"15837",2003-05-11,128,267,0,139
"15838",2003-05-12,157,276,0,119
"15839",2003-05-13,157,236,0,79
"15840",2003-05-14,177,238,75,61
"15841",2003-05-15,146,203,0,57
"15842",2003-05-16,157,239,0,82
"15843",2003-05-17,150,252,0,102
"15844",2003-05-18,172,286,7,114
"15845",2003-05-19,156,277,40,121
"15846",2003-05-20,144,282,0,138
"15847",2003-05-21,187,275,0,88
"15848",2003-05-22,136,281,0,145
"15849",2003-05-23,173,259,0,86
"15850",2003-05-24,161,293,0,132
"15851",2003-05-25,158,314,0,156
"15852",2003-05-26,171,287,0,116
"15853",2003-05-27,198,281,0,83
"15854",2003-05-28,194,327,0,133
"15855",2003-05-29,202,324,0,122
"15856",2003-05-30,188,335,0,147
"15857",2003-05-31,185,337,0,152
"15858",2003-06-01,219,347,0,128
"15859",2003-06-02,179,300,73,121
"15860",2003-06-03,178,227,17,49
"15861",2003-06-04,170,298,0,128
"15862",2003-06-05,185,330,10,145
"15863",2003-06-06,191,326,0,135
"15864",2003-06-07,185,363,0,178
"15865",2003-06-08,222,334,0,112
"15866",2003-06-09,197,287,163,90
"15867",2003-06-10,196,249,7,53
"15868",2003-06-11,193,299,0,106
"15869",2003-06-12,170,318,0,148
"15870",2003-06-13,177,307,0,130
"15871",2003-06-14,219,346,0,127
"15872",2003-06-15,192,303,16,111
"15873",2003-06-16,198,317,0,119
"15874",2003-06-17,218,350,0,132
"15875",2003-06-18,235,363,0,128
"15876",2003-06-19,237,364,0,127
"15877",2003-06-20,220,347,0,127
"15878",2003-06-21,209,321,0,112
"15879",2003-06-22,212,282,406,70
"15880",2003-06-23,205,327,0,122
"15881",2003-06-24,238,334,0,96
"15882",2003-06-25,224,327,0,103
"15883",2003-06-26,200,288,95,88
"15884",2003-06-27,189,340,0,151
"15885",2003-06-28,222,360,0,138
"15886",2003-06-29,194,303,541,109
"15887",2003-06-30,185,207,92,22
"15888",2003-07-01,198,264,40,66
"15889",2003-07-02,205,255,136,50
"15890",2003-07-03,197,302,0,105
"15891",2003-07-04,233,327,6,94
"15892",2003-07-05,222,287,0,65
"15893",2003-07-06,202,305,0,103
"15894",2003-07-07,232,329,0,97
"15895",2003-07-08,239,294,7,55
"15896",2003-07-09,206,297,0,91
"15897",2003-07-10,189,308,0,119
"15898",2003-07-11,203,297,42,94
"15899",2003-07-12,194,221,120,27
"15900",2003-07-13,195,237,48,42
"15901",2003-07-14,194,274,97,80
"15902",2003-07-15,197,245,4,48
"15903",2003-07-16,192,223,427,31
"15904",2003-07-17,198,281,6,83
"15905",2003-07-18,193,297,98,104
"15906",2003-07-19,222,324,44,102
"15907",2003-07-20,225,325,0,100
"15908",2003-07-21,241,283,17,42
"15909",2003-07-22,216,304,0,88
"15910",2003-07-23,239,306,0,67
"15911",2003-07-24,263,346,0,83
"15912",2003-07-25,276,356,0,80
"15913",2003-07-26,269,344,0,75
"15914",2003-07-27,284,368,0,84
"15915",2003-07-28,261,332,0,71
"15916",2003-07-29,269,337,2,68
"15917",2003-07-30,276,350,37,74
"15918",2003-07-31,275,344,0,69
"15919",2003-08-01,247,299,0,52
"15920",2003-08-02,235,331,0,96
"15921",2003-08-03,232,287,7,55
"15922",2003-08-04,235,297,0,62
"15923",2003-08-05,239,326,0,87
"15924",2003-08-06,259,340,162,81
"15925",2003-08-07,248,338,0,90
"15926",2003-08-08,240,312,0,72
"15927",2003-08-09,236,334,0,98
"15928",2003-08-10,242,289,3,47
"15929",2003-08-11,212,276,11,64
"15930",2003-08-12,196,247,191,51
"15931",2003-08-13,199,230,47,31
"15932",2003-08-14,197,231,16,34
"15933",2003-08-15,192,208,443,16
"15934",2003-08-16,163,252,0,89
"15935",2003-08-17,196,246,0,50
"15936",2003-08-18,189,284,0,95
"15937",2003-08-19,215,293,0,78
"15938",2003-08-20,192,282,0,90
"15939",2003-08-21,241,280,9,39
"15940",2003-08-22,230,329,0,99
"15941",2003-08-23,254,334,54,80
"15942",2003-08-24,234,257,0,23
"15943",2003-08-25,222,277,0,55
"15944",2003-08-26,211,261,240,50
"15945",2003-08-27,193,298,316,105
"15946",2003-08-28,204,302,115,98
"15947",2003-08-29,165,244,659,79
"15948",2003-08-30,132,175,380,43
"15949",2003-08-31,119,224,3,105
"15950",2003-09-01,154,188,355,34
"15951",2003-09-02,172,260,3,88
"15952",2003-09-03,189,252,23,63
"15953",2003-09-04,180,219,159,39
"15954",2003-09-05,197,274,32,77
"15955",2003-09-06,198,234,97,36
"15956",2003-09-07,190,260,48,70
"15957",2003-09-08,161,243,0,82
"15958",2003-09-09,169,258,0,89
"15959",2003-09-10,155,283,0,128
"15960",2003-09-11,163,289,0,126
"15961",2003-09-12,163,295,0,132
"15962",2003-09-13,180,334,0,154
"15963",2003-09-14,201,313,0,112
"15964",2003-09-15,205,292,0,87
"15965",2003-09-16,230,318,0,88
"15966",2003-09-17,235,313,0,78
"15967",2003-09-18,186,279,103,93
"15968",2003-09-19,154,209,94,55
"15969",2003-09-20,151,232,0,81
"15970",2003-09-21,141,271,0,130
"15971",2003-09-22,164,274,0,110
"15972",2003-09-23,166,268,25,102
"15973",2003-09-24,158,298,0,140
"15974",2003-09-25,163,308,0,145
"15975",2003-09-26,182,294,0,112
"15976",2003-09-27,176,258,0,82
"15977",2003-09-28,170,191,9,21
"15978",2003-09-29,164,177,43,13
"15979",2003-09-30,148,166,120,18
"15980",2003-10-01,135,158,302,23
"15981",2003-10-02,119,149,71,30
"15982",2003-10-03,115,139,101,24
"15983",2003-10-04,110,127,121,17
"15984",2003-10-05,107,182,31,75
"15985",2003-10-06,92,184,0,92
"15986",2003-10-07,122,196,0,74
"15987",2003-10-08,140,219,0,79
"15988",2003-10-09,162,231,0,69
"15989",2003-10-10,160,190,309,30
"15990",2003-10-11,114,163,590,49
"15991",2003-10-12,85,115,34,30
"15992",2003-10-13,84,156,0,72
"15993",2003-10-14,81,193,0,112
"15994",2003-10-15,105,205,0,100
"15995",2003-10-16,113,214,0,101
"15996",2003-10-17,75,230,0,155
"15997",2003-10-18,88,208,0,120
"15998",2003-10-19,72,164,1,92
"15999",2003-10-20,108,230,4,122
"16000",2003-10-21,101,250,0,149
"16001",2003-10-22,95,170,0,75
"16002",2003-10-23,37,180,0,143
"16003",2003-10-24,64,241,0,177
"16004",2003-10-25,94,245,0,151
"16005",2003-10-26,77,267,0,190
"16006",2003-10-27,101,270,0,169
"16007",2003-10-28,90,246,0,156
"16008",2003-10-29,117,239,0,122
"16009",2003-10-30,151,235,0,84
"16010",2003-10-31,113,259,0,146
"16011",2003-11-01,116,282,0,166
"16012",2003-11-02,132,228,0,96
"16013",2003-11-03,99,194,0,95
"16014",2003-11-04,70,196,0,126
"16015",2003-11-05,127,171,1,44
"16016",2003-11-06,66,130,0,64
"16017",2003-11-07,3,68,212,65
"16018",2003-11-08,1,37,12,36
"16019",2003-11-09,2,36,56,34
"16020",2003-11-10,5,100,0,95
"16021",2003-11-11,13,101,0,88
"16022",2003-11-12,37,133,0,96
"16023",2003-11-13,24,124,0,100
"16024",2003-11-14,75,150,0,75
"16025",2003-11-15,54,130,0,76
"16026",2003-11-16,26,117,0,91
"16027",2003-11-17,48,105,0,57
"16028",2003-11-18,62,91,7,29
"16029",2003-11-19,54,81,39,27
"16030",2003-11-20,32,159,0,127
"16031",2003-11-21,52,113,0,61
"16032",2003-11-22,-4,103,0,107
"16033",2003-11-23,32,100,7,68
"16034",2003-11-24,46,112,1,66
"16035",2003-11-25,13,95,0,82
"16036",2003-11-26,35,102,0,67
"16037",2003-11-27,22,38,0,16
"16038",2003-11-28,14,120,0,106
"16039",2003-11-29,-33,91,0,124
"16040",2003-11-30,18,105,0,87
"16041",2003-12-01,25,56,0,31
"16042",2003-12-02,26,79,0,53
"16043",2003-12-03,-25,43,0,68
"16044",2003-12-04,0,22,160,22
"16045",2003-12-05,4,35,0,31
"16046",2003-12-06,-8,60,0,68
"16047",2003-12-07,-54,38,0,92
"16048",2003-12-08,-26,47,0,73
"16049",2003-12-09,-23,49,0,72
"16050",2003-12-10,12,83,0,71
"16051",2003-12-11,-15,61,0,76
"16052",2003-12-12,-35,73,0,108
"16053",2003-12-13,-14,12,0,26
"16054",2003-12-14,-14,65,0,79
"16055",2003-12-15,-20,34,0,54
"16056",2003-12-16,-11,101,0,112
"16057",2003-12-17,-15,75,0,90
"16058",2003-12-18,32,94,0,62
"16059",2003-12-19,-10,66,0,76
"16060",2003-12-20,-20,99,0,119
"16061",2003-12-21,-42,109,0,151
"16062",2003-12-22,-27,152,0,179
"16063",2003-12-23,4,165,0,161
"16064",2003-12-24,58,141,0,83
"16065",2003-12-25,0,97,0,97
"16066",2003-12-26,-4,83,0,87
"16067",2003-12-27,-52,95,0,147
"16068",2003-12-28,9,101,0,92
"16069",2003-12-29,30,91,0,61
"16070",2003-12-30,27,96,0,69
"16071",2003-12-31,4,146,0,142
"16072",2004-01-01,62,114,0,52
"16073",2004-01-02,22,127,0,105
"16074",2004-01-03,-5,109,0,114
"16075",2004-01-04,-7,104,0,111
"16076",2004-01-05,-12,70,0,82
"16077",2004-01-06,-16,129,0,145
"16078",2004-01-07,5,58,0,53
"16079",2004-01-08,-2,33,0,35
"16080",2004-01-09,-35,80,0,115
"16081",2004-01-10,-16,41,0,57
"16082",2004-01-11,-33,71,0,104
"16083",2004-01-12,-5,83,0,88
"16084",2004-01-13,-59,78,0,137
"16085",2004-01-14,10,78,0,68
"16086",2004-01-15,0,49,1,49
"16087",2004-01-16,-16,23,20,39
"16088",2004-01-17,-55,7,0,62
"16089",2004-01-18,-32,40,0,72
"16090",2004-01-19,-23,60,0,83
"16091",2004-01-20,-12,55,0,67
"16092",2004-01-21,-81,25,0,106
"16093",2004-01-22,-71,51,0,122
"16094",2004-01-23,-34,20,0,54
"16095",2004-01-24,-48,25,0,73
"16096",2004-01-25,-76,41,0,117
"16097",2004-01-26,-57,81,0,138
"16098",2004-01-27,-65,70,0,135
"16099",2004-01-28,-66,118,0,184
"16100",2004-01-29,-40,81,0,121
"16101",2004-01-30,-35,67,0,102
"16102",2004-01-31,-28,48,0,76
"16103",2004-02-01,-10,70,0,80
"16104",2004-02-02,-1,66,0,67
"16105",2004-02-03,12,71,0,59
"16106",2004-02-04,-29,84,0,113
"16107",2004-02-05,3,53,0,50
"16108",2004-02-06,-42,82,0,124
"16109",2004-02-07,-6,109,0,115
"16110",2004-02-08,25,123,0,98
"16111",2004-02-09,-35,122,0,157
"16112",2004-02-10,-11,159,0,170
"16113",2004-02-11,9,128,0,119
"16114",2004-02-12,-1,173,0,174
"16115",2004-02-13,19,236,0,217
"16116",2004-02-14,19,177,0,158
"16117",2004-02-15,11,160,0,149
"16118",2004-02-16,33,158,0,125
"16119",2004-02-17,5,196,0,191
"16120",2004-02-18,57,193,0,136
"16121",2004-02-19,45,201,0,156
"16122",2004-02-20,84,137,143,53
"16123",2004-02-21,82,155,34,73
"16124",2004-02-22,42,113,0,71
"16125",2004-02-23,16,128,0,112
"16126",2004-02-24,55,173,0,118
"16127",2004-02-25,56,171,0,115
"16128",2004-02-26,71,175,0,104
"16129",2004-02-27,70,176,0,106
"16130",2004-02-28,75,178,0,103
"16131",2004-02-29,33,131,0,98
"16132",2004-03-01,24,109,0,85
"16133",2004-03-02,50,116,0,66
"16134",2004-03-03,8,107,0,99
"16135",2004-03-04,-8,180,0,188
"16136",2004-03-05,71,124,0,53
"16137",2004-03-06,-23,103,0,126
"16138",2004-03-07,-22,143,0,165
"16139",2004-03-08,36,229,0,193
"16140",2004-03-09,64,254,0,190
"16141",2004-03-10,120,231,0,111
"16142",2004-03-11,89,144,0,55
"16143",2004-03-12,45,165,0,120
"16144",2004-03-13,47,166,0,119
"16145",2004-03-14,39,199,0,160
"16146",2004-03-15,85,249,0,164
"16147",2004-03-16,127,252,0,125
"16148",2004-03-17,0,193,3,193
"16149",2004-03-18,27,81,8,54
"16150",2004-03-19,29,65,42,36
"16151",2004-03-20,38,68,0,30
"16152",2004-03-21,58,131,0,73
"16153",2004-03-22,60,162,0,102
"16154",2004-03-23,52,188,0,136
"16155",2004-03-24,91,142,0,51
"16156",2004-03-25,57,161,0,104
"16157",2004-03-26,58,164,0,106
"16158",2004-03-27,94,206,0,112
"16159",2004-03-28,97,244,0,147
"16160",2004-03-29,114,244,0,130
"16161",2004-03-30,107,210,0,103
"16162",2004-03-31,80,234,0,154
"16163",2004-04-01,95,211,25,116
"16164",2004-04-02,91,217,0,126
"16165",2004-04-03,60,140,0,80
"16166",2004-04-04,39,165,0,126
"16167",2004-04-05,71,239,0,168
"16168",2004-04-06,115,189,0,74
"16169",2004-04-07,81,190,0,109
"16170",2004-04-08,47,264,0,217
"16171",2004-04-09,69,247,0,178
"16172",2004-04-10,132,248,15,116
"16173",2004-04-11,139,269,0,130
"16174",2004-04-12,139,261,0,122
"16175",2004-04-13,155,219,0,64
"16176",2004-04-14,135,242,0,107
"16177",2004-04-15,165,284,0,119
"16178",2004-04-16,138,291,0,153
"16179",2004-04-17,113,294,0,181
"16180",2004-04-18,145,226,0,81
"16181",2004-04-19,127,364,0,237
"16182",2004-04-20,159,329,0,170
"16183",2004-04-21,146,327,0,181
"16184",2004-04-22,186,282,0,96
"16185",2004-04-23,147,202,0,55
"16186",2004-04-24,80,216,0,136
"16187",2004-04-25,120,202,5,82
"16188",2004-04-26,116,194,73,78
"16189",2004-04-27,69,208,0,139
"16190",2004-04-28,119,284,0,165
"16191",2004-04-29,190,279,0,89
"16192",2004-04-30,132,230,0,98
"16193",2004-05-01,127,212,0,85
"16194",2004-05-02,129,188,37,59
"16195",2004-05-03,120,202,187,82
"16196",2004-05-04,116,262,0,146
"16197",2004-05-05,130,308,0,178
"16198",2004-05-06,127,308,0,181
"16199",2004-05-07,166,283,0,117
"16200",2004-05-08,176,281,0,105
"16201",2004-05-09,162,287,0,125
"16202",2004-05-10,175,287,0,112
"16203",2004-05-11,159,248,220,89
"16204",2004-05-12,147,299,6,152
"16205",2004-05-13,181,275,0,94
"16206",2004-05-14,162,228,0,66
"16207",2004-05-15,147,272,0,125
"16208",2004-05-16,166,248,0,82
"16209",2004-05-17,176,323,0,147
"16210",2004-05-18,170,301,0,131
"16211",2004-05-19,184,363,0,179
"16212",2004-05-20,220,312,0,92
"16213",2004-05-21,149,304,0,155
"16214",2004-05-22,167,319,0,152
"16215",2004-05-23,166,326,0,160
"16216",2004-05-24,194,345,0,151
"16217",2004-05-25,245,298,0,53
"16218",2004-05-26,173,246,3,73
"16219",2004-05-27,153,200,335,47
"16220",2004-05-28,138,316,0,178
"16221",2004-05-29,189,306,0,117
"16222",2004-05-30,189,277,0,88
"16223",2004-05-31,123,299,0,176
"16224",2004-06-01,191,267,0,76
"16225",2004-06-02,145,301,0,156
"16226",2004-06-03,162,264,0,102
"16227",2004-06-04,162,253,9,91
"16228",2004-06-05,156,167,25,11
"16229",2004-06-06,148,262,0,114
"16230",2004-06-07,183,300,0,117
"16231",2004-06-08,170,288,47,118
"16232",2004-06-09,166,347,0,181
"16233",2004-06-10,200,337,0,137
"16234",2004-06-11,183,349,0,166
"16235",2004-06-12,212,364,0,152
"16236",2004-06-13,234,324,0,90
"16237",2004-06-14,176,268,155,92
"16238",2004-06-15,176,193,45,17
"16239",2004-06-16,184,297,7,113
"16240",2004-06-17,161,286,212,125
"16241",2004-06-18,210,315,0,105
"16242",2004-06-19,201,308,0,107
"16243",2004-06-20,210,365,0,155
"16244",2004-06-21,215,373,16,158
"16245",2004-06-22,213,371,0,158
"16246",2004-06-23,238,331,1,93
"16247",2004-06-24,202,356,451,154
"16248",2004-06-25,218,322,0,104
"16249",2004-06-26,225,348,0,123
"16250",2004-06-27,240,349,0,109
"16251",2004-06-28,260,362,0,102
"16252",2004-06-29,268,343,1,75
"16253",2004-06-30,219,308,97,89
"16254",2004-07-01,192,354,0,162
"16255",2004-07-02,241,348,0,107
"16256",2004-07-03,247,357,0,110
"16257",2004-07-04,232,358,0,126
"16258",2004-07-05,253,393,0,140
"16259",2004-07-06,230,335,0,105
"16260",2004-07-07,223,358,0,135
"16261",2004-07-08,223,317,0,94
"16262",2004-07-09,226,322,0,96
"16263",2004-07-10,209,288,685,79
"16264",2004-07-11,226,299,2,73
"16265",2004-07-12,194,278,737,84
"16266",2004-07-13,205,287,0,82
"16267",2004-07-14,216,288,0,72
"16268",2004-07-15,224,280,287,56
"16269",2004-07-16,223,250,299,27
"16270",2004-07-17,223,282,214,59
"16271",2004-07-18,228,297,11,69
"16272",2004-07-19,240,314,0,74
"16273",2004-07-20,236,280,136,44
"16274",2004-07-21,242,322,0,80
"16275",2004-07-22,246,338,0,92
"16276",2004-07-23,258,350,0,92
"16277",2004-07-24,247,359,24,112
"16278",2004-07-25,243,299,56,56
"16279",2004-07-26,245,318,0,73
"16280",2004-07-27,240,312,3,72
"16281",2004-07-28,254,314,4,60
"16282",2004-07-29,242,344,59,102
"16283",2004-07-30,225,271,96,46
"16284",2004-07-31,193,269,32,76
"16285",2004-08-01,225,276,40,51
"16286",2004-08-02,237,268,65,31
"16287",2004-08-03,241,338,3,97
"16288",2004-08-04,256,297,0,41
"16289",2004-08-05,225,293,0,68
"16290",2004-08-06,206,312,0,106
"16291",2004-08-07,234,326,0,92
"16292",2004-08-08,245,334,0,89
"16293",2004-08-09,266,347,57,81
"16294",2004-08-10,247,308,97,61
"16295",2004-08-11,249,286,327,37
"16296",2004-08-12,240,324,0,84
"16297",2004-08-13,206,287,0,81
"16298",2004-08-14,182,247,2,65
"16299",2004-08-15,181,232,73,51
"16300",2004-08-16,179,198,444,19
"16301",2004-08-17,173,264,0,91
"16302",2004-08-18,179,287,0,108
"16303",2004-08-19,196,286,0,90
"16304",2004-08-20,214,247,28,33
"16305",2004-08-21,185,231,15,46
"16306",2004-08-22,193,269,0,76
"16307",2004-08-23,207,280,0,73
"16308",2004-08-24,198,285,0,87
"16309",2004-08-25,232,278,1,46
"16310",2004-08-26,224,279,44,55
"16311",2004-08-27,214,257,21,43
"16312",2004-08-28,223,309,0,86
"16313",2004-08-29,227,293,0,66
"16314",2004-08-30,185,320,0,135
"16315",2004-08-31,200,329,0,129
"16316",2004-09-01,208,337,0,129
"16317",2004-09-02,197,319,1,122
"16318",2004-09-03,185,267,140,82
"16319",2004-09-04,201,256,15,55
"16320",2004-09-05,213,247,36,34
"16321",2004-09-06,195,303,0,108
"16322",2004-09-07,190,266,0,76
"16323",2004-09-08,167,303,0,136
"16324",2004-09-09,154,309,0,155
"16325",2004-09-10,147,291,0,144
"16326",2004-09-11,146,282,0,136
"16327",2004-09-12,169,274,0,105
"16328",2004-09-13,145,275,0,130
"16329",2004-09-14,179,229,4,50
"16330",2004-09-15,138,267,0,129
"16331",2004-09-16,175,313,0,138
"16332",2004-09-17,190,287,0,97
"16333",2004-09-18,178,245,89,67
"16334",2004-09-19,146,213,364,67
"16335",2004-09-20,145,251,56,106
"16336",2004-09-21,115,251,0,136
"16337",2004-09-22,126,268,0,142
"16338",2004-09-23,125,275,0,150
"16339",2004-09-24,140,238,0,98
"16340",2004-09-25,159,217,6,58
"16341",2004-09-26,141,261,0,120
"16342",2004-09-27,160,297,0,137
"16343",2004-09-28,165,288,0,123
"16344",2004-09-29,174,236,0,62
"16345",2004-09-30,151,214,291,63
"16346",2004-10-01,140,198,4,58
"16347",2004-10-02,92,211,0,119
"16348",2004-10-03,66,235,0,169
"16349",2004-10-04,79,237,0,158
"16350",2004-10-05,106,236,0,130
"16351",2004-10-06,102,246,0,144
"16352",2004-10-07,115,247,0,132
"16353",2004-10-08,136,246,0,110
"16354",2004-10-09,112,253,0,141
"16355",2004-10-10,116,213,0,97
"16356",2004-10-11,166,265,0,99
"16357",2004-10-12,95,247,0,152
"16358",2004-10-13,90,238,0,148
"16359",2004-10-14,79,170,0,91
"16360",2004-10-15,75,252,0,177
"16361",2004-10-16,118,176,0,58
"16362",2004-10-17,130,182,11,52
"16363",2004-10-18,95,225,0,130
"16364",2004-10-19,108,232,0,124
"16365",2004-10-20,105,239,0,134
"16366",2004-10-21,129,197,0,68
"16367",2004-10-22,75,191,0,116
"16368",2004-10-23,117,179,2,62
"16369",2004-10-24,111,192,11,81
"16370",2004-10-25,82,207,0,125
"16371",2004-10-26,77,156,0,79
"16372",2004-10-27,29,163,0,134
"16373",2004-10-28,97,171,0,74
"16374",2004-10-29,83,194,0,111
"16375",2004-10-30,126,177,0,51
"16376",2004-10-31,142,217,11,75
"16377",2004-11-01,111,198,0,87
"16378",2004-11-02,96,225,0,129
"16379",2004-11-03,70,227,0,157
"16380",2004-11-04,91,230,0,139
"16381",2004-11-05,96,183,0,87
"16382",2004-11-06,53,199,0,146
"16383",2004-11-07,70,229,0,159
"16384",2004-11-08,97,167,0,70
"16385",2004-11-09,106,137,208,31
"16386",2004-11-10,125,149,0,24
"16387",2004-11-11,79,130,2,51
"16388",2004-11-12,29,89,7,60
"16389",2004-11-13,30,103,22,73
"16390",2004-11-14,27,147,0,120
"16391",2004-11-15,62,156,0,94
"16392",2004-11-16,79,164,0,85
"16393",2004-11-17,71,175,0,104
"16394",2004-11-18,35,187,0,152
"16395",2004-11-19,45,165,0,120
"16396",2004-11-20,39,137,0,98
"16397",2004-11-21,9,135,0,126
"16398",2004-11-22,16,154,0,138
"16399",2004-11-23,57,168,0,111
"16400",2004-11-24,44,112,31,68
"16401",2004-11-25,2,48,131,46
"16402",2004-11-26,-9,82,0,91
"16403",2004-11-27,25,145,0,120
"16404",2004-11-28,2,159,0,157
"16405",2004-11-29,27,172,0,145
"16406",2004-11-30,2,75,0,73
"16407",2004-12-01,26,63,0,37
"16408",2004-12-02,37,57,3,20
"16409",2004-12-03,41,129,26,88
"16410",2004-12-04,76,145,0,69
"16411",2004-12-05,-13,125,0,138
"16412",2004-12-06,36,127,0,91
"16413",2004-12-07,-10,148,0,158
"16414",2004-12-08,-2,171,0,173
"16415",2004-12-09,14,139,0,125
"16416",2004-12-10,5,139,0,134
"16417",2004-12-11,50,136,0,86
"16418",2004-12-12,11,117,0,106
"16419",2004-12-13,23,67,0,44
"16420",2004-12-14,25,60,0,35
"16421",2004-12-15,28,54,0,26
"16422",2004-12-16,20,46,0,26
"16423",2004-12-17,4,82,1,78
"16424",2004-12-18,8,28,0,20
"16425",2004-12-19,5,65,0,60
"16426",2004-12-20,-27,22,0,49
"16427",2004-12-21,-38,6,89,44
"16428",2004-12-22,-34,-16,27,18
"16429",2004-12-23,-53,-25,0,28
"16430",2004-12-24,-53,-12,0,41
"16431",2004-12-25,-68,5,0,73
"16432",2004-12-26,-26,3,0,29
"16433",2004-12-27,-41,-5,0,36
"16434",2004-12-28,-76,-13,0,63
"16435",2004-12-29,-80,-32,0,48
"16436",2004-12-30,-82,-14,1,68
"16437",2004-12-31,-70,-12,0,58
"16438",2005-01-01,-64,16,0,80
"16439",2005-01-02,-78,58,0,136
"16440",2005-01-03,-20,77,0,97
"16441",2005-01-04,-40,19,0,59
"16442",2005-01-05,-31,12,0,43
"16443",2005-01-06,-56,23,0,79
"16444",2005-01-07,-23,29,0,52
"16445",2005-01-08,-54,28,0,82
"16446",2005-01-09,-64,21,0,85
"16447",2005-01-10,-60,74,0,134
"16448",2005-01-11,-45,37,0,82
"16449",2005-01-12,-50,27,0,77
"16450",2005-01-13,-40,45,0,85
"16451",2005-01-14,-66,50,0,116
"16452",2005-01-15,-74,53,0,127
"16453",2005-01-16,-69,73,0,142
"16454",2005-01-17,-45,106,0,151
"16455",2005-01-18,-43,67,0,110
"16456",2005-01-19,-44,75,0,119
"16457",2005-01-20,-44,59,0,103
"16458",2005-01-21,-21,47,0,68
"16459",2005-01-22,-22,63,0,85
"16460",2005-01-23,-33,33,0,66
"16461",2005-01-24,-34,28,0,62
"16462",2005-01-25,-3,44,0,47
"16463",2005-01-26,-60,27,0,87
"16464",2005-01-27,-32,79,0,111
"16465",2005-01-28,-32,62,0,94
"16466",2005-01-29,-15,40,0,55
"16467",2005-01-30,-35,39,0,74
"16468",2005-01-31,-21,79,0,100
"16469",2005-02-01,-48,56,0,104
"16470",2005-02-02,-43,59,0,102
"16471",2005-02-03,-54,88,0,142
"16472",2005-02-04,-32,38,0,70
"16473",2005-02-05,-20,8,0,28
"16474",2005-02-06,-45,-17,22,28
"16475",2005-02-07,-45,-12,0,33
"16476",2005-02-08,-47,-20,1,27
"16477",2005-02-09,-27,1,0,28
"16478",2005-02-10,-66,24,0,90
"16479",2005-02-11,-32,31,0,63
"16480",2005-02-12,-26,50,0,76
"16481",2005-02-13,-36,5,7,41
"16482",2005-02-14,-7,9,16,16
"16483",2005-02-15,3,34,26,31
"16484",2005-02-16,-18,21,0,39
"16485",2005-02-17,-23,3,10,26
"16486",2005-02-18,-37,10,1,47
"16487",2005-02-19,-46,21,0,67
"16488",2005-02-20,-56,58,0,114
"16489",2005-02-21,-55,128,0,183
"16490",2005-02-22,-10,186,0,196
"16491",2005-02-23,4,108,0,104
"16492",2005-02-24,-18,33,0,51
"16493",2005-02-25,-8,32,0,40
"16494",2005-02-26,-50,73,0,123
"16495",2005-02-27,13,113,0,100
"16496",2005-02-28,-2,142,0,144
"16497",2005-03-01,21,127,0,106
"16498",2005-03-02,33,78,0,45
"16499",2005-03-03,-25,124,0,149
"16500",2005-03-04,-1,77,0,78
"16501",2005-03-05,-22,155,0,177
"16502",2005-03-06,7,203,0,196
"16503",2005-03-07,50,229,0,179
"16504",2005-03-08,37,139,0,102
"16505",2005-03-09,22,167,0,145
"16506",2005-03-10,41,122,0,81
"16507",2005-03-11,-11,41,0,52
"16508",2005-03-12,-18,78,0,96
"16509",2005-03-13,-24,130,0,154
"16510",2005-03-14,20,185,0,165
"16511",2005-03-15,72,165,0,93
"16512",2005-03-16,89,135,0,46
"16513",2005-03-17,88,153,0,65
"16514",2005-03-18,13,121,0,108
"16515",2005-03-19,69,115,0,46
"16516",2005-03-20,17,170,0,153
"16517",2005-03-21,77,137,85,60
"16518",2005-03-22,34,126,0,92
"16519",2005-03-23,47,207,0,160
"16520",2005-03-24,15,164,0,149
"16521",2005-03-25,-5,171,0,176
"16522",2005-03-26,107,167,0,60
"16523",2005-03-27,50,187,0,137
"16524",2005-03-28,73,199,0,126
"16525",2005-03-29,77,135,11,58
"16526",2005-03-30,32,192,0,160
"16527",2005-03-31,48,211,0,163
"16528",2005-04-01,89,166,0,77
"16529",2005-04-02,81,189,0,108
"16530",2005-04-03,59,195,0,136
"16531",2005-04-04,74,265,0,191
"16532",2005-04-05,147,276,0,129
"16533",2005-04-06,130,323,0,193
"16534",2005-04-07,177,263,0,86
"16535",2005-04-08,73,177,65,104
"16536",2005-04-09,55,150,68,95
"16537",2005-04-10,63,175,0,112
"16538",2005-04-11,107,165,0,58
"16539",2005-04-12,110,215,0,105
"16540",2005-04-13,60,234,0,174
"16541",2005-04-14,86,214,0,128
"16542",2005-04-15,88,198,0,110
"16543",2005-04-16,98,260,0,162
"16544",2005-04-17,123,296,0,173
"16545",2005-04-18,159,298,0,139
"16546",2005-04-19,180,255,0,75
"16547",2005-04-20,102,275,0,173
"16548",2005-04-21,79,264,0,185
"16549",2005-04-22,110,233,0,123
"16550",2005-04-23,116,246,0,130
"16551",2005-04-24,146,267,0,121
"16552",2005-04-25,139,313,0,174
"16553",2005-04-26,162,287,0,125
"16554",2005-04-27,165,368,0,203
"16555",2005-04-28,202,372,0,170
"16556",2005-04-29,176,275,0,99
"16557",2005-04-30,204,299,0,95
"16558",2005-05-01,197,250,0,53
"16559",2005-05-02,112,258,0,146
"16560",2005-05-03,164,263,0,99
"16561",2005-05-04,181,212,5,31
"16562",2005-05-05,142,211,76,69
"16563",2005-05-06,87,239,0,152
"16564",2005-05-07,155,304,0,149
"16565",2005-05-08,149,269,0,120
"16566",2005-05-09,112,234,0,122
"16567",2005-05-10,147,281,0,134
"16568",2005-05-11,141,270,0,129
"16569",2005-05-12,151,292,0,141
"16570",2005-05-13,193,262,3,69
"16571",2005-05-14,152,233,0,81
"16572",2005-05-15,165,201,32,36
"16573",2005-05-16,167,179,227,12
"16574",2005-05-17,162,182,222,20
"16575",2005-05-18,119,276,0,157
"16576",2005-05-19,161,266,0,105
"16577",2005-05-20,141,250,0,109
"16578",2005-05-21,143,302,0,159
"16579",2005-05-22,165,295,0,130
"16580",2005-05-23,178,295,0,117
"16581",2005-05-24,165,303,0,138
"16582",2005-05-25,189,290,0,101
"16583",2005-05-26,169,294,0,125
"16584",2005-05-27,185,295,0,110
"16585",2005-05-28,187,284,0,97
"16586",2005-05-29,191,298,0,107
"16587",2005-05-30,209,302,0,93
"16588",2005-05-31,205,303,0,98
"16589",2005-06-01,243,356,0,113
"16590",2005-06-02,212,377,0,165
"16591",2005-06-03,201,372,0,171
"16592",2005-06-04,233,332,0,99
"16593",2005-06-05,234,303,0,69
"16594",2005-06-06,199,283,9,84
"16595",2005-06-07,186,306,0,120
"16596",2005-06-08,193,308,0,115
"16597",2005-06-09,198,273,161,75
"16598",2005-06-10,184,322,0,138
"16599",2005-06-11,200,370,0,170
"16600",2005-06-12,203,374,0,171
"16601",2005-06-13,233,379,0,146
"16602",2005-06-14,228,356,4,128
"16603",2005-06-15,218,376,0,158
"16604",2005-06-16,228,376,0,148
"16605",2005-06-17,231,373,0,142
"16606",2005-06-18,259,347,0,88
"16607",2005-06-19,226,383,0,157
"16608",2005-06-20,260,381,0,121
"16609",2005-06-21,218,337,440,119
"16610",2005-06-22,216,402,0,186
"16611",2005-06-23,259,406,0,147
"16612",2005-06-24,247,369,0,122
"16613",2005-06-25,233,337,13,104
"16614",2005-06-26,205,277,588,72
"16615",2005-06-27,209,273,0,64
"16616",2005-06-28,237,315,110,78
"16617",2005-06-29,219,347,0,128
"16618",2005-06-30,262,351,4,89
"16619",2005-07-01,259,339,3,80
"16620",2005-07-02,260,338,30,78
"16621",2005-07-03,219,262,110,43
"16622",2005-07-04,241,261,4,20
"16623",2005-07-05,232,275,0,43
"16624",2005-07-06,205,272,0,67
"16625",2005-07-07,212,290,0,78
"16626",2005-07-08,231,299,1,68
"16627",2005-07-09,229,339,0,110
"16628",2005-07-10,243,322,6,79
"16629",2005-07-11,229,321,0,92
"16630",2005-07-12,244,344,0,100
"16631",2005-07-13,247,333,0,86
"16632",2005-07-14,250,338,0,88
"16633",2005-07-15,245,337,15,92
"16634",2005-07-16,242,305,20,63
"16635",2005-07-17,233,275,31,42
"16636",2005-07-18,254,295,32,41
"16637",2005-07-19,259,329,0,70
"16638",2005-07-20,241,344,0,103
"16639",2005-07-21,245,318,0,73
"16640",2005-07-22,244,291,1182,47
"16641",2005-07-23,235,254,266,19
"16642",2005-07-24,239,291,0,52
"16643",2005-07-25,228,303,0,75
"16644",2005-07-26,221,303,0,82
"16645",2005-07-27,234,303,0,69
"16646",2005-07-28,249,335,0,86
"16647",2005-07-29,228,323,440,95
"16648",2005-07-30,237,306,0,69
"16649",2005-07-31,251,326,4,75
"16650",2005-08-01,248,352,0,104
"16651",2005-08-02,247,296,23,49
"16652",2005-08-03,226,303,0,77
"16653",2005-08-04,220,297,0,77
"16654",2005-08-05,219,300,0,81
"16655",2005-08-06,237,281,88,44
"16656",2005-08-07,238,310,0,72
"16657",2005-08-08,245,318,0,73
"16658",2005-08-09,254,326,5,72
"16659",2005-08-10,257,346,0,89
"16660",2005-08-11,275,356,0,81
"16661",2005-08-12,285,363,0,78
"16662",2005-08-13,274,360,0,86
"16663",2005-08-14,272,331,0,59
"16664",2005-08-15,272,329,1,57
"16665",2005-08-16,267,341,6,74
"16666",2005-08-17,189,274,118,85
"16667",2005-08-18,185,257,0,72
"16668",2005-08-19,198,270,8,72
"16669",2005-08-20,187,219,3,32
"16670",2005-08-21,194,243,0,49
"16671",2005-08-22,187,223,101,36
"16672",2005-08-23,182,207,221,25
"16673",2005-08-24,173,274,0,101
"16674",2005-08-25,183,286,0,103
"16675",2005-08-26,185,301,0,116
"16676",2005-08-27,187,303,0,116
"16677",2005-08-28,214,273,25,59
"16678",2005-08-29,211,227,581,16
"16679",2005-08-30,186,285,0,99
"16680",2005-08-31,198,300,0,102
"16681",2005-09-01,190,322,0,132
"16682",2005-09-02,223,249,94,26
"16683",2005-09-03,191,262,0,71
"16684",2005-09-04,152,266,0,114
"16685",2005-09-05,183,269,2,86
"16686",2005-09-06,181,279,0,98
"16687",2005-09-07,168,306,0,138
"16688",2005-09-08,187,306,0,119
"16689",2005-09-09,196,316,0,120
"16690",2005-09-10,201,323,0,122
"16691",2005-09-11,180,305,0,125
"16692",2005-09-12,171,308,0,137
"16693",2005-09-13,216,300,0,84
"16694",2005-09-14,201,254,0,53
"16695",2005-09-15,195,232,0,37
"16696",2005-09-16,205,251,5,46
"16697",2005-09-17,222,309,0,87
"16698",2005-09-18,165,259,0,94
"16699",2005-09-19,208,260,5,52
"16700",2005-09-20,158,208,122,50
"16701",2005-09-21,153,206,186,53
"16702",2005-09-22,128,238,0,110
"16703",2005-09-23,143,250,0,107
"16704",2005-09-24,131,261,0,130
"16705",2005-09-25,169,214,129,45
"16706",2005-09-26,144,170,48,26
"16707",2005-09-27,155,172,194,17
"16708",2005-09-28,169,184,233,15
"16709",2005-09-29,177,194,204,17
"16710",2005-09-30,184,236,111,52
"16711",2005-10-01,179,208,47,29
"16712",2005-10-02,119,191,86,72
"16713",2005-10-03,111,157,110,46
"16714",2005-10-04,105,199,0,94
"16715",2005-10-05,139,238,0,99
"16716",2005-10-06,160,184,54,24
"16717",2005-10-07,163,240,1,77
"16718",2005-10-08,104,242,0,138
"16719",2005-10-09,100,245,0,145
"16720",2005-10-10,96,238,0,142
"16721",2005-10-11,107,233,0,126
"16722",2005-10-12,148,194,0,46
"16723",2005-10-13,147,227,0,80
"16724",2005-10-14,110,177,0,67
"16725",2005-10-15,118,236,0,118
"16726",2005-10-16,94,276,0,182
"16727",2005-10-17,111,216,0,105
"16728",2005-10-18,136,177,0,41
"16729",2005-10-19,141,174,0,33
"16730",2005-10-20,143,164,45,21
"16731",2005-10-21,120,153,9,33
"16732",2005-10-22,76,141,0,65
"16733",2005-10-23,56,220,0,164
"16734",2005-10-24,102,241,0,139
"16735",2005-10-25,100,223,0,123
"16736",2005-10-26,98,230,0,132
"16737",2005-10-27,129,190,1,61
"16738",2005-10-28,114,157,0,43
"16739",2005-10-29,96,189,0,93
"16740",2005-10-30,79,193,0,114
"16741",2005-10-31,43,208,0,165
"16742",2005-11-01,73,214,0,141
"16743",2005-11-02,102,234,0,132
"16744",2005-11-03,100,237,0,137
"16745",2005-11-04,122,227,0,105
"16746",2005-11-05,160,204,32,44
"16747",2005-11-06,105,216,0,111
"16748",2005-11-07,82,249,0,167
"16749",2005-11-08,73,199,0,126
"16750",2005-11-09,82,235,0,153
"16751",2005-11-10,65,229,0,164
"16752",2005-11-11,84,185,0,101
"16753",2005-11-12,80,148,0,68
"16754",2005-11-13,97,132,17,35
"16755",2005-11-14,64,114,0,50
"16756",2005-11-15,34,123,0,89
"16757",2005-11-16,39,131,0,92
"16758",2005-11-17,22,132,0,110
"16759",2005-11-18,51,137,0,86
"16760",2005-11-19,47,99,0,52
"16761",2005-11-20,13,122,0,109
"16762",2005-11-21,25,133,0,108
"16763",2005-11-22,20,141,0,121
"16764",2005-11-23,87,148,0,61
"16765",2005-11-24,58,159,0,101
"16766",2005-11-25,60,179,0,119
"16767",2005-11-26,63,193,0,130
"16768",2005-11-27,36,211,0,175
"16769",2005-11-28,82,152,0,70
"16770",2005-11-29,28,147,0,119
"16771",2005-11-30,14,170,0,156
"16772",2005-12-01,87,132,0,45
"16773",2005-12-02,1,103,0,102
"16774",2005-12-03,35,103,0,68
"16775",2005-12-04,-17,35,0,52
"16776",2005-12-05,-42,22,0,64
"16777",2005-12-06,-73,51,0,124
"16778",2005-12-07,-68,68,0,136
"16779",2005-12-08,-48,56,0,104
"16780",2005-12-09,-34,50,0,84
"16781",2005-12-10,-4,35,0,39
"16782",2005-12-11,-53,41,0,94
"16783",2005-12-12,-59,46,0,105
"16784",2005-12-13,-73,52,0,125
"16785",2005-12-14,-12,41,0,53
"16786",2005-12-15,-22,66,0,88
"16787",2005-12-16,-8,88,0,96
"16788",2005-12-17,-7,50,0,57
"16789",2005-12-18,-60,95,0,155
"16790",2005-12-19,-18,79,0,97
"16791",2005-12-20,-38,66,0,104
"16792",2005-12-21,-35,39,0,74
"16793",2005-12-22,-13,119,0,132
"16794",2005-12-23,14,136,0,122
"16795",2005-12-24,-5,121,0,126
"16796",2005-12-25,22,122,0,100
"16797",2005-12-26,-35,81,0,116
"16798",2005-12-27,2,45,0,43
"16799",2005-12-28,2,45,0,43
"16800",2005-12-29,-4,20,0,24
"16801",2005-12-30,-6,17,11,23
"16802",2005-12-31,-15,9,12,24
"16803",2006-01-01,-14,90,0,104
"16804",2006-01-02,-16,77,0,93
"16805",2006-01-03,-5,18,0,23
"16806",2006-01-04,-25,1,0,26
"16807",2006-01-05,-54,5,0,59
"16808",2006-01-06,-44,15,0,59
"16809",2006-01-07,-35,31,0,66
"16810",2006-01-08,-44,71,0,115
"16811",2006-01-09,1,114,0,113
"16812",2006-01-10,-35,70,0,105
"16813",2006-01-11,-19,48,0,67
"16814",2006-01-12,-11,21,0,32
"16815",2006-01-13,-36,69,0,105
"16816",2006-01-14,-23,58,0,81
"16817",2006-01-15,-27,109,0,136
"16818",2006-01-16,22,70,0,48
"16819",2006-01-17,-11,22,2,33
"16820",2006-01-18,-30,-11,84,19
"16821",2006-01-19,-41,-23,152,18
"16822",2006-01-20,-28,17,5,45
"16823",2006-01-21,-74,35,0,109
"16824",2006-01-22,-65,45,0,110
"16825",2006-01-23,-46,52,0,98
"16826",2006-01-24,-36,46,0,82
"16827",2006-01-25,-36,45,0,81
"16828",2006-01-26,-41,100,0,141
"16829",2006-01-27,-39,85,0,124
"16830",2006-01-28,-6,23,0,29
"16831",2006-01-29,4,29,0,25
"16832",2006-01-30,-9,38,15,47
"16833",2006-01-31,-15,38,0,53
"16834",2006-02-01,-24,0,0,24
"16835",2006-02-02,-11,39,0,50
"16836",2006-02-03,-60,13,0,73
"16837",2006-02-04,-36,19,0,55
"16838",2006-02-05,-22,-3,49,19
"16839",2006-02-06,-24,96,0,120
"16840",2006-02-07,-26,94,0,120
"16841",2006-02-08,-36,16,0,52
"16842",2006-02-09,-43,83,0,126
"16843",2006-02-10,12,166,0,154
"16844",2006-02-11,26,123,0,97
"16845",2006-02-12,23,102,0,79
"16846",2006-02-13,42,184,0,142
"16847",2006-02-14,116,190,0,74
"16848",2006-02-15,68,128,33,60
"16849",2006-02-16,33,95,0,62
"16850",2006-02-17,-2,80,0,82
"16851",2006-02-18,-19,113,0,132
"16852",2006-02-19,-3,155,0,158
"16853",2006-02-20,6,160,0,154
"16854",2006-02-21,58,128,0,70
"16855",2006-02-22,27,103,0,76
"16856",2006-02-23,35,126,0,91
"16857",2006-02-24,29,126,0,97
"16858",2006-02-25,35,84,0,49
"16859",2006-02-26,-18,41,0,59
"16860",2006-02-27,-38,-15,93,23
"16861",2006-02-28,-64,53,3,117
"16862",2006-03-01,8,119,0,111
"16863",2006-03-02,-11,131,0,142
"16864",2006-03-03,34,165,0,131
"16865",2006-03-04,43,203,0,160
"16866",2006-03-05,68,221,0,153
"16867",2006-03-06,41,175,0,134
"16868",2006-03-07,25,206,0,181
"16869",2006-03-08,67,149,54,82
"16870",2006-03-09,65,138,0,73
"16871",2006-03-10,70,201,0,131
"16872",2006-03-11,55,152,0,97
"16873",2006-03-12,-4,55,0,59
"16874",2006-03-13,9,110,0,101
"16875",2006-03-14,54,156,0,102
"16876",2006-03-15,77,149,0,72
"16877",2006-03-16,50,219,0,169
"16878",2006-03-17,51,226,0,175
"16879",2006-03-18,119,183,0,64
"16880",2006-03-19,51,177,0,126
"16881",2006-03-20,56,202,0,146
"16882",2006-03-21,90,199,0,109
"16883",2006-03-22,124,188,0,64
"16884",2006-03-23,88,178,0,90
"16885",2006-03-24,65,222,0,157
"16886",2006-03-25,85,237,0,152
"16887",2006-03-26,69,167,0,98
"16888",2006-03-27,68,248,0,180
"16889",2006-03-28,32,167,0,135
"16890",2006-03-29,26,264,0,238
"16891",2006-03-30,88,197,0,109
"16892",2006-03-31,95,243,0,148
"16893",2006-04-01,147,252,0,105
"16894",2006-04-02,102,247,0,145
"16895",2006-04-03,150,203,0,53
"16896",2006-04-04,133,185,104,52
"16897",2006-04-05,73,186,0,113
"16898",2006-04-06,114,253,0,139
"16899",2006-04-07,120,274,0,154
"16900",2006-04-08,135,263,0,128
"16901",2006-04-09,102,186,0,84
"16902",2006-04-10,102,255,0,153
"16903",2006-04-11,142,267,4,125
"16904",2006-04-12,39,160,204,121
"16905",2006-04-13,24,132,0,108
"16906",2006-04-14,68,158,0,90
"16907",2006-04-15,53,239,0,186
"16908",2006-04-16,99,243,0,144
"16909",2006-04-17,114,266,0,152
"16910",2006-04-18,130,283,0,153
"16911",2006-04-19,130,241,0,111
"16912",2006-04-20,70,201,0,131
"16913",2006-04-21,106,164,37,58
"16914",2006-04-22,112,212,0,100
"16915",2006-04-23,125,246,0,121
"16916",2006-04-24,100,252,0,152
"16917",2006-04-25,149,215,21,66
"16918",2006-04-26,123,295,0,172
"16919",2006-04-27,159,266,0,107
"16920",2006-04-28,127,298,0,171
"16921",2006-04-29,132,355,0,223
"16922",2006-04-30,180,387,0,207
"16923",2006-05-01,207,296,0,89
"16924",2006-05-02,171,237,0,66
"16925",2006-05-03,150,264,0,114
"16926",2006-05-04,203,301,0,98
"16927",2006-05-05,178,229,179,51
"16928",2006-05-06,129,250,0,121
"16929",2006-05-07,152,261,0,109
"16930",2006-05-08,157,276,0,119
"16931",2006-05-09,174,248,10,74
"16932",2006-05-10,172,215,122,43
"16933",2006-05-11,111,190,87,79
"16934",2006-05-12,91,174,37,83
"16935",2006-05-13,122,254,0,132
"16936",2006-05-14,154,288,0,134
"16937",2006-05-15,148,318,0,170
"16938",2006-05-16,142,312,0,170
"16939",2006-05-17,172,287,0,115
"16940",2006-05-18,202,300,0,98
"16941",2006-05-19,172,328,0,156
"16942",2006-05-20,207,274,0,67
"16943",2006-05-21,150,216,95,66
"16944",2006-05-22,136,280,8,144
"16945",2006-05-23,145,324,0,179
"16946",2006-05-24,201,299,63,98
"16947",2006-05-25,176,230,54,54
"16948",2006-05-26,168,244,0,76
"16949",2006-05-27,194,294,0,100
"16950",2006-05-28,141,311,0,170
"16951",2006-05-29,145,349,0,204
"16952",2006-05-30,201,348,0,147
"16953",2006-05-31,186,319,0,133
"16954",2006-06-01,184,327,0,143
"16955",2006-06-02,218,318,0,100
"16956",2006-06-03,212,285,0,73
"16957",2006-06-04,175,319,0,144
"16958",2006-06-05,208,311,0,103
"16959",2006-06-06,176,321,0,145
"16960",2006-06-07,211,353,0,142
"16961",2006-06-08,234,339,0,105
"16962",2006-06-09,194,346,0,152
"16963",2006-06-10,216,324,0,108
"16964",2006-06-11,235,363,0,128
"16965",2006-06-12,249,355,0,106
"16966",2006-06-13,220,321,20,101
"16967",2006-06-14,198,324,59,126
"16968",2006-06-15,211,379,0,168
"16969",2006-06-16,224,398,0,174
"16970",2006-06-17,239,352,0,113
"16971",2006-06-18,236,368,0,132
"16972",2006-06-19,260,401,0,141
"16973",2006-06-20,259,358,0,99
"16974",2006-06-21,203,310,156,107
"16975",2006-06-22,217,223,402,6
"16976",2006-06-23,211,291,2,80
"16977",2006-06-24,210,316,0,106
"16978",2006-06-25,215,345,0,130
"16979",2006-06-26,198,331,122,133
"16980",2006-06-27,241,369,0,128
"16981",2006-06-28,247,333,59,86
"16982",2006-06-29,230,333,9,103
"16983",2006-06-30,258,311,0,53
"16984",2006-07-01,245,333,0,88
"16985",2006-07-02,234,305,217,71
"16986",2006-07-03,220,252,798,32
"16987",2006-07-04,240,287,3,47
"16988",2006-07-05,219,338,0,119
"16989",2006-07-06,252,295,0,43
"16990",2006-07-07,257,316,0,59
"16991",2006-07-08,231,314,0,83
"16992",2006-07-09,252,312,0,60
"16993",2006-07-10,243,328,0,85
"16994",2006-07-11,251,328,227,77
"16995",2006-07-12,259,343,0,84
"16996",2006-07-13,268,353,0,85
"16997",2006-07-14,285,342,1,57
"16998",2006-07-15,265,315,0,50
"16999",2006-07-16,270,309,6,39
"17000",2006-07-17,250,296,3,46
"17001",2006-07-18,241,341,0,100
"17002",2006-07-19,235,312,0,77
"17003",2006-07-20,251,303,0,52
"17004",2006-07-21,261,329,0,68
"17005",2006-07-22,239,301,7,62
"17006",2006-07-23,215,263,7,48
"17007",2006-07-24,208,303,0,95
"17008",2006-07-25,226,298,0,72
"17009",2006-07-26,220,279,0,59
"17010",2006-07-27,224,286,0,62
"17011",2006-07-28,240,291,15,51
"17012",2006-07-29,239,286,368,47
"17013",2006-07-30,249,332,0,83
"17014",2006-07-31,237,322,167,85
"17015",2006-08-01,229,316,7,87
"17016",2006-08-02,218,299,3,81
"17017",2006-08-03,217,291,0,74
"17018",2006-08-04,224,262,0,38
"17019",2006-08-05,229,312,219,83
"17020",2006-08-06,224,311,51,87
"17021",2006-08-07,241,322,252,81
"17022",2006-08-08,233,321,0,88
"17023",2006-08-09,247,327,0,80
"17024",2006-08-10,243,328,0,85
"17025",2006-08-11,252,333,0,81
"17026",2006-08-12,257,342,0,85
"17027",2006-08-13,265,332,0,67
"17028",2006-08-14,261,308,0,47
"17029",2006-08-15,234,288,2,54
"17030",2006-08-16,241,325,0,84
"17031",2006-08-17,224,323,0,99
"17032",2006-08-18,234,313,0,79
"17033",2006-08-19,213,317,0,104
"17034",2006-08-20,206,312,0,106
"17035",2006-08-21,210,269,1,59
"17036",2006-08-22,210,277,0,67
"17037",2006-08-23,198,321,0,123
"17038",2006-08-24,218,311,0,93
"17039",2006-08-25,231,307,583,76
"17040",2006-08-26,230,317,9,87
"17041",2006-08-27,236,319,0,83
"17042",2006-08-28,247,302,63,55
"17043",2006-08-29,218,266,427,48
"17044",2006-08-30,206,226,4,20
"17045",2006-08-31,194,230,0,36
"17046",2006-09-01,214,247,9,33
"17047",2006-09-02,214,288,0,74
"17048",2006-09-03,232,290,0,58
"17049",2006-09-04,132,268,230,136
"17050",2006-09-05,133,242,11,109
"17051",2006-09-06,135,295,0,160
"17052",2006-09-07,170,237,67,67
"17053",2006-09-08,164,271,0,107
"17054",2006-09-09,128,255,0,127
"17055",2006-09-10,128,271,0,143
"17056",2006-09-11,118,275,0,157
"17057",2006-09-12,149,266,0,117
"17058",2006-09-13,141,260,0,119
"17059",2006-09-14,194,249,0,55
"17060",2006-09-15,159,270,0,111
"17061",2006-09-16,172,301,0,129
"17062",2006-09-17,174,278,0,104
"17063",2006-09-18,166,300,0,134
"17064",2006-09-19,187,294,0,107
"17065",2006-09-20,166,294,0,128
"17066",2006-09-21,176,266,0,90
"17067",2006-09-22,170,272,0,102
"17068",2006-09-23,166,275,0,109
"17069",2006-09-24,174,260,0,86
"17070",2006-09-25,198,283,0,85
"17071",2006-09-26,200,239,9,39
"17072",2006-09-27,175,199,129,24
"17073",2006-09-28,175,231,42,56
"17074",2006-09-29,181,250,3,69
"17075",2006-09-30,186,229,0,43
"17076",2006-10-01,138,279,0,141
"17077",2006-10-02,142,284,0,142
"17078",2006-10-03,145,278,0,133
"17079",2006-10-04,156,279,0,123
"17080",2006-10-05,166,290,0,124
"17081",2006-10-06,156,290,0,134
"17082",2006-10-07,183,283,0,100
"17083",2006-10-08,159,274,0,115
"17084",2006-10-09,152,299,0,147
"17085",2006-10-10,136,315,0,179
"17086",2006-10-11,146,251,0,105
"17087",2006-10-12,156,258,0,102
"17088",2006-10-13,152,275,0,123
"17089",2006-10-14,159,302,0,143
"17090",2006-10-15,153,290,0,137
"17091",2006-10-16,173,262,0,89
"17092",2006-10-17,161,221,0,60
"17093",2006-10-18,141,188,0,47
"17094",2006-10-19,162,264,0,102
"17095",2006-10-20,165,199,0,34
"17096",2006-10-21,164,210,0,46
"17097",2006-10-22,160,259,0,99
"17098",2006-10-23,101,171,0,70
"17099",2006-10-24,128,166,0,38
"17100",2006-10-25,96,185,0,89
"17101",2006-10-26,104,188,0,84
"17102",2006-10-27,71,205,0,134
"17103",2006-10-28,123,256,0,133
"17104",2006-10-29,91,235,0,144
"17105",2006-10-30,127,241,0,114
"17106",2006-10-31,138,248,0,110
"17107",2006-11-01,135,255,0,120
"17108",2006-11-02,87,263,0,176
"17109",2006-11-03,94,263,0,169
"17110",2006-11-04,106,263,0,157
"17111",2006-11-05,102,218,0,116
"17112",2006-11-06,49,202,0,153
"17113",2006-11-07,46,227,0,181
"17114",2006-11-08,84,261,0,177
"17115",2006-11-09,125,241,0,116
"17116",2006-11-10,108,202,0,94
"17117",2006-11-11,50,189,0,139
"17118",2006-11-12,51,196,0,145
"17119",2006-11-13,95,168,0,73
"17120",2006-11-14,56,160,0,104
"17121",2006-11-15,11,176,4,165
"17122",2006-11-16,73,170,0,97
"17123",2006-11-17,60,162,0,102
"17124",2006-11-18,66,113,19,47
"17125",2006-11-19,70,157,8,87
"17126",2006-11-20,76,155,0,79
"17127",2006-11-21,69,168,0,99
"17128",2006-11-22,41,86,58,45
"17129",2006-11-23,11,41,180,30
"17130",2006-11-24,19,37,8,18
"17131",2006-11-25,25,52,168,27
"17132",2006-11-26,52,72,59,20
"17133",2006-11-27,42,68,83,26
"17134",2006-11-28,18,114,0,96
"17135",2006-11-29,30,107,0,77
"17136",2006-11-30,14,112,0,98
"17137",2006-12-01,-6,126,0,132
"17138",2006-12-02,-14,75,0,89
"17139",2006-12-03,-8,71,0,79
"17140",2006-12-04,-19,69,0,88
"17141",2006-12-05,-9,42,0,51
"17142",2006-12-06,-1,32,8,33
"17143",2006-12-07,4,36,15,32
"17144",2006-12-08,-3,21,9,24
"17145",2006-12-09,-18,57,0,75
"17146",2006-12-10,-10,98,0,108
"17147",2006-12-11,4,135,0,131
"17148",2006-12-12,-4,121,0,125
"17149",2006-12-13,58,100,0,42
"17150",2006-12-14,5,146,0,141
"17151",2006-12-15,17,120,0,103
"17152",2006-12-16,23,82,0,59
"17153",2006-12-17,-51,50,0,101
"17154",2006-12-18,-4,116,0,120
"17155",2006-12-19,-29,91,0,120
"17156",2006-12-20,-18,126,0,144
"17157",2006-12-21,-21,104,0,125
"17158",2006-12-22,-10,89,0,99
"17159",2006-12-23,-6,71,0,77
"17160",2006-12-24,5,76,0,71
"17161",2006-12-25,-13,75,0,88
"17162",2006-12-26,4,31,0,27
"17163",2006-12-27,6,33,0,27
"17164",2006-12-28,-4,33,0,37
"17165",2006-12-29,-47,34,0,81
"17166",2006-12-30,-6,25,23,31
"17167",2006-12-31,-8,10,0,18
"17168",2007-01-01,-5,18,0,23
"17169",2007-01-02,-17,15,0,32
"17170",2007-01-03,-17,37,0,54
"17171",2007-01-04,-36,56,0,92
"17172",2007-01-05,9,92,0,83
"17173",2007-01-06,-4,60,0,64
"17174",2007-01-07,-11,59,0,70
"17175",2007-01-08,-3,65,0,68
"17176",2007-01-09,-44,115,0,159
"17177",2007-01-10,-44,46,0,90
"17178",2007-01-11,-15,20,0,35
"17179",2007-01-12,-40,40,0,80
"17180",2007-01-13,-31,45,0,76
"17181",2007-01-14,-50,55,0,105
"17182",2007-01-15,-34,54,0,88
"17183",2007-01-16,-38,65,0,103
"17184",2007-01-17,-23,110,0,133
"17185",2007-01-18,-8,99,0,107
"17186",2007-01-19,-20,98,0,118
"17187",2007-01-20,-31,94,0,125
"17188",2007-01-21,-19,59,0,78
"17189",2007-01-22,-4,52,0,56
"17190",2007-01-23,6,92,0,86
"17191",2007-01-24,-12,80,0,92
"17192",2007-01-25,-2,128,0,130
"17193",2007-01-26,23,99,0,76
"17194",2007-01-27,44,89,0,45
"17195",2007-01-28,-16,112,0,128
"17196",2007-01-29,-16,169,0,185
"17197",2007-01-30,-11,126,0,137
"17198",2007-01-31,16,74,0,58
"17199",2007-02-01,-37,137,0,174
"17200",2007-02-02,-14,139,0,153
"17201",2007-02-03,-1,155,0,156
"17202",2007-02-04,-17,128,0,145
"17203",2007-02-05,13,197,0,184
"17204",2007-02-06,36,117,0,81
"17205",2007-02-07,25,109,30,84
"17206",2007-02-08,21,85,0,64
"17207",2007-02-09,-1,160,0,161
"17208",2007-02-10,45,129,0,84
"17209",2007-02-11,-2,140,0,142
"17210",2007-02-12,10,159,0,149
"17211",2007-02-13,93,169,0,76
"17212",2007-02-14,11,137,0,126
"17213",2007-02-15,1,65,0,64
"17214",2007-02-16,40,73,0,33
"17215",2007-02-17,44,85,7,41
"17216",2007-02-18,57,120,0,63
"17217",2007-02-19,18,147,0,129
"17218",2007-02-20,34,170,0,136
"17219",2007-02-21,63,161,0,98
"17220",2007-02-22,39,204,0,165
"17221",2007-02-23,44,138,0,94
"17222",2007-02-24,59,141,25,82
"17223",2007-02-25,51,153,0,102
"17224",2007-02-26,52,163,0,111
"17225",2007-02-27,41,137,0,96
"17226",2007-02-28,46,118,74,72
"17227",2007-03-01,46,93,44,47
"17228",2007-03-02,61,84,30,23
"17229",2007-03-03,44,74,416,30
"17230",2007-03-04,34,107,18,73
"17231",2007-03-05,16,58,0,42
"17232",2007-03-06,-32,72,0,104
"17233",2007-03-07,-22,95,0,117
"17234",2007-03-08,10,124,0,114
"17235",2007-03-09,14,152,0,138
"17236",2007-03-10,50,112,0,62
"17237",2007-03-11,1,102,0,101
"17238",2007-03-12,18,141,0,123
"17239",2007-03-13,26,108,0,82
"17240",2007-03-14,75,93,2,18
"17241",2007-03-15,57,84,74,27
"17242",2007-03-16,51,89,58,38
"17243",2007-03-17,22,108,1,86
"17244",2007-03-18,53,111,1,58
"17245",2007-03-19,59,140,0,81
"17246",2007-03-20,41,164,0,123
"17247",2007-03-21,52,194,0,142
"17248",2007-03-22,68,184,0,116
"17249",2007-03-23,129,208,0,79
"17250",2007-03-24,119,226,0,107
"17251",2007-03-25,98,271,0,173
"17252",2007-03-26,121,250,0,129
"17253",2007-03-27,116,232,0,116
"17254",2007-03-28,134,240,0,106
"17255",2007-03-29,129,310,0,181
"17256",2007-03-30,106,220,0,114
"17257",2007-03-31,94,204,0,110
"17258",2007-04-01,134,208,20,74
"17259",2007-04-02,87,184,0,97
"17260",2007-04-03,30,175,0,145
"17261",2007-04-04,53,196,0,143
"17262",2007-04-05,103,210,0,107
"17263",2007-04-06,99,225,0,126
"17264",2007-04-07,112,207,0,95
"17265",2007-04-08,82,206,0,124
"17266",2007-04-09,110,222,0,112
"17267",2007-04-10,113,195,0,82
"17268",2007-04-11,95,250,0,155
"17269",2007-04-12,134,282,0,148
"17270",2007-04-13,115,197,7,82
"17271",2007-04-14,125,236,1,111
"17272",2007-04-15,102,187,117,85
"17273",2007-04-16,54,196,0,142
"17274",2007-04-17,121,227,0,106
"17275",2007-04-18,83,248,0,165
"17276",2007-04-19,137,277,0,140
"17277",2007-04-20,211,271,0,60
"17278",2007-04-21,158,240,0,82
"17279",2007-04-22,161,205,0,44
"17280",2007-04-23,94,197,0,103
"17281",2007-04-24,135,243,0,108
"17282",2007-04-25,144,272,0,128
"17283",2007-04-26,126,271,0,145
"17284",2007-04-27,123,225,0,102
"17285",2007-04-28,130,256,0,126
"17286",2007-04-29,143,254,0,111
"17287",2007-04-30,144,284,13,140
"17288",2007-05-01,139,260,0,121
"17289",2007-05-02,111,286,0,175
"17290",2007-05-03,198,286,0,88
"17291",2007-05-04,155,336,0,181
"17292",2007-05-05,176,273,0,97
"17293",2007-05-06,129,298,0,169
"17294",2007-05-07,164,344,0,180
"17295",2007-05-08,177,335,0,158
"17296",2007-05-09,143,284,0,141
"17297",2007-05-10,132,217,0,85
"17298",2007-05-11,174,235,8,61
"17299",2007-05-12,181,292,0,111
"17300",2007-05-13,112,328,0,216
"17301",2007-05-14,181,321,0,140
"17302",2007-05-15,238,291,0,53
"17303",2007-05-16,214,325,0,111
"17304",2007-05-17,190,369,0,179
"17305",2007-05-18,177,270,0,93
"17306",2007-05-19,133,287,0,154
"17307",2007-05-20,192,339,0,147
"17308",2007-05-21,213,286,0,73
"17309",2007-05-22,201,245,0,44
"17310",2007-05-23,189,277,0,88
"17311",2007-05-24,232,318,0,86
"17312",2007-05-25,220,361,0,141
"17313",2007-05-26,231,381,0,150
"17314",2007-05-27,234,397,0,163
"17315",2007-05-28,239,360,0,121
"17316",2007-05-29,242,330,0,88
"17317",2007-05-30,206,292,77,86
"17318",2007-05-31,187,228,162,41
"17319",2007-06-01,176,240,0,64
"17320",2007-06-02,183,272,0,89
"17321",2007-06-03,185,303,0,118
"17322",2007-06-04,201,292,0,91
"17323",2007-06-05,207,327,0,120
"17324",2007-06-06,197,358,0,161
"17325",2007-06-07,211,363,0,152
"17326",2007-06-08,215,352,0,137
"17327",2007-06-09,241,369,0,128
"17328",2007-06-10,238,320,0,82
"17329",2007-06-11,196,316,0,120
"17330",2007-06-12,204,339,0,135
"17331",2007-06-13,230,324,0,94
"17332",2007-06-14,208,283,46,75
"17333",2007-06-15,205,322,0,117
"17334",2007-06-16,217,317,0,100
"17335",2007-06-17,212,319,0,107
"17336",2007-06-18,231,289,3,58
"17337",2007-06-19,185,238,135,53
"17338",2007-06-20,193,239,22,46
"17339",2007-06-21,208,229,16,21
"17340",2007-06-22,201,231,107,30
"17341",2007-06-23,194,353,0,159
"17342",2007-06-24,231,336,0,105
"17343",2007-06-25,239,373,0,134
"17344",2007-06-26,262,330,0,68
"17345",2007-06-27,231,299,60,68
"17346",2007-06-28,230,340,0,110
"17347",2007-06-29,239,359,170,120
"17348",2007-06-30,228,319,0,91
"17349",2007-07-01,220,323,0,103
"17350",2007-07-02,245,319,0,74
"17351",2007-07-03,238,321,4,83
"17352",2007-07-04,202,284,112,82
"17353",2007-07-05,201,232,80,31
"17354",2007-07-06,219,290,43,71
"17355",2007-07-07,209,317,0,108
"17356",2007-07-08,252,288,0,36
"17357",2007-07-09,209,341,0,132
"17358",2007-07-10,243,342,0,99
"17359",2007-07-11,263,370,0,107
"17360",2007-07-12,244,318,0,74
"17361",2007-07-13,221,287,385,66
"17362",2007-07-14,208,249,215,41
"17363",2007-07-15,202,295,13,93
"17364",2007-07-16,225,318,0,93
"17365",2007-07-17,261,340,0,79
"17366",2007-07-18,278,347,5,69
"17367",2007-07-19,240,304,192,64
"17368",2007-07-20,192,241,91,49
"17369",2007-07-21,189,280,0,91
"17370",2007-07-22,211,270,0,59
"17371",2007-07-23,222,280,0,58
"17372",2007-07-24,228,292,0,64
"17373",2007-07-25,214,291,0,77
"17374",2007-07-26,218,296,0,78
"17375",2007-07-27,241,304,0,63
"17376",2007-07-28,232,341,0,109
"17377",2007-07-29,254,343,187,89
"17378",2007-07-30,229,306,59,77
"17379",2007-07-31,227,349,143,122
"17380",2007-08-01,276,373,0,97
"17381",2007-08-02,225,327,1126,102
"17382",2007-08-03,211,303,4,92
"17383",2007-08-04,206,311,0,105
"17384",2007-08-05,235,319,0,84
"17385",2007-08-06,244,301,1,57
"17386",2007-08-07,250,321,3,71
"17387",2007-08-08,258,344,0,86
"17388",2007-08-09,221,333,201,112
"17389",2007-08-10,228,266,80,38
"17390",2007-08-11,222,313,0,91
"17391",2007-08-12,213,319,11,106
"17392",2007-08-13,229,343,0,114
"17393",2007-08-14,205,319,435,114
"17394",2007-08-15,202,310,0,108
"17395",2007-08-16,220,299,0,79
"17396",2007-08-17,228,277,0,49
"17397",2007-08-18,231,315,0,84
"17398",2007-08-19,227,313,0,86
"17399",2007-08-20,236,327,0,91
"17400",2007-08-21,253,326,0,73
"17401",2007-08-22,258,319,0,61
"17402",2007-08-23,251,299,0,48
"17403",2007-08-24,262,340,0,78
"17404",2007-08-25,269,307,31,38
"17405",2007-08-26,235,324,0,89
"17406",2007-08-27,209,263,0,54
"17407",2007-08-28,220,282,0,62
"17408",2007-08-29,220,257,0,37
"17409",2007-08-30,184,220,177,36
"17410",2007-08-31,182,204,216,22
"17411",2007-09-01,179,280,0,101
"17412",2007-09-02,174,304,0,130
"17413",2007-09-03,209,254,0,45
"17414",2007-09-04,202,256,0,54
"17415",2007-09-05,198,256,0,58
"17416",2007-09-06,168,286,0,118
"17417",2007-09-07,174,274,0,100
"17418",2007-09-08,201,285,0,84
"17419",2007-09-09,155,302,0,147
"17420",2007-09-10,177,305,0,128
"17421",2007-09-11,174,304,0,130
"17422",2007-09-12,206,283,2,77
"17423",2007-09-13,207,259,3,52
"17424",2007-09-14,174,305,0,131
"17425",2007-09-15,187,313,0,126
"17426",2007-09-16,192,321,0,129
"17427",2007-09-17,208,283,0,75
"17428",2007-09-18,185,292,0,107
"17429",2007-09-19,185,274,0,89
"17430",2007-09-20,173,284,0,111
"17431",2007-09-21,148,315,0,167
"17432",2007-09-22,153,302,0,149
"17433",2007-09-23,156,281,0,125
"17434",2007-09-24,165,277,0,112
"17435",2007-09-25,222,290,0,68
"17436",2007-09-26,200,311,0,111
"17437",2007-09-27,166,274,0,108
"17438",2007-09-28,134,191,7,57
"17439",2007-09-29,125,176,18,51
"17440",2007-09-30,123,146,16,23
"17441",2007-10-01,143,161,11,18
"17442",2007-10-02,141,241,0,100
"17443",2007-10-03,183,234,1,51
"17444",2007-10-04,185,215,0,30
"17445",2007-10-05,184,204,0,20
"17446",2007-10-06,176,221,0,45
"17447",2007-10-07,163,204,4,41
"17448",2007-10-08,145,189,0,44
"17449",2007-10-09,140,180,0,40
"17450",2007-10-10,136,171,0,35
"17451",2007-10-11,129,165,32,36
"17452",2007-10-12,130,159,49,29
"17453",2007-10-13,129,158,1,29
"17454",2007-10-14,101,193,0,92
"17455",2007-10-15,93,223,0,130
"17456",2007-10-16,82,240,0,158
"17457",2007-10-17,84,258,0,174
"17458",2007-10-18,110,239,0,129
"17459",2007-10-19,65,235,0,170
"17460",2007-10-20,94,213,0,119
"17461",2007-10-21,101,241,0,140
"17462",2007-10-22,98,233,0,135
"17463",2007-10-23,118,206,0,88
"17464",2007-10-24,121,222,1,101
"17465",2007-10-25,114,236,0,122
"17466",2007-10-26,112,225,0,113
"17467",2007-10-27,152,242,3,90
"17468",2007-10-28,115,196,84,81
"17469",2007-10-29,74,132,0,58
"17470",2007-10-30,34,176,0,142
"17471",2007-10-31,87,192,0,105
"17472",2007-11-01,79,171,0,92
"17473",2007-11-02,30,208,0,178
"17474",2007-11-03,58,178,0,120
"17475",2007-11-04,35,180,0,145
"17476",2007-11-05,40,189,0,149
"17477",2007-11-06,55,197,0,142
"17478",2007-11-07,64,230,0,166
"17479",2007-11-08,85,193,0,108
"17480",2007-11-09,65,157,0,92
"17481",2007-11-10,82,154,11,72
"17482",2007-11-11,57,153,0,96
"17483",2007-11-12,88,149,0,61
"17484",2007-11-13,48,167,0,119
"17485",2007-11-14,61,161,0,100
"17486",2007-11-15,26,120,65,94
"17487",2007-11-16,23,69,14,46
"17488",2007-11-17,23,158,0,135
"17489",2007-11-18,39,114,0,75
"17490",2007-11-19,16,169,0,153
"17491",2007-11-20,22,192,0,170
"17492",2007-11-21,27,183,0,156
"17493",2007-11-22,40,190,0,150
"17494",2007-11-23,28,133,0,105
"17495",2007-11-24,20,117,0,97
"17496",2007-11-25,37,166,0,129
"17497",2007-11-26,56,124,0,68
"17498",2007-11-27,24,131,0,107
"17499",2007-11-28,-9,152,0,161
"17500",2007-11-29,45,89,0,44
"17501",2007-11-30,38,81,0,43
"17502",2007-12-01,2,70,10,68
"17503",2007-12-02,43,107,19,64
"17504",2007-12-03,-5,99,0,104
"17505",2007-12-04,28,75,0,47
"17506",2007-12-05,-3,79,0,82
"17507",2007-12-06,20,123,0,103
"17508",2007-12-07,-14,86,0,100
"17509",2007-12-08,-5,60,0,65
"17510",2007-12-09,1,53,0,52
"17511",2007-12-10,2,77,0,75
"17512",2007-12-11,8,29,23,21
"17513",2007-12-12,15,64,1,49
"17514",2007-12-13,12,93,0,81
"17515",2007-12-14,-27,134,0,161
"17516",2007-12-15,15,102,0,87
"17517",2007-12-16,-15,105,0,120
"17518",2007-12-17,2,145,0,143
"17519",2007-12-18,26,101,0,75
"17520",2007-12-19,-21,134,0,155
"17521",2007-12-20,-2,75,0,77
"17522",2007-12-21,-6,52,0,58
"17523",2007-12-22,9,71,0,62
"17524",2007-12-23,-11,55,0,66
"17525",2007-12-24,4,40,5,36
"17526",2007-12-25,-16,72,0,88
"17527",2007-12-26,24,61,0,37
"17528",2007-12-27,39,74,26,35
"17529",2007-12-28,49,84,0,35
"17530",2007-12-29,19,87,0,68
"17531",2007-12-30,-12,51,0,63
"17532",2007-12-31,-1,73,0,74
"17533",2008-01-01,-13,67,0,80
"17534",2008-01-02,-47,103,0,150
"17535",2008-01-03,-2,94,0,96
"17536",2008-01-04,-26,98,0,124
"17537",2008-01-05,-34,140,0,174
"17538",2008-01-06,-12,87,0,99
"17539",2008-01-07,-13,149,0,162
"17540",2008-01-08,3,148,0,145
"17541",2008-01-09,-2,81,0,83
"17542",2008-01-10,-15,15,29,30
"17543",2008-01-11,-11,6,10,17
"17544",2008-01-12,-26,13,4,39
"17545",2008-01-13,-41,-17,0,24
"17546",2008-01-14,-76,-4,0,72
"17547",2008-01-15,-32,-12,0,20
"17548",2008-01-16,-66,-6,0,60
"17549",2008-01-17,-41,-4,5,37
"17550",2008-01-18,-23,-7,2,16
"17551",2008-01-19,-36,-18,38,18
"17552",2008-01-20,-35,-10,28,25
"17553",2008-01-21,-48,-15,1,33
"17554",2008-01-22,-58,-3,0,55
"17555",2008-01-23,-51,-23,0,28
"17556",2008-01-24,-88,0,0,88
"17557",2008-01-25,-37,-11,0,26
"17558",2008-01-26,-64,8,0,72
"17559",2008-01-27,-34,-2,45,32
"17560",2008-01-28,-44,24,8,68
"17561",2008-01-29,-53,8,0,61
"17562",2008-01-30,-26,15,0,41
"17563",2008-01-31,-51,24,0,75
"17564",2008-02-01,-39,33,0,72
"17565",2008-02-02,-63,52,0,115
"17566",2008-02-03,-46,62,0,108
"17567",2008-02-04,-53,58,0,111
"17568",2008-02-05,-9,44,0,53
"17569",2008-02-06,-69,51,0,120
"17570",2008-02-07,-55,61,0,116
"17571",2008-02-08,-25,38,0,63
"17572",2008-02-09,-32,25,0,57
"17573",2008-02-10,-56,72,0,128
"17574",2008-02-11,-35,64,0,99
"17575",2008-02-12,-40,38,0,78
"17576",2008-02-13,-62,70,0,132
"17577",2008-02-14,-6,97,0,103
"17578",2008-02-15,-43,107,0,150
"17579",2008-02-16,-15,88,0,103
"17580",2008-02-17,-26,75,0,101
"17581",2008-02-18,21,88,0,67
"17582",2008-02-19,4,135,0,131
"17583",2008-02-20,15,133,0,118
"17584",2008-02-21,-3,195,0,198
"17585",2008-02-22,22,130,0,108
"17586",2008-02-23,-3,82,0,85
"17587",2008-02-24,-18,27,0,45
"17588",2008-02-25,-43,40,25,83
"17589",2008-02-26,1,101,0,100
"17590",2008-02-27,44,145,0,101
"17591",2008-02-28,53,174,0,121
"17592",2008-02-29,60,182,0,122
"17593",2008-03-01,75,181,0,106
"17594",2008-03-02,83,150,0,67
"17595",2008-03-03,18,160,0,142
"17596",2008-03-04,8,174,0,166
"17597",2008-03-05,50,186,0,136
"17598",2008-03-06,86,125,0,39
"17599",2008-03-07,7,149,0,142
"17600",2008-03-08,63,164,0,101
"17601",2008-03-09,59,211,0,152
"17602",2008-03-10,54,249,0,195
"17603",2008-03-11,73,277,0,204
"17604",2008-03-12,97,187,0,90
"17605",2008-03-13,98,156,0,58
"17606",2008-03-14,42,185,0,143
"17607",2008-03-15,93,199,0,106
"17608",2008-03-16,80,175,0,95
"17609",2008-03-17,77,225,0,148
"17610",2008-03-18,115,246,0,131
"17611",2008-03-19,63,146,0,83
"17612",2008-03-20,88,145,0,57
"17613",2008-03-21,92,188,2,96
"17614",2008-03-22,91,234,0,143
"17615",2008-03-23,108,209,0,101
"17616",2008-03-24,52,202,0,150
"17617",2008-03-25,39,210,0,171
"17618",2008-03-26,81,189,0,108
"17619",2008-03-27,60,188,0,128
"17620",2008-03-28,64,144,2,80
"17621",2008-03-29,64,107,16,43
"17622",2008-03-30,53,136,0,83
"17623",2008-03-31,73,157,0,84
"17624",2008-04-01,107,195,0,88
"17625",2008-04-02,99,207,0,108
"17626",2008-04-03,69,221,0,152
"17627",2008-04-04,86,214,0,128
"17628",2008-04-05,106,223,0,117
"17629",2008-04-06,106,273,0,167
"17630",2008-04-07,128,260,0,132
"17631",2008-04-08,118,230,344,112
"17632",2008-04-09,118,210,0,92
"17633",2008-04-10,94,191,2,97
"17634",2008-04-11,99,177,4,78
"17635",2008-04-12,83,146,0,63
"17636",2008-04-13,77,232,0,155
"17637",2008-04-14,90,207,0,117
"17638",2008-04-15,118,214,0,96
"17639",2008-04-16,104,248,0,144
"17640",2008-04-17,99,252,0,153
"17641",2008-04-18,151,205,0,54
"17642",2008-04-19,122,179,463,57
"17643",2008-04-20,121,174,73,53
"17644",2008-04-21,91,196,0,105
"17645",2008-04-22,125,205,22,80
"17646",2008-04-23,125,215,0,90
"17647",2008-04-24,102,258,0,156
"17648",2008-04-25,140,293,0,153
"17649",2008-04-26,111,245,0,134
"17650",2008-04-27,161,211,0,50
"17651",2008-04-28,104,266,0,162
"17652",2008-04-29,144,285,0,141
"17653",2008-04-30,178,344,0,166
"17654",2008-05-01,186,318,0,132
"17655",2008-05-02,203,319,0,116
"17656",2008-05-03,172,304,91,132
"17657",2008-05-04,144,270,0,126
"17658",2008-05-05,154,296,0,142
"17659",2008-05-06,174,307,0,133
"17660",2008-05-07,198,277,0,79
"17661",2008-05-08,169,209,99,40
"17662",2008-05-09,159,248,151,89
"17663",2008-05-10,119,232,0,113
"17664",2008-05-11,150,241,0,91
"17665",2008-05-12,126,239,0,113
"17666",2008-05-13,110,245,0,135
"17667",2008-05-14,142,288,0,146
"17668",2008-05-15,161,280,0,119
"17669",2008-05-16,184,288,0,104
"17670",2008-05-17,172,263,252,91
"17671",2008-05-18,163,279,1,116
"17672",2008-05-19,149,315,0,166
"17673",2008-05-20,168,331,0,163
"17674",2008-05-21,191,315,0,124
"17675",2008-05-22,183,352,0,169
"17676",2008-05-23,210,324,0,114
"17677",2008-05-24,223,329,0,106
"17678",2008-05-25,220,308,0,88
"17679",2008-05-26,241,338,0,97
"17680",2008-05-27,251,324,0,73
"17681",2008-05-28,246,323,0,77
"17682",2008-05-29,206,314,0,108
"17683",2008-05-30,193,300,0,107
"17684",2008-05-31,150,346,0,196
"17685",2008-06-01,205,314,0,109
"17686",2008-06-02,194,301,0,107
"17687",2008-06-03,158,267,112,109
"17688",2008-06-04,143,265,0,122
"17689",2008-06-05,171,312,0,141
"17690",2008-06-06,205,275,2,70
"17691",2008-06-07,202,338,0,136
"17692",2008-06-08,181,344,0,163
"17693",2008-06-09,230,355,0,125
"17694",2008-06-10,237,330,0,93
"17695",2008-06-11,227,318,0,91
"17696",2008-06-12,229,329,0,100
"17697",2008-06-13,238,314,1,76
"17698",2008-06-14,216,298,0,82
"17699",2008-06-15,210,277,0,67
"17700",2008-06-16,183,252,7,69
"17701",2008-06-17,169,246,0,77
"17702",2008-06-18,160,305,0,145
"17703",2008-06-19,221,301,0,80
"17704",2008-06-20,236,336,3,100
"17705",2008-06-21,245,316,0,71
"17706",2008-06-22,241,333,0,92
"17707",2008-06-23,226,360,1,134
"17708",2008-06-24,236,304,0,68
"17709",2008-06-25,237,374,0,137
"17710",2008-06-26,231,324,0,93
"17711",2008-06-27,225,326,0,101
"17712",2008-06-28,224,316,0,92
"17713",2008-06-29,234,356,0,122
"17714",2008-06-30,247,327,120,80
"17715",2008-07-01,231,263,104,32
"17716",2008-07-02,212,324,0,112
"17717",2008-07-03,238,367,0,129
"17718",2008-07-04,284,345,0,61
"17719",2008-07-05,225,301,36,76
"17720",2008-07-06,220,328,0,108
"17721",2008-07-07,217,296,0,79
"17722",2008-07-08,222,286,5,64
"17723",2008-07-09,235,310,0,75
"17724",2008-07-10,254,330,0,76
"17725",2008-07-11,252,350,0,98
"17726",2008-07-12,236,314,432,78
"17727",2008-07-13,251,313,141,62
"17728",2008-07-14,242,312,1607,70
"17729",2008-07-15,237,294,82,57
"17730",2008-07-16,202,334,0,132
"17731",2008-07-17,210,291,81,81
"17732",2008-07-18,203,285,327,82
"17733",2008-07-19,205,291,0,86
"17734",2008-07-20,225,291,0,66
"17735",2008-07-21,216,286,0,70
"17736",2008-07-22,197,258,140,61
"17737",2008-07-23,211,271,65,60
"17738",2008-07-24,201,333,0,132
"17739",2008-07-25,231,302,0,71
"17740",2008-07-26,229,297,0,68
"17741",2008-07-27,255,314,0,59
"17742",2008-07-28,256,333,0,77
"17743",2008-07-29,262,337,0,75
"17744",2008-07-30,248,301,77,53
"17745",2008-07-31,257,320,0,63
"17746",2008-08-01,259,350,0,91
"17747",2008-08-02,268,339,0,71
"17748",2008-08-03,238,327,0,89
"17749",2008-08-04,255,316,0,61
"17750",2008-08-05,247,310,0,63
"17751",2008-08-06,257,315,0,58
"17752",2008-08-07,255,332,0,77
"17753",2008-08-08,254,337,0,83
"17754",2008-08-09,257,332,0,75
"17755",2008-08-10,258,333,0,75
"17756",2008-08-11,251,320,0,69
"17757",2008-08-12,252,329,0,77
"17758",2008-08-13,228,289,463,61
"17759",2008-08-14,238,287,10,49
"17760",2008-08-15,229,281,0,52
"17761",2008-08-16,216,261,0,45
"17762",2008-08-17,194,278,27,84
"17763",2008-08-18,200,318,0,118
"17764",2008-08-19,229,296,0,67
"17765",2008-08-20,244,296,0,52
"17766",2008-08-21,250,301,25,51
"17767",2008-08-22,215,330,0,115
"17768",2008-08-23,198,346,0,148
"17769",2008-08-24,215,319,0,104
"17770",2008-08-25,217,318,0,101
"17771",2008-08-26,211,311,0,100
"17772",2008-08-27,224,298,0,74
"17773",2008-08-28,225,300,0,75
"17774",2008-08-29,232,285,12,53
"17775",2008-08-30,203,263,48,60
"17776",2008-08-31,195,291,0,96
"17777",2008-09-01,174,300,0,126
"17778",2008-09-02,177,310,0,133
"17779",2008-09-03,221,300,0,79
"17780",2008-09-04,188,317,0,129
"17781",2008-09-05,186,311,0,125
"17782",2008-09-06,200,309,0,109
"17783",2008-09-07,219,261,55,42
"17784",2008-09-08,184,229,34,45
"17785",2008-09-09,200,277,0,77
"17786",2008-09-10,181,257,134,76
"17787",2008-09-11,168,308,0,140
"17788",2008-09-12,158,313,0,155
"17789",2008-09-13,172,298,0,126
"17790",2008-09-14,196,293,0,97
"17791",2008-09-15,166,316,0,150
"17792",2008-09-16,180,316,0,136
"17793",2008-09-17,199,316,0,117
"17794",2008-09-18,192,267,86,75
"17795",2008-09-19,184,213,81,29
"17796",2008-09-20,188,258,3,70
"17797",2008-09-21,201,257,0,56
"17798",2008-09-22,226,294,0,68
"17799",2008-09-23,196,265,0,69
"17800",2008-09-24,153,196,0,43
"17801",2008-09-25,164,225,9,61
"17802",2008-09-26,139,187,21,48
"17803",2008-09-27,114,163,71,49
"17804",2008-09-28,116,136,150,20
"17805",2008-09-29,116,214,0,98
"17806",2008-09-30,129,259,0,130
"17807",2008-10-01,123,263,0,140
"17808",2008-10-02,152,269,0,117
"17809",2008-10-03,143,264,0,121
"17810",2008-10-04,175,215,0,40
"17811",2008-10-05,163,223,7,60
"17812",2008-10-06,116,199,0,83
"17813",2008-10-07,98,209,5,111
"17814",2008-10-08,146,220,9,74
"17815",2008-10-09,123,230,0,107
"17816",2008-10-10,155,221,0,66
"17817",2008-10-11,143,203,0,60
"17818",2008-10-12,85,242,0,157
"17819",2008-10-13,112,283,0,171
"17820",2008-10-14,136,313,0,177
"17821",2008-10-15,134,299,0,165
"17822",2008-10-16,157,277,0,120
"17823",2008-10-17,117,252,0,135
"17824",2008-10-18,136,258,0,122
"17825",2008-10-19,141,248,0,107
"17826",2008-10-20,172,189,3,17
"17827",2008-10-21,163,199,74,36
"17828",2008-10-22,143,192,14,49
"17829",2008-10-23,113,186,0,73
"17830",2008-10-24,93,196,0,103
"17831",2008-10-25,72,221,0,149
"17832",2008-10-26,82,237,0,155
"17833",2008-10-27,99,214,0,115
"17834",2008-10-28,125,161,21,36
"17835",2008-10-29,112,200,0,88
"17836",2008-10-30,114,171,0,57
"17837",2008-10-31,122,194,0,72
"17838",2008-11-01,83,236,0,153
"17839",2008-11-02,89,238,0,149
"17840",2008-11-03,98,195,0,97
"17841",2008-11-04,111,212,0,101
"17842",2008-11-05,95,250,0,155
"17843",2008-11-06,160,211,0,51
"17844",2008-11-07,123,181,0,58
"17845",2008-11-08,83,146,0,63
"17846",2008-11-09,78,113,0,35
"17847",2008-11-10,31,137,0,106
"17848",2008-11-11,22,154,0,132
"17849",2008-11-12,53,157,0,104
"17850",2008-11-13,92,171,0,79
"17851",2008-11-14,98,144,79,46
"17852",2008-11-15,94,160,50,66
"17853",2008-11-16,70,169,0,99
"17854",2008-11-17,58,133,0,75
"17855",2008-11-18,35,111,0,76
"17856",2008-11-19,19,116,0,97
"17857",2008-11-20,-2,170,0,172
"17858",2008-11-21,-4,147,0,151
"17859",2008-11-22,68,153,0,85
"17860",2008-11-23,59,111,0,52
"17861",2008-11-24,22,170,0,148
"17862",2008-11-25,48,137,0,89
"17863",2008-11-26,32,135,0,103
"17864",2008-11-27,36,94,0,58
"17865",2008-11-28,-12,146,0,158
"17866",2008-11-29,13,159,0,146
"17867",2008-11-30,32,200,0,168
"17868",2008-12-01,33,169,0,136
"17869",2008-12-02,13,166,0,153
"17870",2008-12-03,57,156,0,99
"17871",2008-12-04,25,121,0,96
"17872",2008-12-05,-39,52,0,91
"17873",2008-12-06,-24,78,0,102
"17874",2008-12-07,-23,133,0,156
"17875",2008-12-08,19,156,0,137
"17876",2008-12-09,25,207,0,182
"17877",2008-12-10,41,88,0,47
"17878",2008-12-11,-17,131,0,148
"17879",2008-12-12,6,73,0,67
"17880",2008-12-13,11,57,0,46
"17881",2008-12-14,-36,112,0,148
"17882",2008-12-15,-33,159,0,192
"17883",2008-12-16,-9,178,0,187
"17884",2008-12-17,44,128,0,84
"17885",2008-12-18,-21,89,0,110
"17886",2008-12-19,-8,144,0,152
"17887",2008-12-20,8,63,0,55
"17888",2008-12-21,-61,41,0,102
"17889",2008-12-22,-102,41,0,143
"17890",2008-12-23,-80,51,0,131
"17891",2008-12-24,-38,133,0,171
"17892",2008-12-25,-31,95,0,126
"17893",2008-12-26,-23,49,0,72
"17894",2008-12-27,-58,48,0,106
"17895",2008-12-28,1,48,31,47
"17896",2008-12-29,-3,65,0,68
"17897",2008-12-30,-1,60,0,61
"17898",2008-12-31,-29,55,0,84
"17899",2009-01-01,-78,44,0,122
"17900",2009-01-02,-60,54,0,114
"17901",2009-01-03,1,37,0,36
"17902",2009-01-04,-31,43,0,74
"17903",2009-01-05,-35,35,0,70
"17904",2009-01-06,-49,28,0,77
"17905",2009-01-07,-47,57,0,104
"17906",2009-01-08,-45,95,0,140
"17907",2009-01-09,-59,50,0,109
"17908",2009-01-10,-86,96,0,182
"17909",2009-01-11,-45,36,0,81
"17910",2009-01-12,-82,42,0,124
"17911",2009-01-13,-15,96,0,111
"17912",2009-01-14,-25,32,0,57
"17913",2009-01-15,-78,73,0,151
"17914",2009-01-16,-59,58,0,117
"17915",2009-01-17,-57,63,0,120
"17916",2009-01-18,-26,126,0,152
"17917",2009-01-19,-20,72,0,92
"17918",2009-01-20,-8,121,0,129
"17919",2009-01-21,8,183,0,175
"17920",2009-01-22,-1,113,0,114
"17921",2009-01-23,-77,-1,0,76
"17922",2009-01-24,-67,35,0,102
"17923",2009-01-25,-43,79,0,122
"17924",2009-01-26,-11,100,0,111
"17925",2009-01-27,-44,137,0,181
"17926",2009-01-28,-8,104,0,112
"17927",2009-01-29,-18,109,0,127
"17928",2009-01-30,-22,89,0,111
"17929",2009-01-31,-23,41,0,64
"17930",2009-02-01,11,47,0,36
"17931",2009-02-02,0,51,0,51
"17932",2009-02-03,-5,74,0,79
"17933",2009-02-04,-25,127,0,152
"17934",2009-02-05,-2,107,0,109
"17935",2009-02-06,66,132,0,66
"17936",2009-02-07,60,102,16,42
"17937",2009-02-08,36,62,48,26
"17938",2009-02-09,30,158,0,128
"17939",2009-02-10,15,225,0,210
"17940",2009-02-11,35,192,0,157
"17941",2009-02-12,125,168,0,43
"17942",2009-02-13,65,136,0,71
"17943",2009-02-14,78,151,0,73
"17944",2009-02-15,27,100,0,73
"17945",2009-02-16,14,46,0,32
"17946",2009-02-17,10,46,0,36
"17947",2009-02-18,0,45,22,45
"17948",2009-02-19,-3,105,11,108
"17949",2009-02-20,21,117,0,96
"17950",2009-02-21,22,141,0,119
"17951",2009-02-22,59,101,0,42
"17952",2009-02-23,27,76,0,49
"17953",2009-02-24,10,48,139,38
"17954",2009-02-25,7,30,18,23
"17955",2009-02-26,6,24,46,18
"17956",2009-02-27,-2,89,1,91
"17957",2009-02-28,12,106,0,94
"17958",2009-03-01,20,106,0,86
"17959",2009-03-02,-1,50,39,51
"17960",2009-03-03,-24,73,0,97
"17961",2009-03-04,7,70,1,63
"17962",2009-03-05,4,152,4,148
"17963",2009-03-06,43,119,0,76
"17964",2009-03-07,21,156,0,135
"17965",2009-03-08,39,180,0,141
"17966",2009-03-09,33,192,0,159
"17967",2009-03-10,57,111,0,54
"17968",2009-03-11,58,91,0,33
"17969",2009-03-12,58,96,113,38
"17970",2009-03-13,68,104,0,36
"17971",2009-03-14,6,167,0,161
"17972",2009-03-15,72,238,0,166
"17973",2009-03-16,89,264,0,175
"17974",2009-03-17,102,267,0,165
"17975",2009-03-18,95,278,0,183
"17976",2009-03-19,133,224,0,91
"17977",2009-03-20,105,150,0,45
"17978",2009-03-21,114,199,9,85
"17979",2009-03-22,117,193,0,76
"17980",2009-03-23,88,156,4,68
"17981",2009-03-24,58,110,0,52
"17982",2009-03-25,22,164,0,142
"17983",2009-03-26,49,150,0,101
"17984",2009-03-27,99,131,0,32
"17985",2009-03-28,79,151,0,72
"17986",2009-03-29,68,167,0,99
"17987",2009-03-30,64,121,0,57
"17988",2009-03-31,48,122,3,74
"17989",2009-04-01,45,144,0,99
"17990",2009-04-02,44,105,0,61
"17991",2009-04-03,55,154,0,99
"17992",2009-04-04,64,202,0,138
"17993",2009-04-05,84,218,0,134
"17994",2009-04-06,107,250,0,143
"17995",2009-04-07,105,248,0,143
"17996",2009-04-08,125,253,0,128
"17997",2009-04-09,110,249,0,139
"17998",2009-04-10,121,203,0,82
"17999",2009-04-11,152,265,0,113
"18000",2009-04-12,141,261,0,120
"18001",2009-04-13,150,296,0,146
"18002",2009-04-14,169,273,0,104
"18003",2009-04-15,99,246,0,147
"18004",2009-04-16,65,185,0,120
"18005",2009-04-17,120,203,0,83
"18006",2009-04-18,135,200,0,65
"18007",2009-04-19,147,184,479,37
"18008",2009-04-20,119,261,0,142
"18009",2009-04-21,109,220,0,111
"18010",2009-04-22,155,206,0,51
"18011",2009-04-23,141,195,13,54
"18012",2009-04-24,143,221,0,78
"18013",2009-04-25,135,228,0,93
"18014",2009-04-26,114,228,0,114
"18015",2009-04-27,107,281,0,174
"18016",2009-04-28,126,289,0,163
"18017",2009-04-29,149,255,0,106
"18018",2009-04-30,145,250,0,105
"18019",2009-05-01,182,261,0,79
"18020",2009-05-02,186,286,0,100
"18021",2009-05-03,156,299,14,143
"18022",2009-05-04,158,284,0,126
"18023",2009-05-05,166,275,0,109
"18024",2009-05-06,168,290,0,122
"18025",2009-05-07,189,306,0,117
"18026",2009-05-08,207,312,0,105
"18027",2009-05-09,246,301,0,55
"18028",2009-05-10,138,282,4,144
"18029",2009-05-11,135,184,271,49
"18030",2009-05-12,153,283,20,130
"18031",2009-05-13,191,258,0,67
"18032",2009-05-14,132,231,167,99
"18033",2009-05-15,126,163,287,37
"18034",2009-05-16,128,269,0,141
"18035",2009-05-17,140,277,0,137
"18036",2009-05-18,168,311,0,143
"18037",2009-05-19,167,307,0,140
"18038",2009-05-20,188,278,0,90
"18039",2009-05-21,160,288,0,128
"18040",2009-05-22,197,262,28,65
"18041",2009-05-23,128,295,0,167
"18042",2009-05-24,161,286,0,125
"18043",2009-05-25,175,243,3,68
"18044",2009-05-26,150,264,0,114
"18045",2009-05-27,183,246,13,63
"18046",2009-05-28,182,207,22,25
"18047",2009-05-29,177,279,0,102
"18048",2009-05-30,208,311,0,103
"18049",2009-05-31,218,345,0,127
"18050",2009-06-01,187,350,0,163
"18051",2009-06-02,198,353,0,155
"18052",2009-06-03,216,346,0,130
"18053",2009-06-04,219,339,3,120
"18054",2009-06-05,226,379,0,153
"18055",2009-06-06,211,317,0,106
"18056",2009-06-07,197,289,0,92
"18057",2009-06-08,206,256,82,50
"18058",2009-06-09,190,291,0,101
"18059",2009-06-10,228,333,0,105
"18060",2009-06-11,204,356,0,152
"18061",2009-06-12,252,331,0,79
"18062",2009-06-13,203,348,0,145
"18063",2009-06-14,225,344,0,119
"18064",2009-06-15,210,326,0,116
"18065",2009-06-16,252,375,0,123
"18066",2009-06-17,234,334,0,100
"18067",2009-06-18,241,294,3,53
"18068",2009-06-19,256,335,0,79
"18069",2009-06-20,250,353,0,103
"18070",2009-06-21,219,401,0,182
"18071",2009-06-22,259,346,0,87
"18072",2009-06-23,238,386,0,148
"18073",2009-06-24,248,419,0,171
"18074",2009-06-25,236,408,0,172
"18075",2009-06-26,290,381,0,91
"18076",2009-06-27,243,375,218,132
"18077",2009-06-28,240,332,192,92
"18078",2009-06-29,252,360,0,108
"18079",2009-06-30,239,370,0,131
"18080",2009-07-01,238,343,0,105
"18081",2009-07-02,251,350,0,99
"18082",2009-07-03,240,365,0,125
"18083",2009-07-04,238,356,0,118
"18084",2009-07-05,248,333,0,85
"18085",2009-07-06,260,331,33,71
"18086",2009-07-07,264,327,36,63
"18087",2009-07-08,235,344,206,109
"18088",2009-07-09,210,310,28,100
"18089",2009-07-10,223,292,3,69
"18090",2009-07-11,198,296,291,98
"18091",2009-07-12,225,329,0,104
"18092",2009-07-13,226,287,481,61
"18093",2009-07-14,224,325,0,101
"18094",2009-07-15,240,327,0,87
"18095",2009-07-16,265,341,0,76
"18096",2009-07-17,280,351,94,71
"18097",2009-07-18,237,301,0,64
"18098",2009-07-19,243,324,0,81
"18099",2009-07-20,282,352,0,70
"18100",2009-07-21,276,341,0,65
"18101",2009-07-22,261,305,68,44
"18102",2009-07-23,227,345,0,118
"18103",2009-07-24,225,306,8,81
"18104",2009-07-25,239,272,0,33
"18105",2009-07-26,209,304,0,95
"18106",2009-07-27,237,296,0,59
"18107",2009-07-28,234,307,0,73
"18108",2009-07-29,220,310,0,90
"18109",2009-07-30,238,312,0,74
"18110",2009-07-31,242,299,4,57
"18111",2009-08-01,228,310,0,82
"18112",2009-08-02,238,332,527,94
"18113",2009-08-03,240,271,7,31
"18114",2009-08-04,238,295,0,57
"18115",2009-08-05,226,264,857,38
"18116",2009-08-06,221,294,0,73
"18117",2009-08-07,227,300,0,73
"18118",2009-08-08,254,291,0,37
"18119",2009-08-09,249,312,0,63
"18120",2009-08-10,243,314,0,71
"18121",2009-08-11,234,335,0,101
"18122",2009-08-12,227,368,0,141
"18123",2009-08-13,218,343,0,125
"18124",2009-08-14,214,343,0,129
"18125",2009-08-15,236,338,0,102
"18126",2009-08-16,248,334,0,86
"18127",2009-08-17,242,299,753,57
"18128",2009-08-18,229,294,0,65
"18129",2009-08-19,256,322,0,66
"18130",2009-08-20,255,311,0,56
"18131",2009-08-21,191,283,163,92
"18132",2009-08-22,183,217,71,34
"18133",2009-08-23,190,292,0,102
"18134",2009-08-24,215,295,0,80
"18135",2009-08-25,241,321,0,80
"18136",2009-08-26,256,318,0,62
"18137",2009-08-27,214,348,0,134
"18138",2009-08-28,218,294,0,76
"18139",2009-08-29,155,263,324,108
"18140",2009-08-30,120,264,0,144
"18141",2009-08-31,157,276,0,119
"18142",2009-09-01,163,281,0,118
"18143",2009-09-02,194,284,0,90
"18144",2009-09-03,216,295,44,79
"18145",2009-09-04,242,315,0,73
"18146",2009-09-05,245,333,0,88
"18147",2009-09-06,178,262,197,84
"18148",2009-09-07,158,179,50,21
"18149",2009-09-08,159,186,0,27
"18150",2009-09-09,153,224,12,71
"18151",2009-09-10,165,217,0,52
"18152",2009-09-11,189,246,0,57
"18153",2009-09-12,167,236,5,69
"18154",2009-09-13,176,194,54,18
"18155",2009-09-14,171,227,68,56
"18156",2009-09-15,156,278,0,122
"18157",2009-09-16,199,233,2,34
"18158",2009-09-17,187,248,4,61
"18159",2009-09-18,201,221,75,20
"18160",2009-09-19,193,224,21,31
"18161",2009-09-20,159,205,129,46
"18162",2009-09-21,133,270,0,137
"18163",2009-09-22,103,287,0,184
"18164",2009-09-23,139,297,0,158
"18165",2009-09-24,188,240,101,52
"18166",2009-09-25,176,277,42,101
"18167",2009-09-26,187,260,0,73
"18168",2009-09-27,171,274,0,103
"18169",2009-09-28,164,275,0,111
"18170",2009-09-29,177,282,0,105
"18171",2009-09-30,150,286,0,136
"18172",2009-10-01,162,298,0,136
"18173",2009-10-02,173,283,0,110
"18174",2009-10-03,154,303,0,149
"18175",2009-10-04,165,267,0,102
"18176",2009-10-05,136,292,0,156
"18177",2009-10-06,138,280,0,142
"18178",2009-10-07,170,240,3,70
"18179",2009-10-08,157,189,10,32
"18180",2009-10-09,161,195,0,34
"18181",2009-10-10,158,188,0,30
"18182",2009-10-11,151,178,4,27
"18183",2009-10-12,136,205,19,69
"18184",2009-10-13,142,238,0,96
"18185",2009-10-14,91,244,0,153
"18186",2009-10-15,90,281,0,191
"18187",2009-10-16,145,273,0,128
"18188",2009-10-17,94,259,0,165
"18189",2009-10-18,116,256,0,140
"18190",2009-10-19,94,226,0,132
"18191",2009-10-20,90,279,0,189
"18192",2009-10-21,115,263,0,148
"18193",2009-10-22,109,292,0,183
"18194",2009-10-23,110,292,0,182
"18195",2009-10-24,121,247,0,126
"18196",2009-10-25,105,263,0,158
"18197",2009-10-26,136,264,0,128
"18198",2009-10-27,132,239,0,107
"18199",2009-10-28,126,263,0,137
"18200",2009-10-29,146,265,0,119
"18201",2009-10-30,165,211,0,46
"18202",2009-10-31,93,166,60,73
"18203",2009-11-01,82,203,0,121
"18204",2009-11-02,9,151,0,142
"18205",2009-11-03,2,125,0,123
"18206",2009-11-04,47,218,0,171
"18207",2009-11-05,49,246,0,197
"18208",2009-11-06,77,261,0,184
"18209",2009-11-07,152,273,0,121
"18210",2009-11-08,124,207,0,83
"18211",2009-11-09,55,150,0,95
"18212",2009-11-10,11,56,0,45
"18213",2009-11-11,-14,11,182,25
"18214",2009-11-12,-28,30,274,58
"18215",2009-11-13,-77,54,0,131
"18216",2009-11-14,-32,30,0,62
"18217",2009-11-15,-28,-1,4,27
"18218",2009-11-16,-21,-5,0,16
"18219",2009-11-17,-47,39,0,86
"18220",2009-11-18,-36,62,0,98
"18221",2009-11-19,-15,56,0,71
"18222",2009-11-20,12,92,0,80
"18223",2009-11-21,2,99,0,97
"18224",2009-11-22,-16,147,0,163
"18225",2009-11-23,-1,137,0,138
"18226",2009-11-24,19,168,0,149
"18227",2009-11-25,21,108,0,87
"18228",2009-11-26,24,66,0,42
"18229",2009-11-27,28,48,0,20
"18230",2009-11-28,6,43,7,37
"18231",2009-11-29,-24,93,0,117
"18232",2009-11-30,17,129,0,112
"18233",2009-12-01,-4,64,0,68
"18234",2009-12-02,14,141,0,127
"18235",2009-12-03,-8,111,0,119
"18236",2009-12-04,-3,135,0,138
"18237",2009-12-05,-24,111,0,135
"18238",2009-12-06,-16,91,0,107
"18239",2009-12-07,2,68,0,66
"18240",2009-12-08,46,96,0,50
"18241",2009-12-09,-9,91,0,100
"18242",2009-12-10,29,87,0,58
"18243",2009-12-11,45,97,0,52
"18244",2009-12-12,10,47,0,37
"18245",2009-12-13,-29,76,0,105
"18246",2009-12-14,-21,39,2,60
"18247",2009-12-15,-1,26,9,27
"18248",2009-12-16,-10,67,0,77
"18249",2009-12-17,-36,62,0,98
"18250",2009-12-18,-45,44,0,89
"18251",2009-12-19,-57,48,0,105
"18252",2009-12-20,-22,46,0,68
"18253",2009-12-21,-75,96,0,171
"18254",2009-12-22,-30,138,0,168
"18255",2009-12-23,-7,95,0,102
"18256",2009-12-24,-16,128,0,144
"18257",2009-12-25,-1,103,0,104
"18258",2009-12-26,-39,14,0,53
"18259",2009-12-27,-7,39,0,46
"18260",2009-12-28,-55,66,0,121
"18261",2009-12-29,-35,121,0,156
"18262",2009-12-30,-14,85,0,99
"18263",2009-12-31,-63,54,0,117
"18264",2010-01-01,-41,170,0,211
"18265",2010-01-02,-24,54,0,78
"18266",2010-01-03,-37,19,0,56
"18267",2010-01-04,-55,-1,0,54
"18268",2010-01-05,-69,-18,0,51
"18269",2010-01-06,-78,-8,0,70
"18270",2010-01-07,-78,-22,0,56
"18271",2010-01-08,-81,22,0,103
"18272",2010-01-09,-49,-6,0,43
"18273",2010-01-10,-45,13,0,58
"18274",2010-01-11,-51,24,0,75
"18275",2010-01-12,-61,59,0,120
"18276",2010-01-13,-70,56,0,126
"18277",2010-01-14,-65,154,0,219
"18278",2010-01-15,-29,48,0,77
"18279",2010-01-16,-65,86,0,151
"18280",2010-01-17,-41,107,0,148
"18281",2010-01-18,-30,54,0,84
"18282",2010-01-19,8,52,0,44
"18283",2010-01-20,14,56,1,42
"18284",2010-01-21,-8,14,1,22
"18285",2010-01-22,-19,60,0,79
"18286",2010-01-23,-10,69,0,79
"18287",2010-01-24,-31,113,0,144
"18288",2010-01-25,-7,90,0,97
"18289",2010-01-26,-18,95,0,113
"18290",2010-01-27,14,144,0,130
"18291",2010-01-28,13,132,0,119
"18292",2010-01-29,-17,110,0,127
"18293",2010-01-30,19,142,0,123
"18294",2010-01-31,22,100,0,78
"18295",2010-02-01,-10,102,0,112
"18296",2010-02-02,1,65,0,64
"18297",2010-02-03,-21,51,0,72
"18298",2010-02-04,-30,86,0,116
"18299",2010-02-05,3,48,0,45
"18300",2010-02-06,-10,16,7,26
"18301",2010-02-07,-9,29,7,38
"18302",2010-02-08,15,46,0,31
"18303",2010-02-09,11,26,22,15
"18304",2010-02-10,-31,11,36,42
"18305",2010-02-11,-37,2,26,39
"18306",2010-02-12,-64,5,0,69
"18307",2010-02-13,-40,20,0,60
"18308",2010-02-14,-11,35,0,46
"18309",2010-02-15,-15,16,0,31
"18310",2010-02-16,-38,37,0,75
"18311",2010-02-17,-36,70,0,106
"18312",2010-02-18,2,95,0,93
"18313",2010-02-19,-13,147,0,160
"18314",2010-02-20,-16,201,0,217
"18315",2010-02-21,22,176,0,154
"18316",2010-02-22,23,183,0,160
"18317",2010-02-23,32,206,0,174
"18318",2010-02-24,98,167,0,69
"18319",2010-02-25,87,123,0,36
"18320",2010-02-26,44,128,0,84
"18321",2010-02-27,50,124,2,74
"18322",2010-02-28,12,103,32,91
"18323",2010-03-01,-9,45,0,54
"18324",2010-03-02,15,73,0,58
"18325",2010-03-03,42,66,0,24
"18326",2010-03-04,30,86,0,56
"18327",2010-03-05,-2,56,66,58
"18328",2010-03-06,3,53,0,50
"18329",2010-03-07,-10,64,0,74
"18330",2010-03-08,-3,40,0,43
"18331",2010-03-09,-32,50,0,82
"18332",2010-03-10,0,148,0,148
"18333",2010-03-11,17,195,0,178
"18334",2010-03-12,74,199,0,125
"18335",2010-03-13,70,161,0,91
"18336",2010-03-14,40,100,60,60
"18337",2010-03-15,35,169,4,134
"18338",2010-03-16,6,189,0,183
"18339",2010-03-17,76,146,0,70
"18340",2010-03-18,48,105,2,57
"18341",2010-03-19,51,285,0,234
"18342",2010-03-20,144,244,0,100
"18343",2010-03-21,72,164,0,92
"18344",2010-03-22,106,142,20,36
"18345",2010-03-23,96,138,0,42
"18346",2010-03-24,86,157,0,71
"18347",2010-03-25,50,139,0,89
"18348",2010-03-26,12,178,0,166
"18349",2010-03-27,108,218,0,110
"18350",2010-03-28,65,167,0,102
"18351",2010-03-29,96,160,1,64
"18352",2010-03-30,108,170,1,62
"18353",2010-03-31,81,209,0,128
"18354",2010-04-01,113,182,5,69
"18355",2010-04-02,45,206,0,161
"18356",2010-04-03,100,200,0,100
"18357",2010-04-04,86,249,0,163
"18358",2010-04-05,110,300,0,190
"18359",2010-04-06,85,235,0,150
"18360",2010-04-07,63,168,0,105
"18361",2010-04-08,84,222,0,138
"18362",2010-04-09,104,219,0,115
"18363",2010-04-10,112,187,0,75
"18364",2010-04-11,91,112,0,21
"18365",2010-04-12,73,111,3,38
"18366",2010-04-13,32,115,0,83
"18367",2010-04-14,20,87,40,67
"18368",2010-04-15,38,145,0,107
"18369",2010-04-16,57,203,0,146
"18370",2010-04-17,109,215,0,106
"18371",2010-04-18,140,233,0,93
"18372",2010-04-19,142,205,0,63
"18373",2010-04-20,113,176,143,63
"18374",2010-04-21,92,129,355,37
"18375",2010-04-22,85,219,0,134
"18376",2010-04-23,78,201,0,123
"18377",2010-04-24,112,219,0,107
"18378",2010-04-25,135,205,0,70
"18379",2010-04-26,124,230,0,106
"18380",2010-04-27,63,249,0,186
"18381",2010-04-28,117,202,0,85
"18382",2010-04-29,87,265,0,178
"18383",2010-04-30,105,252,0,147
"18384",2010-05-01,129,317,0,188
"18385",2010-05-02,181,331,0,150
"18386",2010-05-03,235,318,0,83
"18387",2010-05-04,201,275,0,74
"18388",2010-05-05,188,260,18,72
"18389",2010-05-06,193,261,0,68
"18390",2010-05-07,131,297,0,166
"18391",2010-05-08,186,247,0,61
"18392",2010-05-09,154,263,0,109
"18393",2010-05-10,113,279,0,166
"18394",2010-05-11,153,247,0,94
"18395",2010-05-12,164,216,1,52
"18396",2010-05-13,161,241,2,80
"18397",2010-05-14,152,246,0,94
"18398",2010-05-15,146,245,0,99
"18399",2010-05-16,163,208,47,45
"18400",2010-05-17,164,230,45,66
"18401",2010-05-18,179,245,0,66
"18402",2010-05-19,137,321,0,184
"18403",2010-05-20,140,308,0,168
"18404",2010-05-21,200,249,5,49
"18405",2010-05-22,173,261,2,88
"18406",2010-05-23,157,286,0,129
"18407",2010-05-24,181,333,0,152
"18408",2010-05-25,200,309,0,109
"18409",2010-05-26,215,263,0,48
"18410",2010-05-27,185,237,92,52
"18411",2010-05-28,178,286,4,108
"18412",2010-05-29,190,333,0,143
"18413",2010-05-30,211,340,0,129
"18414",2010-05-31,225,287,0,62
"18415",2010-06-01,208,280,0,72
"18416",2010-06-02,185,304,0,119
"18417",2010-06-03,200,264,0,64
"18418",2010-06-04,202,270,8,68
"18419",2010-06-05,167,299,0,132
"18420",2010-06-06,206,309,0,103
"18421",2010-06-07,208,283,0,75
"18422",2010-06-08,206,262,3,56
"18423",2010-06-09,171,225,165,54
"18424",2010-06-10,190,269,0,79
"18425",2010-06-11,182,304,0,122
"18426",2010-06-12,204,337,0,133
"18427",2010-06-13,206,345,0,139
"18428",2010-06-14,209,360,0,151
"18429",2010-06-15,218,368,0,150
"18430",2010-06-16,242,349,0,107
"18431",2010-06-17,240,395,0,155
"18432",2010-06-18,232,346,0,114
"18433",2010-06-19,238,337,0,99
"18434",2010-06-20,243,362,0,119
"18435",2010-06-21,246,377,0,131
"18436",2010-06-22,256,387,0,131
"18437",2010-06-23,239,301,11,62
"18438",2010-06-24,238,313,0,75
"18439",2010-06-25,226,315,0,89
"18440",2010-06-26,214,334,0,120
"18441",2010-06-27,233,360,0,127
"18442",2010-06-28,221,374,0,153
"18443",2010-06-29,271,378,0,107
"18444",2010-06-30,294,373,0,79
"18445",2010-07-01,271,363,60,92
"18446",2010-07-02,253,332,17,79
"18447",2010-07-03,275,310,0,35
"18448",2010-07-04,267,377,0,110
"18449",2010-07-05,284,357,0,73
"18450",2010-07-06,261,399,0,138
"18451",2010-07-07,274,374,0,100
"18452",2010-07-08,241,338,18,97
"18453",2010-07-09,263,333,0,70
"18454",2010-07-10,223,307,169,84
"18455",2010-07-11,226,327,0,101
"18456",2010-07-12,242,338,0,96
"18457",2010-07-13,255,325,0,70
"18458",2010-07-14,242,335,0,93
"18459",2010-07-15,238,311,63,73
"18460",2010-07-16,224,293,0,69
"18461",2010-07-17,249,271,88,22
"18462",2010-07-18,226,289,1,63
"18463",2010-07-19,218,267,1020,49
"18464",2010-07-20,217,314,0,97
"18465",2010-07-21,229,333,0,104
"18466",2010-07-22,249,328,0,79
"18467",2010-07-23,236,289,55,53
"18468",2010-07-24,234,307,35,73
"18469",2010-07-25,256,329,0,73
"18470",2010-07-26,245,335,0,90
"18471",2010-07-27,257,337,0,80
"18472",2010-07-28,266,342,0,76
"18473",2010-07-29,275,360,0,85
"18474",2010-07-30,291,364,0,73
"18475",2010-07-31,290,357,0,67
"18476",2010-08-01,260,328,0,68
"18477",2010-08-02,240,304,0,64
"18478",2010-08-03,256,342,0,86
"18479",2010-08-04,280,389,0,109
"18480",2010-08-05,261,357,10,96
"18481",2010-08-06,256,315,0,59
"18482",2010-08-07,251,303,0,52
"18483",2010-08-08,259,345,0,86
"18484",2010-08-09,256,344,315,88
"18485",2010-08-10,259,297,277,38
"18486",2010-08-11,252,318,0,66
"18487",2010-08-12,264,306,0,42
"18488",2010-08-13,265,357,48,92
"18489",2010-08-14,241,299,88,58
"18490",2010-08-15,237,296,0,59
"18491",2010-08-16,186,332,0,146
"18492",2010-08-17,206,324,0,118
"18493",2010-08-18,243,324,0,81
"18494",2010-08-19,247,332,44,85
"18495",2010-08-20,232,259,152,27
"18496",2010-08-21,234,317,106,83
"18497",2010-08-22,209,261,70,52
"18498",2010-08-23,206,244,14,38
"18499",2010-08-24,172,206,597,34
"18500",2010-08-25,190,218,42,28
"18501",2010-08-26,197,243,23,46
"18502",2010-08-27,192,277,0,85
"18503",2010-08-28,172,299,0,127
"18504",2010-08-29,192,314,0,122
"18505",2010-08-30,204,305,0,101
"18506",2010-08-31,229,292,0,63
"18507",2010-09-01,211,297,0,86
"18508",2010-09-02,241,278,0,37
"18509",2010-09-03,218,287,3,69
"18510",2010-09-04,224,292,0,68
"18511",2010-09-05,221,269,540,48
"18512",2010-09-06,207,229,385,22
"18513",2010-09-07,200,226,291,26
"18514",2010-09-08,196,241,11,45
"18515",2010-09-09,187,251,7,64
"18516",2010-09-10,179,304,14,125
"18517",2010-09-11,191,319,0,128
"18518",2010-09-12,202,324,0,122
"18519",2010-09-13,194,306,0,112
"18520",2010-09-14,206,288,0,82
"18521",2010-09-15,220,296,0,76
"18522",2010-09-16,233,298,0,65
"18523",2010-09-17,262,337,0,75
"18524",2010-09-18,186,306,0,120
"18525",2010-09-19,170,207,58,37
"18526",2010-09-20,181,259,0,78
"18527",2010-09-21,161,247,0,86
"18528",2010-09-22,135,204,0,69
"18529",2010-09-23,111,242,0,131
"18530",2010-09-24,128,180,10,52
"18531",2010-09-25,127,163,92,36
"18532",2010-09-26,132,223,0,91
"18533",2010-09-27,146,267,0,121
"18534",2010-09-28,164,198,0,34
"18535",2010-09-29,143,216,0,73
"18536",2010-09-30,116,259,0,143
"18537",2010-10-01,176,252,0,76
"18538",2010-10-02,179,267,6,88
"18539",2010-10-03,156,252,0,96
"18540",2010-10-04,106,263,0,157
"18541",2010-10-05,107,288,0,181
"18542",2010-10-06,125,275,0,150
"18543",2010-10-07,172,261,0,89
"18544",2010-10-08,132,252,0,120
"18545",2010-10-09,135,266,0,131
"18546",2010-10-10,163,253,0,90
"18547",2010-10-11,169,223,11,54
"18548",2010-10-12,147,189,0,42
"18549",2010-10-13,133,225,11,92
"18550",2010-10-14,145,237,0,92
"18551",2010-10-15,140,262,0,122
"18552",2010-10-16,107,267,0,160
"18553",2010-10-17,143,203,0,60
"18554",2010-10-18,120,190,0,70
"18555",2010-10-19,104,170,0,66
"18556",2010-10-20,111,154,0,43
"18557",2010-10-21,105,175,0,70
"18558",2010-10-22,81,221,0,140
"18559",2010-10-23,84,222,0,138
"18560",2010-10-24,108,219,0,111
"18561",2010-10-25,82,178,0,96
"18562",2010-10-26,66,102,0,36
"18563",2010-10-27,58,159,0,101
"18564",2010-10-28,42,164,0,122
"18565",2010-10-29,41,190,0,149
"18566",2010-10-30,47,211,0,164
"18567",2010-10-31,56,217,0,161
"18568",2010-11-01,79,178,2,99
"18569",2010-11-02,75,137,13,62
"18570",2010-11-03,35,204,0,169
"18571",2010-11-04,56,223,0,167
"18572",2010-11-05,55,216,0,161
"18573",2010-11-06,55,228,0,173
"18574",2010-11-07,121,204,0,83
"18575",2010-11-08,36,202,0,166
"18576",2010-11-09,40,229,0,189
"18577",2010-11-10,55,237,0,182
"18578",2010-11-11,110,204,0,94
"18579",2010-11-12,48,183,0,135
"18580",2010-11-13,108,153,0,45
"18581",2010-11-14,71,108,0,37
"18582",2010-11-15,19,108,0,89
"18583",2010-11-16,-6,174,0,180
"18584",2010-11-17,26,178,0,152
"18585",2010-11-18,32,182,0,150
"18586",2010-11-19,53,201,0,148
"18587",2010-11-20,38,218,0,180
"18588",2010-11-21,75,178,0,103
"18589",2010-11-22,8,134,0,126
"18590",2010-11-23,61,134,0,73
"18591",2010-11-24,34,179,0,145
"18592",2010-11-25,27,137,0,110
"18593",2010-11-26,9,187,0,178
"18594",2010-11-27,42,139,0,97
"18595",2010-11-28,17,179,0,162
"18596",2010-11-29,8,217,0,209
"18597",2010-11-30,31,205,0,174
"18598",2010-12-01,30,218,0,188
"18599",2010-12-02,56,169,0,113
"18600",2010-12-03,1,142,0,141
"18601",2010-12-04,31,192,0,161
"18602",2010-12-05,48,152,0,104
"18603",2010-12-06,40,129,0,89
"18604",2010-12-07,3,121,0,118
"18605",2010-12-08,21,154,0,133
"18606",2010-12-09,8,150,0,142
"18607",2010-12-10,25,162,0,137
"18608",2010-12-11,14,123,0,109
"18609",2010-12-12,5,83,0,78
"18610",2010-12-13,-15,79,0,94
"18611",2010-12-14,-31,15,0,46
"18612",2010-12-15,-24,8,0,32
"18613",2010-12-16,-22,57,0,79
"18614",2010-12-17,16,137,0,121
"18615",2010-12-18,-22,177,0,199
"18616",2010-12-19,31,157,0,126
"18617",2010-12-20,-17,154,0,171
"18618",2010-12-21,0,167,0,167
"18619",2010-12-22,19,182,0,163
"18620",2010-12-23,-12,114,0,126
"18621",2010-12-24,-38,-12,0,26
"18622",2010-12-25,-50,57,0,107
"18623",2010-12-26,-48,98,0,146
"18624",2010-12-27,-31,142,0,173
"18625",2010-12-28,11,115,0,104
"18626",2010-12-29,-6,101,0,107
"18627",2010-12-30,-15,42,0,57
"18628",2010-12-31,-37,30,0,67
"18629",2011-01-01,-68,7,0,75
"18630",2011-01-02,-37,1,0,38
"18631",2011-01-03,-60,9,0,69
"18632",2011-01-04,-58,39,0,97
"18633",2011-01-05,-46,21,0,67
"18634",2011-01-06,-54,16,0,70
"18635",2011-01-07,-79,42,0,121
"18636",2011-01-08,-61,70,0,131
"18637",2011-01-09,-49,18,0,67
"18638",2011-01-10,-77,45,0,122
"18639",2011-01-11,-12,51,0,63
"18640",2011-01-12,-76,64,0,140
"18641",2011-01-13,-28,99,0,127
"18642",2011-01-14,-23,47,0,70
"18643",2011-01-15,-47,24,0,71
"18644",2011-01-16,-84,13,0,97
"18645",2011-01-17,-62,27,0,89
"18646",2011-01-18,-46,21,0,67
"18647",2011-01-19,-66,31,0,97
"18648",2011-01-20,-48,17,0,65
"18649",2011-01-21,-67,47,0,114
"18650",2011-01-22,-60,78,0,138
"18651",2011-01-23,-29,63,0,92
"18652",2011-01-24,-85,56,0,141
"18653",2011-01-25,-58,52,0,110
"18654",2011-01-26,-57,26,0,83
"18655",2011-01-27,-46,29,0,75
"18656",2011-01-28,-48,45,0,93
"18657",2011-01-29,-38,44,0,82
"18658",2011-01-30,-78,70,0,148
"18659",2011-01-31,-65,97,0,162
"18660",2011-02-01,-22,104,0,126
"18661",2011-02-02,-53,140,0,193
"18662",2011-02-03,-21,96,0,117
"18663",2011-02-04,-36,123,0,159
"18664",2011-02-05,-40,130,0,170
"18665",2011-02-06,3,127,0,124
"18666",2011-02-07,24,108,0,84
"18667",2011-02-08,-18,93,0,111
"18668",2011-02-09,-7,66,37,73
"18669",2011-02-10,-14,29,23,43
"18670",2011-02-11,10,84,0,74
"18671",2011-02-12,-27,40,0,67
"18672",2011-02-13,-19,35,0,54
"18673",2011-02-14,-75,30,0,105
"18674",2011-02-15,-56,18,1,74
"18675",2011-02-16,-15,83,0,98
"18676",2011-02-17,-11,85,0,96
"18677",2011-02-18,2,86,0,84
"18678",2011-02-19,-6,102,0,108
"18679",2011-02-20,-14,113,0,127
"18680",2011-02-21,-17,118,0,135
"18681",2011-02-22,59,153,0,94
"18682",2011-02-23,10,187,0,177
"18683",2011-02-24,44,140,0,96
"18684",2011-02-25,45,103,0,58
"18685",2011-02-26,8,45,113,37
"18686",2011-02-27,2,27,18,25
"18687",2011-02-28,-10,7,79,17
"18688",2011-03-01,-10,39,2,49
"18689",2011-03-02,-21,94,0,115
"18690",2011-03-03,15,99,0,84
"18691",2011-03-04,-28,94,0,122
"18692",2011-03-05,22,152,0,130
"18693",2011-03-06,31,121,0,90
"18694",2011-03-07,0,184,0,184
"18695",2011-03-08,26,163,0,137
"18696",2011-03-09,64,149,0,85
"18697",2011-03-10,5,184,0,179
"18698",2011-03-11,28,184,0,156
"18699",2011-03-12,49,254,0,205
"18700",2011-03-13,102,194,0,92
"18701",2011-03-14,77,159,0,82
"18702",2011-03-15,59,131,0,72
"18703",2011-03-16,61,166,0,105
"18704",2011-03-17,40,195,0,155
"18705",2011-03-18,89,192,0,103
"18706",2011-03-19,101,154,2,53
"18707",2011-03-20,58,110,12,52
"18708",2011-03-21,68,127,12,59
"18709",2011-03-22,53,135,0,82
"18710",2011-03-23,42,158,0,116
"18711",2011-03-24,60,135,0,75
"18712",2011-03-25,31,163,0,132
"18713",2011-03-26,44,187,0,143
"18714",2011-03-27,53,185,0,132
"18715",2011-03-28,54,211,0,157
"18716",2011-03-29,44,192,0,148
"18717",2011-03-30,77,221,0,144
"18718",2011-03-31,89,241,0,152
"18719",2011-04-01,103,240,0,137
"18720",2011-04-02,22,103,80,81
"18721",2011-04-03,35,134,0,99
"18722",2011-04-04,13,161,0,148
"18723",2011-04-05,36,175,0,139
"18724",2011-04-06,101,180,9,79
"18725",2011-04-07,74,214,0,140
"18726",2011-04-08,87,216,0,129
"18727",2011-04-09,96,279,0,183
"18728",2011-04-10,115,218,0,103
"18729",2011-04-11,41,204,0,163
"18730",2011-04-12,83,225,0,142
"18731",2011-04-13,107,260,0,153
"18732",2011-04-14,136,285,0,149
"18733",2011-04-15,162,298,0,136
"18734",2011-04-16,151,228,0,77
"18735",2011-04-17,131,247,0,116
"18736",2011-04-18,131,230,0,99
"18737",2011-04-19,118,227,0,109
"18738",2011-04-20,118,248,9,130
"18739",2011-04-21,155,241,53,86
"18740",2011-04-22,110,232,4,122
"18741",2011-04-23,116,263,0,147
"18742",2011-04-24,103,251,0,148
"18743",2011-04-25,122,353,0,231
"18744",2011-04-26,169,321,0,152
"18745",2011-04-27,145,275,0,130
"18746",2011-04-28,158,268,0,110
"18747",2011-04-29,174,349,0,175
"18748",2011-04-30,198,317,0,119
"18749",2011-05-01,150,254,0,104
"18750",2011-05-02,152,202,0,50
"18751",2011-05-03,121,249,0,128
"18752",2011-05-04,162,247,0,85
"18753",2011-05-05,159,285,0,126
"18754",2011-05-06,176,277,0,101
"18755",2011-05-07,188,277,0,89
"18756",2011-05-08,164,234,0,70
"18757",2011-05-09,141,181,58,40
"18758",2011-05-10,141,181,239,40
"18759",2011-05-11,104,285,0,181
"18760",2011-05-12,196,272,0,76
"18761",2011-05-13,162,272,0,110
"18762",2011-05-14,205,303,0,98
"18763",2011-05-15,164,320,0,156
"18764",2011-05-16,195,275,0,80
"18765",2011-05-17,186,329,0,143
"18766",2011-05-18,199,376,0,177
"18767",2011-05-19,229,315,0,86
"18768",2011-05-20,164,228,6,64
"18769",2011-05-21,128,217,54,89
"18770",2011-05-22,153,206,0,53
"18771",2011-05-23,108,241,0,133
"18772",2011-05-24,154,228,0,74
"18773",2011-05-25,161,253,0,92
"18774",2011-05-26,146,283,0,137
"18775",2011-05-27,177,299,0,122
"18776",2011-05-28,193,315,0,122
"18777",2011-05-29,214,268,0,54
"18778",2011-05-30,198,311,0,113
"18779",2011-05-31,258,349,0,91
"18780",2011-06-01,183,328,0,145
"18781",2011-06-02,188,344,0,156
"18782",2011-06-03,199,355,0,156
"18783",2011-06-04,203,306,0,103
"18784",2011-06-05,226,332,0,106
"18785",2011-06-06,235,344,0,109
"18786",2011-06-07,217,405,8,188
"18787",2011-06-08,263,425,0,162
"18788",2011-06-09,272,332,0,60
"18789",2011-06-10,246,341,0,95
"18790",2011-06-11,226,354,0,128
"18791",2011-06-12,248,329,0,81
"18792",2011-06-13,206,343,0,137
"18793",2011-06-14,241,301,0,60
"18794",2011-06-15,218,319,0,101
"18795",2011-06-16,231,308,0,77
"18796",2011-06-17,233,276,0,43
"18797",2011-06-18,227,318,10,91
"18798",2011-06-19,226,356,0,130
"18799",2011-06-20,235,329,0,94
"18800",2011-06-21,253,323,0,70
"18801",2011-06-22,263,314,0,51
"18802",2011-06-23,245,297,18,52
"18803",2011-06-24,211,318,0,107
"18804",2011-06-25,196,269,0,73
"18805",2011-06-26,213,328,0,115
"18806",2011-06-27,234,303,0,69
"18807",2011-06-28,220,352,0,132
"18808",2011-06-29,239,352,0,113
"18809",2011-06-30,270,380,0,110
"18810",2011-07-01,273,352,0,79
"18811",2011-07-02,268,372,0,104
"18812",2011-07-03,231,268,24,37
"18813",2011-07-04,247,279,29,32
"18814",2011-07-05,231,353,0,122
"18815",2011-07-06,233,313,46,80
"18816",2011-07-07,229,340,5,111
"18817",2011-07-08,198,389,0,191
"18818",2011-07-09,245,358,0,113
"18819",2011-07-10,253,368,0,115
"18820",2011-07-11,270,354,0,84
"18821",2011-07-12,276,343,0,67
"18822",2011-07-13,267,330,0,63
"18823",2011-07-14,247,341,0,94
"18824",2011-07-15,243,330,0,87
"18825",2011-07-16,218,332,0,114
"18826",2011-07-17,230,328,0,98
"18827",2011-07-18,251,304,0,53
"18828",2011-07-19,242,317,0,75
"18829",2011-07-20,240,320,0,80
"18830",2011-07-21,239,331,223,92
"18831",2011-07-22,266,344,0,78
"18832",2011-07-23,255,363,1,108
"18833",2011-07-24,263,360,9,97
"18834",2011-07-25,254,390,5,136
"18835",2011-07-26,222,384,284,162
"18836",2011-07-27,244,334,0,90
"18837",2011-07-28,252,354,0,102
"18838",2011-07-29,260,334,61,74
"18839",2011-07-30,240,319,5,79
"18840",2011-07-31,242,314,0,72
"18841",2011-08-01,198,287,156,89
"18842",2011-08-02,200,208,275,8
"18843",2011-08-03,189,296,6,107
"18844",2011-08-04,208,291,0,83
"18845",2011-08-05,235,283,0,48
"18846",2011-08-06,224,291,213,67
"18847",2011-08-07,231,293,0,62
"18848",2011-08-08,229,329,0,100
"18849",2011-08-09,239,353,0,114
"18850",2011-08-10,249,323,0,74
"18851",2011-08-11,249,319,0,70
"18852",2011-08-12,252,332,0,80
"18853",2011-08-13,259,339,0,80
"18854",2011-08-14,277,352,0,75
"18855",2011-08-15,292,349,0,57
"18856",2011-08-16,270,322,104,52
"18857",2011-08-17,251,297,0,46
"18858",2011-08-18,203,256,11,53
"18859",2011-08-19,206,228,0,22
"18860",2011-08-20,196,212,303,16
"18861",2011-08-21,200,209,302,9
"18862",2011-08-22,197,266,0,69
"18863",2011-08-23,205,278,0,73
"18864",2011-08-24,184,299,0,115
"18865",2011-08-25,191,303,0,112
"18866",2011-08-26,211,285,0,74
"18867",2011-08-27,200,284,0,84
"18868",2011-08-28,204,298,0,94
"18869",2011-08-29,200,309,0,109
"18870",2011-08-30,208,316,0,108
"18871",2011-08-31,206,331,0,125
"18872",2011-09-01,216,315,0,99
"18873",2011-09-02,214,275,0,61
"18874",2011-09-03,216,259,0,43
"18875",2011-09-04,181,216,147,35
"18876",2011-09-05,197,217,60,20
"18877",2011-09-06,186,202,33,16
"18878",2011-09-07,165,191,141,26
"18879",2011-09-08,174,222,0,48
"18880",2011-09-09,155,228,0,73
"18881",2011-09-10,168,222,1,54
"18882",2011-09-11,143,168,252,25
"18883",2011-09-12,156,181,186,25
"18884",2011-09-13,171,187,271,16
"18885",2011-09-14,173,201,554,28
"18886",2011-09-15,183,250,297,67
"18887",2011-09-16,170,260,0,90
"18888",2011-09-17,135,238,158,103
"18889",2011-09-18,120,149,22,29
"18890",2011-09-19,101,196,57,95
"18891",2011-09-20,140,232,0,92
"18892",2011-09-21,111,260,0,149
"18893",2011-09-22,126,281,0,155
"18894",2011-09-23,120,281,0,161
"18895",2011-09-24,126,285,0,159
"18896",2011-09-25,137,282,0,145
"18897",2011-09-26,148,256,0,108
"18898",2011-09-27,168,232,21,64
"18899",2011-09-28,158,201,334,43
"18900",2011-09-29,167,225,0,58
"18901",2011-09-30,142,233,0,91
"18902",2011-10-01,141,214,0,73
"18903",2011-10-02,133,198,0,65
"18904",2011-10-03,94,217,0,123
"18905",2011-10-04,135,197,0,62
"18906",2011-10-05,116,269,0,153
"18907",2011-10-06,122,273,0,151
"18908",2011-10-07,129,277,0,148
"18909",2011-10-08,147,266,0,119
"18910",2011-10-09,177,218,8,41
"18911",2011-10-10,165,185,6,20
"18912",2011-10-11,162,190,13,28
"18913",2011-10-12,151,176,98,25
"18914",2011-10-13,144,241,0,97
"18915",2011-10-14,103,238,0,135
"18916",2011-10-15,145,230,0,85
"18917",2011-10-16,142,269,0,127
"18918",2011-10-17,117,260,0,143
"18919",2011-10-18,106,257,0,151
"18920",2011-10-19,138,236,0,98
"18921",2011-10-20,153,216,0,63
"18922",2011-10-21,108,219,0,111
"18923",2011-10-22,114,199,57,85
"18924",2011-10-23,142,159,210,17
"18925",2011-10-24,88,159,0,71
"18926",2011-10-25,28,149,0,121
"18927",2011-10-26,52,152,0,100
"18928",2011-10-27,63,173,0,110
"18929",2011-10-28,93,180,0,87
"18930",2011-10-29,66,180,0,114
"18931",2011-10-30,115,159,0,44
"18932",2011-10-31,110,189,0,79
"18933",2011-11-01,125,177,0,52
"18934",2011-11-02,125,187,0,62
"18935",2011-11-03,113,167,2,54
"18936",2011-11-04,122,149,31,27
"18937",2011-11-05,128,145,15,17
"18938",2011-11-06,104,135,33,31
"18939",2011-11-07,85,117,281,32
"18940",2011-11-08,83,112,36,29
"18941",2011-11-09,49,160,0,111
"18942",2011-11-10,39,146,0,107
"18943",2011-11-11,43,167,0,124
"18944",2011-11-12,112,175,0,63
"18945",2011-11-13,71,179,0,108
"18946",2011-11-14,42,162,0,120
"18947",2011-11-15,95,136,20,41
"18948",2011-11-16,99,119,101,20
"18949",2011-11-17,90,102,80,12
"18950",2011-11-18,96,143,221,47
"18951",2011-11-19,71,144,0,73
"18952",2011-11-20,23,116,0,93
"18953",2011-11-21,41,107,0,66
"18954",2011-11-22,66,164,25,98
"18955",2011-11-23,45,145,0,100
"18956",2011-11-24,5,106,0,101
"18957",2011-11-25,33,70,0,37
"18958",2011-11-26,16,125,0,109
"18959",2011-11-27,29,109,0,80
"18960",2011-11-28,64,91,166,27
"18961",2011-11-29,9,83,161,74
"18962",2011-11-30,12,46,0,34
"18963",2011-12-01,-29,57,0,86
"18964",2011-12-02,-14,68,0,82
"18965",2011-12-03,2,56,0,54
"18966",2011-12-04,19,71,1,52
"18967",2011-12-05,19,57,34,38
"18968",2011-12-06,20,38,6,18
"18969",2011-12-07,31,89,17,58
"18970",2011-12-08,6,56,0,50
"18971",2011-12-09,-48,34,0,82
"18972",2011-12-10,-18,66,0,84
"18973",2011-12-11,-8,95,0,103
"18974",2011-12-12,-24,103,0,127
"18975",2011-12-13,-13,108,0,121
"18976",2011-12-14,7,84,0,77
"18977",2011-12-15,-34,57,0,91
"18978",2011-12-16,-47,36,0,83
"18979",2011-12-17,-49,56,0,105
"18980",2011-12-18,-15,72,0,87
"18981",2011-12-19,-37,72,0,109
"18982",2011-12-20,-21,32,0,53
"18983",2011-12-21,-20,84,0,104
"18984",2011-12-22,-16,62,0,78
"18985",2011-12-23,-34,84,0,118
"18986",2011-12-24,-21,89,0,110
"18987",2011-12-25,-7,103,0,110
"18988",2011-12-26,-29,64,0,93
"18989",2011-12-27,-31,61,0,92
"18990",2011-12-28,-32,81,0,113
"18991",2011-12-29,-2,33,0,35
"18992",2011-12-30,1,51,0,50
"18993",2011-12-31,-23,58,0,81
"18994",2012-01-01,-17,4,0,21
"18995",2012-01-02,-6,89,0,95
"18996",2012-01-03,-3,57,0,60
"18997",2012-01-04,-28,44,0,72
"18998",2012-01-05,-68,52,0,120
"18999",2012-01-06,-53,33,0,86
"19000",2012-01-07,-51,23,0,74
"19001",2012-01-08,-42,66,0,108
"19002",2012-01-09,-39,61,0,100
"19003",2012-01-10,-30,46,0,76
"19004",2012-01-11,-32,31,0,63
"19005",2012-01-12,-46,61,0,107
"19006",2012-01-13,-37,47,0,84
"19007",2012-01-14,-23,45,0,68
"19008",2012-01-15,-9,56,0,65
"19009",2012-01-16,-32,25,7,57
"19010",2012-01-17,5,31,0,26
"19011",2012-01-18,4,24,7,20
"19012",2012-01-19,14,38,4,24
"19013",2012-01-20,-3,34,0,37
"19014",2012-01-21,-43,-3,0,40
"19015",2012-01-22,-56,-9,0,47
"19016",2012-01-23,-71,13,0,84
"19017",2012-01-24,-42,34,0,76
"19018",2012-01-25,-52,78,0,130
"19019",2012-01-26,-56,86,0,142
"19020",2012-01-27,-43,71,0,114
"19021",2012-01-28,-23,60,0,83
"19022",2012-01-29,-10,28,0,38
"19023",2012-01-30,-17,48,0,65
"19024",2012-01-31,-38,131,0,169
"19025",2012-02-01,-31,14,0,45
"19026",2012-02-02,-64,26,0,90
"19027",2012-02-03,-56,77,0,133
"19028",2012-02-04,-24,39,0,63
"19029",2012-02-05,-28,102,0,130
"19030",2012-02-06,1,78,0,77
"19031",2012-02-07,-53,39,0,92
"19032",2012-02-08,-31,47,0,78
"19033",2012-02-09,-14,49,0,63
"19034",2012-02-10,-23,69,0,92
"19035",2012-02-11,-51,100,0,151
"19036",2012-02-12,8,62,0,54
"19037",2012-02-13,-9,78,0,87
"19038",2012-02-14,-16,90,0,106
"19039",2012-02-15,22,56,0,34
"19040",2012-02-16,-17,56,0,73
"19041",2012-02-17,-29,79,0,108
"19042",2012-02-18,-32,84,0,116
"19043",2012-02-19,-44,114,0,158
"19044",2012-02-20,12,133,0,121
"19045",2012-02-21,55,118,0,63
"19046",2012-02-22,21,151,0,130
"19047",2012-02-23,29,106,0,77
"19048",2012-02-24,27,75,0,48
"19049",2012-02-25,21,62,0,41
"19050",2012-02-26,-13,67,0,80
"19051",2012-02-27,-26,86,0,112
"19052",2012-02-28,-3,97,0,100
"19053",2012-02-29,38,86,0,48
"19054",2012-03-01,43,64,48,21
"19055",2012-03-02,26,44,2,18
"19056",2012-03-03,0,36,2,36
"19057",2012-03-04,13,59,0,46
"19058",2012-03-05,32,114,0,82
"19059",2012-03-06,70,122,0,52
"19060",2012-03-07,43,133,0,90
"19061",2012-03-08,38,104,0,66
"19062",2012-03-09,15,102,0,87
"19063",2012-03-10,16,177,0,161
"19064",2012-03-11,-3,109,0,112
"19065",2012-03-12,-6,94,0,100
"19066",2012-03-13,1,180,0,179
"19067",2012-03-14,53,145,0,92
"19068",2012-03-15,64,111,14,47
"19069",2012-03-16,55,182,0,127
"19070",2012-03-17,50,196,0,146
"19071",2012-03-18,42,146,0,104
"19072",2012-03-19,15,42,0,27
"19073",2012-03-20,28,82,0,54
"19074",2012-03-21,3,62,79,59
"19075",2012-03-22,32,65,20,33
"19076",2012-03-23,46,151,4,105
"19077",2012-03-24,29,214,0,185
"19078",2012-03-25,47,199,0,152
"19079",2012-03-26,75,239,0,164
"19080",2012-03-27,94,272,0,178
"19081",2012-03-28,96,244,0,148
"19082",2012-03-29,153,229,0,76
"19083",2012-03-30,140,191,0,51
"19084",2012-03-31,97,238,0,141
"19085",2012-04-01,124,237,0,113
"19086",2012-04-02,80,178,2,98
"19087",2012-04-03,45,217,0,172
"19088",2012-04-04,87,259,0,172
"19089",2012-04-05,103,250,0,147
"19090",2012-04-06,134,254,0,120
"19091",2012-04-07,120,279,0,159
"19092",2012-04-08,116,291,0,175
"19093",2012-04-09,148,228,7,80
"19094",2012-04-10,149,238,0,89
"19095",2012-04-11,143,209,0,66
"19096",2012-04-12,113,151,10,38
"19097",2012-04-13,137,265,0,128
"19098",2012-04-14,118,245,0,127
"19099",2012-04-15,96,267,0,171
"19100",2012-04-16,134,193,0,59
"19101",2012-04-17,137,237,0,100
"19102",2012-04-18,160,237,0,77
"19103",2012-04-19,144,253,0,109
"19104",2012-04-20,161,220,32,59
"19105",2012-04-21,137,211,0,74
"19106",2012-04-22,139,265,0,126
"19107",2012-04-23,171,284,0,113
"19108",2012-04-24,151,257,480,106
"19109",2012-04-25,126,234,2,108
"19110",2012-04-26,103,261,0,158
"19111",2012-04-27,145,320,0,175
"19112",2012-04-28,174,251,0,77
"19113",2012-04-29,147,239,0,92
"19114",2012-04-30,169,221,0,52
"19115",2012-05-01,185,253,0,68
"19116",2012-05-02,160,275,0,115
"19117",2012-05-03,187,285,0,98
"19118",2012-05-04,179,306,0,127
"19119",2012-05-05,173,303,0,130
"19120",2012-05-06,180,331,0,151
"19121",2012-05-07,217,273,1,56
"19122",2012-05-08,189,285,0,96
"19123",2012-05-09,200,293,0,93
"19124",2012-05-10,205,306,0,101
"19125",2012-05-11,200,275,0,75
"19126",2012-05-12,197,244,116,47
"19127",2012-05-13,145,260,0,115
"19128",2012-05-14,206,295,0,89
"19129",2012-05-15,163,301,0,138
"19130",2012-05-16,136,308,0,172
"19131",2012-05-17,168,329,0,161
"19132",2012-05-18,198,302,0,104
"19133",2012-05-19,191,307,0,116
"19134",2012-05-20,203,289,0,86
"19135",2012-05-21,179,255,0,76
"19136",2012-05-22,204,232,5,28
"19137",2012-05-23,175,265,0,90
"19138",2012-05-24,204,273,0,69
"19139",2012-05-25,173,296,0,123
"19140",2012-05-26,180,320,0,140
"19141",2012-05-27,198,319,0,121
"19142",2012-05-28,209,317,0,108
"19143",2012-05-29,203,275,2,72
"19144",2012-05-30,163,281,0,118
"19145",2012-05-31,195,269,0,74
"19146",2012-06-01,217,284,0,67
"19147",2012-06-02,190,315,0,125
"19148",2012-06-03,224,290,0,66
"19149",2012-06-04,191,321,0,130
"19150",2012-06-05,199,333,0,134
"19151",2012-06-06,234,290,0,56
"19152",2012-06-07,200,331,0,131
"19153",2012-06-08,234,347,0,113
"19154",2012-06-09,239,380,0,141
"19155",2012-06-10,250,333,0,83
"19156",2012-06-11,200,341,0,141
"19157",2012-06-12,204,380,0,176
"19158",2012-06-13,224,410,0,186
"19159",2012-06-14,250,356,0,106
"19160",2012-06-15,211,347,0,136
"19161",2012-06-16,208,349,0,141
"19162",2012-06-17,233,353,0,120
"19163",2012-06-18,232,360,0,128
"19164",2012-06-19,230,351,0,121
"19165",2012-06-20,243,350,0,107
"19166",2012-06-21,254,360,0,106
"19167",2012-06-22,251,368,0,117
"19168",2012-06-23,258,357,3,99
"19169",2012-06-24,248,348,0,100
"19170",2012-06-25,238,301,16,63
"19171",2012-06-26,231,312,10,81
"19172",2012-06-27,226,287,0,61
"19173",2012-06-28,226,265,4,39
"19174",2012-06-29,225,252,39,27
"19175",2012-06-30,225,321,0,96
"19176",2012-07-01,210,358,0,148
"19177",2012-07-02,239,320,2,81
"19178",2012-07-03,209,370,0,161
"19179",2012-07-04,233,307,462,74
"19180",2012-07-05,217,295,15,78
"19181",2012-07-06,219,323,0,104
"19182",2012-07-07,253,284,43,31
"19183",2012-07-08,245,300,5,55
"19184",2012-07-09,252,287,152,35
"19185",2012-07-10,250,332,142,82
"19186",2012-07-11,253,389,0,136
"19187",2012-07-12,289,386,0,97
"19188",2012-07-13,243,338,30,95
"19189",2012-07-14,234,286,0,52
"19190",2012-07-15,223,306,0,83
"19191",2012-07-16,233,318,0,85
"19192",2012-07-17,240,315,0,75
"19193",2012-07-18,247,318,0,71
"19194",2012-07-19,231,336,0,105
"19195",2012-07-20,252,340,0,88
"19196",2012-07-21,271,350,0,79
"19197",2012-07-22,265,326,3,61
"19198",2012-07-23,239,342,0,103
"19199",2012-07-24,269,342,0,73
"19200",2012-07-25,253,359,9,106
"19201",2012-07-26,271,365,0,94
"19202",2012-07-27,285,369,0,84
"19203",2012-07-28,270,364,0,94
"19204",2012-07-29,290,384,0,94
"19205",2012-07-30,284,364,0,80
"19206",2012-07-31,250,331,28,81
"19207",2012-08-01,209,269,292,60
"19208",2012-08-02,234,303,0,69
"19209",2012-08-03,244,317,0,73
"19210",2012-08-04,249,287,22,38
"19211",2012-08-05,240,270,326,30
"19212",2012-08-06,242,311,0,69
"19213",2012-08-07,229,322,0,93
"19214",2012-08-08,225,331,0,106
"19215",2012-08-09,257,314,0,57
"19216",2012-08-10,247,313,0,66
"19217",2012-08-11,258,325,3,67
"19218",2012-08-12,249,323,0,74
"19219",2012-08-13,226,249,5,23
"19220",2012-08-14,223,282,0,59
"19221",2012-08-15,189,316,0,127
"19222",2012-08-16,204,302,0,98
"19223",2012-08-17,234,314,0,80
"19224",2012-08-18,258,317,27,59
"19225",2012-08-19,236,326,0,90
"19226",2012-08-20,224,290,731,66
"19227",2012-08-21,231,281,17,50
"19228",2012-08-22,188,288,0,100
"19229",2012-08-23,142,282,0,140
"19230",2012-08-24,161,283,0,122
"19231",2012-08-25,175,296,0,121
"19232",2012-08-26,202,297,7,95
"19233",2012-08-27,223,268,290,45
"19234",2012-08-28,221,309,0,88
"19235",2012-08-29,211,360,0,149
"19236",2012-08-30,227,324,0,97
"19237",2012-08-31,246,283,21,37
"19238",2012-09-01,225,284,155,59
"19239",2012-09-02,200,270,124,70
"19240",2012-09-03,199,303,0,104
"19241",2012-09-04,177,272,0,95
"19242",2012-09-05,192,296,0,104
"19243",2012-09-06,205,290,0,85
"19244",2012-09-07,197,275,0,78
"19245",2012-09-08,207,266,10,59
"19246",2012-09-09,185,283,0,98
"19247",2012-09-10,186,263,0,77
"19248",2012-09-11,199,238,272,39
"19249",2012-09-12,187,226,0,39
"19250",2012-09-13,159,263,0,104
"19251",2012-09-14,153,267,0,114
"19252",2012-09-15,138,265,0,127
"19253",2012-09-16,142,254,0,112
"19254",2012-09-17,151,273,0,122
"19255",2012-09-18,167,290,0,123
"19256",2012-09-19,176,299,0,123
"19257",2012-09-20,151,255,0,104
"19258",2012-09-21,192,233,0,41
"19259",2012-09-22,190,281,2,91
"19260",2012-09-23,180,285,0,105
"19261",2012-09-24,197,261,0,64
"19262",2012-09-25,198,260,53,62
"19263",2012-09-26,197,220,436,23
"19264",2012-09-27,163,277,0,114
"19265",2012-09-28,142,249,0,107
"19266",2012-09-29,114,254,0,140
"19267",2012-09-30,113,269,0,156
"19268",2012-10-01,112,280,0,168
"19269",2012-10-02,115,276,0,161
"19270",2012-10-03,156,294,0,138
"19271",2012-10-04,154,246,0,92
"19272",2012-10-05,185,242,0,57
"19273",2012-10-06,138,252,0,114
"19274",2012-10-07,172,235,0,63
"19275",2012-10-08,138,252,0,114
"19276",2012-10-09,191,267,0,76
"19277",2012-10-10,146,227,0,81
"19278",2012-10-11,127,249,0,122
"19279",2012-10-12,134,250,0,116
"19280",2012-10-13,130,266,0,136
"19281",2012-10-14,146,226,0,80
"19282",2012-10-15,168,203,0,35
"19283",2012-10-16,142,200,134,58
"19284",2012-10-17,103,210,0,107
"19285",2012-10-18,72,225,0,153
"19286",2012-10-19,132,230,0,98
"19287",2012-10-20,111,247,0,136
"19288",2012-10-21,130,208,6,78
"19289",2012-10-22,132,210,13,78
"19290",2012-10-23,65,229,0,164
"19291",2012-10-24,115,242,0,127
"19292",2012-10-25,79,230,0,151
"19293",2012-10-26,110,187,0,77
"19294",2012-10-27,94,254,0,160
"19295",2012-10-28,101,203,0,102
"19296",2012-10-29,128,171,27,43
"19297",2012-10-30,99,173,0,74
"19298",2012-10-31,91,179,0,88
"19299",2012-11-01,49,200,0,151
"19300",2012-11-02,92,203,0,111
"19301",2012-11-03,87,145,49,58
"19302",2012-11-04,53,115,0,62
"19303",2012-11-05,56,136,0,80
"19304",2012-11-06,10,178,0,168
"19305",2012-11-07,43,163,0,120
"19306",2012-11-08,78,138,1,60
"19307",2012-11-09,86,119,0,33
"19308",2012-11-10,85,128,15,43
"19309",2012-11-11,30,133,0,103
"19310",2012-11-12,8,161,0,153
"19311",2012-11-13,29,170,0,141
"19312",2012-11-14,14,120,0,106
"19313",2012-11-15,39,110,0,71
"19314",2012-11-16,73,142,3,69
"19315",2012-11-17,10,160,0,150
"19316",2012-11-18,36,187,0,151
"19317",2012-11-19,66,136,0,70
"19318",2012-11-20,46,126,0,80
"19319",2012-11-21,65,148,0,83
"19320",2012-11-22,57,136,0,79
"19321",2012-11-23,39,90,0,51
"19322",2012-11-24,-16,118,0,134
"19323",2012-11-25,55,108,48,53
"19324",2012-11-26,36,113,0,77
"19325",2012-11-27,-9,151,0,160
"19326",2012-11-28,60,123,0,63
"19327",2012-11-29,-12,89,0,101
"19328",2012-11-30,-15,66,0,81
"19329",2012-12-01,-3,26,0,29
"19330",2012-12-02,-18,45,0,63
"19331",2012-12-03,7,97,0,90
"19332",2012-12-04,-25,121,0,146
"19333",2012-12-05,16,100,0,84
"19334",2012-12-06,-31,93,0,124
"19335",2012-12-07,-22,102,0,124
"19336",2012-12-08,-17,65,0,82
"19337",2012-12-09,-57,59,0,116
"19338",2012-12-10,-49,62,0,111
"19339",2012-12-11,-45,25,0,70
"19340",2012-12-12,-59,24,0,83
"19341",2012-12-13,-6,25,63,31
"19342",2012-12-14,-6,50,0,56
"19343",2012-12-15,-25,22,0,47
"19344",2012-12-16,16,33,2,17
"19345",2012-12-17,13,32,0,19
"19346",2012-12-18,-6,33,0,39
"19347",2012-12-19,-20,30,0,50
"19348",2012-12-20,-16,16,11,32
"19349",2012-12-21,-45,2,10,47
"19350",2012-12-22,-22,43,0,65
"19351",2012-12-23,-55,21,0,76
"19352",2012-12-24,-76,26,0,102
"19353",2012-12-25,-49,-2,0,47
"19354",2012-12-26,-68,-7,0,61
"19355",2012-12-27,-32,5,5,37
"19356",2012-12-28,-4,25,0,29
"19357",2012-12-29,-7,38,0,45
"19358",2012-12-30,-31,46,0,77
"19359",2012-12-31,-62,81,0,143
"19360",2013-01-01,NA,NA,NA,NA
"19361",2013-01-02,NA,-21,NA,NA
"19362",2013-01-03,NA,-12,NA,NA
"19363",2013-01-04,NA,-1,NA,NA
"19364",2013-01-05,-93,18,NA,111
"19365",2013-01-06,-66,39,NA,105
"19366",2013-01-07,-51,NA,NA,NA
"19367",2013-01-08,NA,23,NA,NA
"19368",2013-01-09,NA,14,NA,NA
"19369",2013-01-10,-67,36,NA,103
"19370",2013-01-11,NA,NA,NA,NA
"19371",2013-01-12,-61,107,NA,168
"19372",2013-01-13,NA,27,NA,NA
"19373",2013-01-14,-63,50,NA,113
"19374",2013-01-15,NA,NA,NA,NA
"19375",2013-01-16,NA,-19,NA,NA
"19376",2013-01-17,NA,33,NA,NA
"19377",2013-01-18,-78,45,NA,123
"19378",2013-01-19,-47,NA,33,NA
"19379",2013-01-20,NA,0,18,NA
"19380",2013-01-21,NA,10,NA,NA
"19381",2013-01-22,NA,9,NA,NA
"19382",2013-01-23,-35,104,NA,139
"19383",2013-01-24,NA,112,NA,NA
"19384",2013-01-25,NA,NA,NA,NA
"19385",2013-01-26,NA,NA,NA,NA
"19386",2013-01-27,-48,91,NA,139
"19387",2013-01-28,-19,NA,NA,NA
"19388",2013-01-29,NA,33,NA,NA
"19389",2013-01-30,NA,NA,0,NA
"19390",2013-01-31,-2,24,5,26
"19391",2013-02-01,NA,73,0,NA
"19392",2013-02-02,-7,67,30,74
"19393",2013-02-03,NA,22,33,NA
"19394",2013-02-04,NA,22,13,NA
"19395",2013-02-05,NA,63,3,NA
"19396",2013-02-06,NA,37,0,NA
"19397",2013-02-07,NA,9,0,NA
"19398",2013-02-08,-52,11,NA,63
"19399",2013-02-09,-43,92,NA,135
"19400",2013-02-10,-31,NA,NA,NA
"19401",2013-02-11,NA,NA,3,NA
"19402",2013-02-12,NA,NA,NA,NA
"19403",2013-02-13,-33,116,NA,149
"19404",2013-02-14,NA,90,NA,NA
"19405",2013-02-15,-12,60,NA,72
"19406",2013-02-16,8,NA,NA,NA
"19407",2013-02-17,NA,NA,NA,NA
"19408",2013-02-18,NA,NA,NA,NA
"19409",2013-02-19,-28,81,NA,109
"19410",2013-02-20,-17,107,NA,124
"19411",2013-02-21,NA,91,NA,NA
"19412",2013-02-22,-3,NA,NA,NA
"19413",2013-02-23,-4,151,NA,155
"19414",2013-02-24,14,138,NA,124
"19415",2013-02-25,NA,85,NA,NA
"19416",2013-02-26,NA,94,NA,NA
"19417",2013-02-27,7,148,NA,141
"19418",2013-02-28,NA,157,NA,NA
"19419",2013-03-01,NA,71,NA,NA
"19420",2013-03-02,-3,95,NA,98
"19421",2013-03-03,10,NA,NA,NA
"19422",2013-03-04,59,NA,NA,NA
"19423",2013-03-05,48,231,NA,183
"19424",2013-03-06,76,NA,NA,NA
"19425",2013-03-07,82,282,NA,200
"19426",2013-03-08,107,328,NA,221
"19427",2013-03-09,NA,NA,NA,NA
"19428",2013-03-10,NA,106,23,NA
"19429",2013-03-11,NA,75,20,NA
"19430",2013-03-12,NA,157,0,NA
"19431",2013-03-13,NA,111,NA,NA
"19432",2013-03-14,NA,89,NA,NA
"19433",2013-03-15,26,150,NA,124
"19434",2013-03-16,73,145,3,72
"19435",2013-03-17,NA,221,0,NA
"19436",2013-03-18,NA,270,NA,NA
"19437",2013-03-19,NA,NA,NA,NA
"19438",2013-03-20,15,NA,NA,NA
"19439",2013-03-21,38,171,0,133
"19440",2013-03-22,NA,NA,0,NA
"19441",2013-03-23,59,177,NA,118
"19442",2013-03-24,NA,118,NA,NA
"19443",2013-03-25,NA,74,0,NA
"19444",2013-03-26,NA,120,15,NA
"19445",2013-03-27,38,239,NA,201
"19446",2013-03-28,NA,NA,NA,NA
"19447",2013-03-29,NA,NA,0,NA
"19448",2013-03-30,NA,131,8,NA
"19449",2013-03-31,40,155,0,115
"19450",2013-04-01,NA,NA,0,NA
"19451",2013-04-02,69,189,NA,120
"19452",2013-04-03,NA,198,5,NA
"19453",2013-04-04,79,NA,0,NA
"19454",2013-04-05,NA,135,79,NA
"19455",2013-04-06,NA,173,51,NA
"19456",2013-04-07,50,213,0,163
"19457",2013-04-08,NA,NA,NA,NA
"19458",2013-04-09,NA,NA,NA,NA
"19459",2013-04-10,48,182,NA,134
"19460",2013-04-11,55,231,NA,176
"19461",2013-04-12,71,283,NA,212
"19462",2013-04-13,124,313,NA,189
"19463",2013-04-14,174,274,NA,100
"19464",2013-04-15,145,332,NA,187
"19465",2013-04-16,NA,244,NA,NA
"19466",2013-04-17,124,221,NA,97
"19467",2013-04-18,NA,143,NA,NA
"19468",2013-04-19,NA,95,102,NA
"19469",2013-04-20,21,110,NA,89
"19470",2013-04-21,32,160,NA,128
"19471",2013-04-22,NA,99,104,NA
"19472",2013-04-23,73,198,NA,125
"19473",2013-04-24,NA,274,NA,NA
"19474",2013-04-25,NA,243,NA,NA
"19475",2013-04-26,110,279,NA,169
"19476",2013-04-27,NA,NA,NA,NA
"19477",2013-04-28,153,287,NA,134
"19478",2013-04-29,NA,213,NA,NA
"19479",2013-04-30,96,301,NA,205
"19480",2013-06-01,177,NA,NA,NA
"19481",2013-06-02,194,NA,NA,NA
"19482",2013-06-03,NA,NA,NA,NA
"19483",2013-06-04,NA,NA,NA,NA
"19484",2013-06-05,NA,NA,NA,NA
"19485",2013-06-06,NA,NA,NA,NA
"19486",2013-06-07,NA,NA,NA,NA
"19487",2013-06-08,NA,NA,NA,NA
"19488",2013-06-09,NA,NA,8,NA
"19489",2013-06-10,NA,NA,28,NA
"19490",2013-06-11,NA,287,5,NA
"19491",2013-06-12,149,NA,0,NA
"19492",2013-06-13,NA,NA,NA,NA
"19493",2013-06-14,204,NA,NA,NA
"19494",2013-06-15,NA,NA,NA,NA
"19495",2013-06-16,239,NA,NA,NA
"19496",2013-06-17,NA,NA,NA,NA
"19497",2013-06-18,NA,NA,NA,NA
"19498",2013-06-19,NA,NA,0,NA
"19499",2013-06-20,NA,NA,NA,NA
"19500",2013-06-21,NA,292,0,NA
"19501",2013-06-22,NA,NA,0,NA
"19502",2013-06-23,220,NA,NA,NA
"19503",2013-06-24,NA,NA,0,NA
"19504",2013-06-25,NA,NA,NA,NA
"19505",2013-06-26,NA,NA,122,NA
"19506",2013-06-27,214,NA,NA,NA
"19507",2013-06-28,NA,NA,NA,NA
"19508",2013-06-29,241,NA,NA,NA
"19509",2013-06-30,259,NA,NA,NA
"19510",2013-07-01,NA,NA,23,NA
"19511",2013-07-02,NA,NA,41,NA
"19512",2013-07-03,264,NA,28,NA
"19513",2013-07-04,NA,NA,173,NA
"19514",2013-07-05,240,NA,NA,NA
"19515",2013-07-06,NA,NA,NA,NA
"19516",2013-07-07,258,NA,NA,NA
"19517",2013-07-08,NA,NA,3,NA
"19518",2013-07-09,NA,NA,NA,NA
"19519",2013-07-10,NA,NA,NA,NA
"19520",2013-07-11,NA,NA,NA,NA
"19521",2013-07-12,NA,NA,NA,NA
"19522",2013-07-13,NA,NA,3,NA
"19523",2013-07-14,NA,NA,0,NA
"19524",2013-07-15,250,NA,5,NA
"19525",2013-07-16,NA,NA,NA,NA
"19526",2013-07-17,NA,NA,23,NA
"19527",2013-07-18,NA,NA,109,NA
"19528",2013-07-19,219,NA,30,NA
"19529",2013-07-20,NA,NA,0,NA
"19530",2013-07-21,240,317,NA,77
"19531",2013-07-22,NA,NA,8,NA
"19532",2013-07-23,NA,NA,53,NA
"19533",2013-07-24,233,NA,0,NA
"19534",2013-07-25,NA,NA,NA,NA
"19535",2013-07-26,NA,NA,NA,NA
"19536",2013-07-27,NA,NA,NA,NA
"19537",2013-07-28,NA,NA,NA,NA
"19538",2013-07-29,NA,353,NA,NA
"19539",2013-07-30,NA,NA,NA,NA
"19540",2013-07-31,NA,NA,3,NA
"19541",2013-08-01,NA,NA,74,NA
"19542",2013-08-02,NA,NA,5,NA
"19543",2013-08-03,NA,NA,NA,NA
"19544",2013-08-04,NA,NA,NA,NA
"19545",2013-08-05,NA,NA,NA,NA
"19546",2013-08-06,NA,NA,NA,NA
"19547",2013-08-07,NA,390,292,NA
"19548",2013-08-08,NA,NA,20,NA
"19549",2013-08-09,245,NA,NA,NA
"19550",2013-08-10,260,NA,NA,NA
"19551",2013-08-11,NA,NA,193,NA
"19552",2013-08-12,244,NA,3,NA
"19553",2013-08-13,260,NA,NA,NA
"19554",2013-08-14,278,NA,NA,NA
"19555",2013-08-15,NA,NA,NA,NA
"19556",2013-08-16,NA,NA,NA,NA
"19557",2013-08-17,NA,NA,NA,NA
"19558",2013-08-18,NA,NA,NA,NA
"19559",2013-08-19,NA,NA,NA,NA
"19560",2013-08-20,NA,NA,NA,NA
"19561",2013-08-21,230,NA,NA,NA
"19562",2013-08-22,234,NA,NA,NA
"19563",2013-08-23,NA,NA,66,NA
"19564",2013-08-24,231,NA,NA,NA
"19565",2013-08-25,NA,NA,3,NA
"19566",2013-08-26,215,NA,NA,NA
"19567",2013-08-27,250,NA,NA,NA
"19568",2013-08-28,259,NA,0,NA
"19569",2013-08-29,NA,NA,0,NA
"19570",2013-08-30,NA,NA,NA,NA
"19571",2013-08-31,NA,NA,NA,NA
"19572",2013-09-01,NA,NA,NA,NA
"19573",2013-09-02,NA,NA,NA,NA
"19574",2013-09-03,163,NA,NA,NA
"19575",2013-09-04,NA,NA,NA,NA
"19576",2013-09-05,NA,NA,NA,NA
"19577",2013-09-06,NA,NA,NA,NA
"19578",2013-09-07,198,NA,NA,NA
"19579",2013-09-08,NA,NA,97,NA
"19580",2013-09-09,NA,NA,NA,NA
"19581",2013-09-10,175,NA,NA,NA
"19582",2013-09-11,197,NA,NA,NA
"19583",2013-09-12,NA,NA,0,NA
"19584",2013-09-13,NA,NA,NA,NA
"19585",2013-09-14,180,NA,NA,NA
"19586",2013-09-15,NA,NA,NA,NA
"19587",2013-09-16,215,NA,NA,NA
"19588",2013-09-17,NA,NA,NA,NA
"19589",2013-09-18,NA,NA,NA,NA
"19590",2013-09-19,NA,NA,NA,NA
"19591",2013-09-20,NA,NA,NA,NA
"19592",2013-09-21,NA,NA,NA,NA
"19593",2013-09-22,NA,NA,NA,NA
"19594",2013-09-23,NA,NA,0,NA
"19595",2013-09-24,NA,211,NA,NA
"19596",2013-09-25,NA,NA,NA,NA
"19597",2013-09-26,120,NA,NA,NA
"19598",2013-09-27,NA,232,NA,NA
"19599",2013-09-28,128,NA,NA,NA
"19600",2013-09-29,NA,NA,NA,NA
"19601",2013-09-30,161,NA,NA,NA
"19602",2013-11-01,NA,NA,25,NA
"19603",2013-11-02,NA,190,15,NA
"19604",2013-11-03,NA,199,0,NA
"19605",2013-11-04,NA,NA,NA,NA
"19606",2013-11-05,NA,NA,0,NA
"19607",2013-11-06,NA,234,NA,NA
"19608",2013-11-07,48,NA,8,NA
"19609",2013-11-08,NA,NA,48,NA
"19610",2013-11-09,NA,NA,56,NA
"19611",2013-11-10,NA,NA,56,NA
"19612",2013-11-11,NA,NA,0,NA
"19613",2013-11-12,NA,NA,NA,NA
"19614",2013-11-13,29,NA,NA,NA
"19615",2013-11-14,NA,170,NA,NA
"19616",2013-11-15,NA,NA,NA,NA
"19617",2013-11-16,NA,NA,NA,NA
"19618",2013-11-17,NA,163,NA,NA
"19619",2013-11-18,NA,166,NA,NA
"19620",2013-11-19,7,142,NA,135
"19621",2013-11-20,8,124,NA,116
"19622",2013-11-21,NA,NA,NA,NA
"19623",2013-11-22,7,122,38,115
"19624",2013-11-23,NA,96,145,NA
"19625",2013-11-24,NA,NA,0,NA
"19626",2013-11-25,NA,NA,NA,NA
"19627",2013-11-26,-1,151,NA,152
"19628",2013-11-27,NA,83,NA,NA
"19629",2013-11-28,10,84,NA,74
"19630",2013-11-29,NA,149,NA,NA
"19631",2013-11-30,NA,NA,NA,NA
"19632",2013-12-01,NA,155,NA,NA
"19633",2013-12-02,-4,173,NA,177
"19634",2013-12-03,NA,150,NA,NA
"19635",2013-12-04,-2,174,NA,176
"19636",2013-12-05,NA,136,NA,NA
"19637",2013-12-06,NA,NA,NA,NA
"19638",2013-12-07,NA,134,NA,NA
"19639",2013-12-08,16,NA,0,NA
"19640",2013-12-09,NA,102,0,NA
"19641",2013-12-10,NA,NA,NA,NA
"19642",2013-12-11,NA,111,NA,NA
"19643",2013-12-12,NA,NA,NA,NA
"19644",2013-12-13,-39,86,NA,125
"19645",2013-12-14,-17,133,NA,150
"19646",2013-12-15,NA,75,NA,NA
"19647",2013-12-16,NA,63,NA,NA
"19648",2013-12-17,-12,51,NA,63
"19649",2013-12-18,NA,25,0,NA
"19650",2013-12-19,NA,58,0,NA
"19651",2013-12-20,NA,40,NA,NA
"19652",2013-12-21,NA,26,NA,NA
"19653",2013-12-22,NA,42,NA,NA
"19654",2013-12-23,NA,NA,NA,NA
"19655",2013-12-24,-56,NA,NA,NA
"19656",2013-12-25,-39,84,NA,123
"19657",2013-12-26,NA,56,NA,NA
"19658",2013-12-27,-61,57,NA,118
"19659",2013-12-28,NA,60,NA,NA
"19660",2013-12-29,NA,NA,NA,NA
"19661",2013-12-30,NA,111,NA,NA
"19662",2013-12-31,-8,148,NA,156
"19663",2014-01-01,NA,NA,NA,NA
"19664",2014-01-02,6,NA,NA,NA
"19665",2014-01-03,NA,127,0,NA
"19666",2014-01-04,NA,128,0,NA
"19667",2014-01-05,-20,96,NA,116
"19668",2014-01-06,NA,65,NA,NA
"19669",2014-01-07,NA,75,0,NA
"19670",2014-01-08,NA,62,NA,NA
"19671",2014-01-09,-65,59,3,124
"19672",2014-01-10,NA,62,0,NA
"19673",2014-01-11,NA,NA,NA,NA
"19674",2014-01-12,NA,67,0,NA
"19675",2014-01-13,NA,77,0,NA
"19676",2014-01-14,NA,28,NA,NA
"19677",2014-01-15,NA,44,NA,NA
"19678",2014-01-16,NA,NA,NA,NA
"19679",2014-01-17,NA,102,0,NA
"19680",2014-01-18,NA,104,0,NA
"19681",2014-01-19,NA,NA,NA,NA
"19682",2014-01-20,NA,94,NA,NA
"19683",2014-01-21,NA,80,NA,NA
"19684",2014-01-22,-59,NA,0,NA
"19685",2014-01-23,NA,134,0,NA
"19686",2014-01-24,NA,NA,0,NA
"19687",2014-01-25,-20,116,0,136
"19688",2014-01-26,-26,84,NA,110
"19689",2014-01-27,NA,159,NA,NA
"19690",2014-01-28,NA,NA,NA,NA
"19691",2014-01-29,9,146,NA,137
"19692",2014-01-30,12,NA,NA,NA
"19693",2014-01-31,NA,NA,0,NA
"19694",2014-02-01,NA,62,NA,NA
"19695",2014-02-02,10,120,NA,110
"19696",2014-02-03,NA,NA,NA,NA
"19697",2014-02-04,-34,24,NA,58
"19698",2014-02-05,NA,-11,69,NA
"19699",2014-02-06,NA,-15,89,NA
"19700",2014-02-07,NA,17,3,NA
"19701",2014-02-08,NA,22,3,NA
"19702",2014-02-09,NA,-9,NA,NA
"19703",2014-02-10,NA,-14,NA,NA
"19704",2014-02-11,-88,NA,NA,NA
"19705",2014-02-12,-65,17,NA,82
"19706",2014-02-13,NA,42,NA,NA
"19707",2014-02-14,-55,66,NA,121
"19708",2014-02-15,-21,72,NA,93
"19709",2014-02-16,NA,NA,3,NA
"19710",2014-02-17,NA,35,66,NA
"19711",2014-02-18,NA,69,3,NA
"19712",2014-02-19,-11,114,0,125
"19713",2014-02-20,-11,92,NA,103
"19714",2014-02-21,-1,117,NA,118
"19715",2014-02-22,8,118,NA,110
"19716",2014-02-23,18,NA,NA,NA
"19717",2014-02-24,NA,NA,NA,NA
"19718",2014-02-25,39,122,NA,83
"19719",2014-02-26,74,146,NA,72
"19720",2014-02-27,NA,115,NA,NA
"19721",2014-02-28,NA,63,13,NA
"19722",2014-03-01,NA,96,NA,NA
"19723",2014-03-02,10,121,NA,111
"19724",2014-03-03,NA,134,NA,NA
"19725",2014-03-04,NA,120,NA,NA
"19726",2014-03-05,25,59,NA,34
"19727",2014-03-06,NA,83,0,NA
"19728",2014-03-07,8,102,NA,94
"19729",2014-03-08,NA,NA,NA,NA
"19730",2014-03-09,15,187,NA,172
"19731",2014-03-10,NA,181,NA,NA
"19732",2014-03-11,47,181,NA,134
"19733",2014-03-12,NA,119,NA,NA
"19734",2014-03-13,20,160,0,140
"19735",2014-03-14,39,200,NA,161
"19736",2014-03-15,40,261,NA,221
"19737",2014-03-16,71,249,NA,178
"19738",2014-03-17,83,292,NA,209
"19739",2014-03-18,NA,191,58,NA
"19740",2014-03-19,NA,157,NA,NA
"19741",2014-03-20,NA,169,NA,NA
"19742",2014-03-21,38,205,NA,167
"19743",2014-03-22,46,231,NA,185
"19744",2014-03-23,71,199,NA,128
"19745",2014-03-24,88,230,0,142
"19746",2014-03-25,108,244,NA,136
"19747",2014-03-26,120,264,NA,144
"19748",2014-03-27,145,275,NA,130
"19749",2014-03-28,NA,271,5,NA
"19750",2014-03-29,NA,250,0,NA
"19751",2014-03-30,NA,NA,NA,NA
"19752",2014-03-31,NA,226,NA,NA
"19753",2014-04-01,NA,238,NA,NA
"19754",2014-04-02,106,247,NA,141
"19755",2014-04-03,NA,179,NA,NA
"19756",2014-04-04,86,262,0,176
"19757",2014-04-05,NA,194,NA,NA
"19758",2014-04-06,65,187,NA,122
"19759",2014-04-07,NA,236,NA,NA
"19760",2014-04-08,101,261,NA,160
"19761",2014-04-09,139,289,NA,150
"19762",2014-04-10,NA,NA,NA,NA
"19763",2014-04-11,NA,133,86,NA
"19764",2014-04-12,NA,178,NA,NA
"19765",2014-04-13,106,225,NA,119
"19766",2014-04-14,115,239,3,124
"19767",2014-04-15,NA,177,152,NA
"19768",2014-04-16,130,194,142,64
"19769",2014-04-17,131,240,0,109
"19770",2014-04-18,NA,162,191,NA
"19771",2014-04-19,NA,191,NA,NA
"19772",2014-04-20,110,202,NA,92
"19773",2014-04-21,NA,201,3,NA
"19774",2014-04-22,117,240,0,123
"19775",2014-04-23,NA,230,0,NA
"19776",2014-04-24,NA,239,NA,NA
"19777",2014-04-25,139,169,132,30
"19778",2014-04-26,NA,192,NA,NA
"19779",2014-04-27,NA,243,NA,NA
"19780",2014-04-28,NA,236,NA,NA
"19781",2014-04-29,111,254,0,143
"19782",2014-04-30,149,294,NA,145
"19783",2014-05-01,156,304,53,148
"19784",2014-05-02,NA,232,NA,NA
"19785",2014-05-03,130,234,NA,104
"19786",2014-05-04,NA,NA,NA,NA
"19787",2014-05-05,81,241,NA,160
"19788",2014-05-06,126,279,NA,153
"19789",2014-05-07,NA,337,NA,NA
"19790",2014-05-08,NA,292,NA,NA
"19791",2014-05-09,NA,285,NA,NA
"19792",2014-05-10,NA,197,211,NA
"19793",2014-05-11,NA,258,NA,NA
"19794",2014-05-12,111,312,NA,201
"19795",2014-05-13,NA,280,5,NA
"19796",2014-05-14,NA,246,NA,NA
"19797",2014-05-15,NA,293,NA,NA
"19798",2014-05-16,146,292,NA,146
"19799",2014-05-17,161,280,NA,119
"19800",2014-05-18,178,292,NA,114
"19801",2014-05-19,NA,290,NA,NA
"19802",2014-05-20,173,365,NA,192
"19803",2014-05-21,171,322,NA,151
"19804",2014-05-22,NA,323,NA,NA
"19805",2014-05-23,197,293,272,96
"19806",2014-05-24,NA,312,NA,NA
"19807",2014-05-25,NA,NA,NA,NA
"19808",2014-05-26,209,340,NA,131
"19809",2014-05-27,NA,NA,NA,NA
"19810",2014-05-28,NA,368,NA,NA
"19811",2014-05-29,216,394,NA,178
"19812",2014-05-30,219,362,NA,143
"19813",2014-05-31,NA,294,41,NA
"19814",2014-06-01,NA,309,NA,NA
"19815",2014-06-02,198,282,NA,84
"19816",2014-06-03,NA,294,NA,NA
"19817",2014-06-04,197,326,NA,129
"19818",2014-06-05,209,340,NA,131
"19819",2014-06-06,NA,364,NA,NA
"19820",2014-06-07,NA,330,NA,NA
"19821",2014-06-08,NA,367,NA,NA
"19822",2014-06-09,NA,366,NA,NA
"19823",2014-06-10,NA,NA,NA,NA
"19824",2014-06-11,NA,NA,NA,NA
"19825",2014-06-12,211,332,NA,121
"19826",2014-06-13,NA,NA,NA,NA
"19827",2014-06-14,NA,281,0,NA
"19828",2014-06-15,NA,256,0,NA
"19829",2014-06-16,209,270,NA,61
"19830",2014-06-17,212,340,NA,128
"19831",2014-06-18,NA,335,NA,NA
"19832",2014-06-19,NA,299,208,NA
"19833",2014-06-20,200,NA,NA,NA
"19834",2014-06-21,209,NA,NA,NA
"19835",2014-06-22,210,334,NA,124
"19836",2014-06-23,224,NA,NA,NA
"19837",2014-06-24,NA,342,8,NA
"19838",2014-06-25,NA,257,3,NA
"19839",2014-06-26,204,313,0,109
"19840",2014-06-27,229,349,NA,120
"19841",2014-06-28,NA,346,10,NA
"19842",2014-06-29,NA,269,41,NA
"19843",2014-06-30,221,328,13,107
"19844",2014-07-01,NA,324,0,NA
"19845",2014-07-02,211,336,NA,125
"19846",2014-07-03,NA,363,137,NA
"19847",2014-07-04,NA,276,5,NA
"19848",2014-07-05,NA,316,NA,NA
"19849",2014-07-06,220,337,NA,117
"19850",2014-07-07,232,348,NA,116
"19851",2014-07-08,NA,356,NA,NA
"19852",2014-07-09,NA,310,NA,NA
"19853",2014-07-10,NA,261,74,NA
"19854",2014-07-11,215,373,66,158
"19855",2014-07-12,NA,NA,20,NA
"19856",2014-07-13,228,360,0,132
"19857",2014-07-14,NA,344,NA,NA
"19858",2014-07-15,214,347,NA,133
"19859",2014-07-16,NA,350,NA,NA
"19860",2014-07-17,NA,351,NA,NA
"19861",2014-07-18,249,335,NA,86
"19862",2014-07-19,257,353,NA,96
"19863",2014-07-20,278,377,NA,99
"19864",2014-07-21,NA,397,NA,NA
"19865",2014-07-22,NA,NA,NA,NA
"19866",2014-07-23,NA,321,0,NA
"19867",2014-07-24,NA,NA,NA,NA
"19868",2014-07-25,NA,NA,NA,NA
"19869",2014-07-26,NA,358,NA,NA
"19870",2014-07-27,208,344,NA,136
"19871",2014-07-28,226,353,NA,127
"19872",2014-07-29,NA,351,269,NA
"19873",2014-07-30,NA,304,NA,NA
"19874",2014-07-31,238,325,NA,87
"19875",2014-08-01,NA,327,NA,NA
"19876",2014-08-02,NA,347,NA,NA
"19877",2014-08-03,257,364,NA,107
"19878",2014-08-04,NA,381,NA,NA
"19879",2014-08-05,NA,282,NA,NA
"19880",2014-08-06,NA,NA,155,NA
"19881",2014-08-07,185,NA,64,NA
"19882",2014-08-08,NA,NA,30,NA
"19883",2014-08-09,164,227,99,63
"19884",2014-08-10,165,302,71,137
"19885",2014-08-11,NA,313,0,NA
"19886",2014-08-12,NA,308,NA,NA
"19887",2014-08-13,NA,304,0,NA
"19888",2014-08-14,NA,314,NA,NA
"19889",2014-08-15,196,360,NA,164
"19890",2014-08-16,NA,315,0,NA
"19891",2014-08-17,NA,NA,10,NA
"19892",2014-08-18,NA,303,NA,NA
"19893",2014-08-19,NA,314,NA,NA
"19894",2014-08-20,197,326,NA,129
"19895",2014-08-21,227,338,NA,111
"19896",2014-08-22,240,338,NA,98
"19897",2014-08-23,NA,298,0,NA
"19898",2014-08-24,204,NA,0,NA
"19899",2014-08-25,216,339,NA,123
"19900",2014-08-26,NA,305,15,NA
"19901",2014-08-27,NA,262,41,NA
"19902",2014-08-28,NA,287,10,NA
"19903",2014-08-29,170,292,0,122
"19904",2014-08-30,NA,227,262,NA
"19905",2014-08-31,192,275,254,83
"19906",2014-09-01,199,251,28,52
"19907",2014-09-02,NA,309,NA,NA
"19908",2014-09-03,NA,294,0,NA
"19909",2014-09-04,167,320,NA,153
"19910",2014-09-05,NA,306,NA,NA
"19911",2014-09-06,193,296,NA,103
"19912",2014-09-07,NA,NA,33,NA
"19913",2014-09-08,NA,262,5,NA
"19914",2014-09-09,NA,272,56,NA
"19915",2014-09-10,212,287,13,75
"19916",2014-09-11,NA,241,117,NA
"19917",2014-09-12,157,191,15,34
"19918",2014-09-13,178,233,3,55
"19919",2014-09-14,NA,196,493,NA
"19920",2014-09-15,NA,164,287,NA
"19921",2014-09-16,NA,NA,338,NA
"19922",2014-09-17,NA,NA,292,NA
"19923",2014-09-18,145,185,292,40
"19924",2014-09-19,140,267,0,127
"19925",2014-09-20,146,290,NA,144
"19926",2014-09-21,NA,NA,NA,NA
"19927",2014-09-22,NA,NA,NA,NA
"19928",2014-09-23,161,NA,NA,NA
"19929",2014-09-24,NA,NA,NA,NA
"19930",2014-09-25,167,260,0,93
"19931",2014-09-26,201,295,NA,94
"19932",2014-09-27,NA,284,414,NA
"19933",2014-09-28,NA,201,188,NA
"19934",2014-09-29,NA,274,122,NA
"19935",2014-09-30,NA,200,0,NA
"19936",2014-10-01,NA,NA,18,NA
"19937",2014-10-02,143,302,NA,159
"19938",2014-10-03,NA,NA,NA,NA
"19939",2014-10-04,158,NA,NA,NA
"19940",2014-10-05,NA,243,NA,NA
"19941",2014-10-06,NA,226,NA,NA
"19942",2014-10-07,112,247,NA,135
"19943",2014-10-08,138,248,NA,110
"19944",2014-10-09,NA,251,NA,NA
"19945",2014-10-10,NA,232,NA,NA
"19946",2014-10-11,131,NA,NA,NA
"19947",2014-10-12,NA,183,NA,NA
"19948",2014-10-13,NA,180,NA,NA
"19949",2014-10-14,NA,228,NA,NA
"19950",2014-10-15,94,NA,NA,NA
"19951",2014-10-16,NA,222,NA,NA
"19952",2014-10-17,NA,264,NA,NA
"19953",2014-10-18,113,241,20,128
"19954",2014-10-19,NA,182,8,NA
"19955",2014-10-20,NA,167,104,NA
"19956",2014-10-21,NA,202,NA,NA
"19957",2014-10-22,125,210,NA,85
"19958",2014-10-23,NA,268,NA,NA
"19959",2014-10-24,127,271,NA,144
"19960",2014-10-25,NA,273,NA,NA
"19961",2014-10-26,NA,238,NA,NA
"19962",2014-10-27,NA,146,NA,NA
"19963",2014-10-28,105,150,NA,45
"19964",2014-10-29,NA,NA,0,NA
"19965",2014-10-30,126,176,NA,50
"19966",2014-10-31,NA,185,0,NA
"19967",2014-11-01,NA,174,0,NA
"19968",2014-11-02,NA,164,NA,NA
"19969",2014-11-03,NA,192,NA,NA
"19970",2014-11-04,33,191,NA,158
"19971",2014-11-05,NA,206,NA,NA
"19972",2014-11-06,80,NA,NA,NA
"19973",2014-11-07,NA,113,NA,NA
"19974",2014-11-08,31,142,NA,111
"19975",2014-11-09,NA,164,NA,NA
"19976",2014-11-10,49,166,NA,117
"19977",2014-11-11,88,NA,NA,NA
"19978",2014-11-12,NA,NA,NA,NA
"19979",2014-11-13,NA,165,NA,NA
"19980",2014-11-14,28,152,5,124
"19981",2014-11-15,NA,99,3,NA
"19982",2014-11-16,NA,NA,3,NA
"19983",2014-11-17,NA,140,0,NA
"19984",2014-11-18,10,152,NA,142
"19985",2014-11-19,NA,159,NA,NA
"19986",2014-11-20,35,178,NA,143
"19987",2014-11-21,61,162,NA,101
"19988",2014-11-22,NA,113,89,NA
"19989",2014-11-23,58,117,NA,59
"19990",2014-11-24,NA,118,0,NA
"19991",2014-11-25,NA,111,NA,NA
"19992",2014-11-26,23,141,NA,118
"19993",2014-11-27,NA,84,56,NA
"19994",2014-11-28,NA,103,NA,NA
"19995",2014-11-29,49,72,23,23
"19996",2014-11-30,NA,124,NA,NA
"19997",2014-12-01,NA,54,NA,NA
"19998",2014-12-02,-40,52,NA,92
"19999",2014-12-03,NA,85,NA,NA
"20000",2014-12-04,NA,78,NA,NA
"20001",2014-12-05,NA,NA,NA,NA
"20002",2014-12-06,-26,113,NA,139
"20003",2014-12-07,NA,125,NA,NA
"20004",2014-12-08,-23,84,NA,107
"20005",2014-12-09,NA,56,0,NA
"20006",2014-12-10,33,91,NA,58
"20007",2014-12-11,NA,78,NA,NA
"20008",2014-12-12,NA,73,NA,NA
"20009",2014-12-13,NA,110,NA,NA
"20010",2014-12-14,NA,104,NA,NA
"20011",2014-12-15,NA,NA,NA,NA
"20012",2014-12-16,NA,55,NA,NA
"20013",2014-12-17,NA,114,NA,NA
"20014",2014-12-18,-37,121,NA,158
"20015",2014-12-19,NA,NA,NA,NA
"20016",2014-12-20,-1,35,NA,36
"20017",2014-12-21,NA,NA,NA,NA
"20018",2014-12-22,NA,111,NA,NA
"20019",2014-12-23,NA,140,NA,NA
"20020",2014-12-24,NA,95,NA,NA
"20021",2014-12-25,-29,53,NA,82
"20022",2014-12-26,NA,65,NA,NA
"20023",2014-12-27,NA,112,NA,NA
"20024",2014-12-28,NA,143,NA,NA
"20025",2014-12-29,NA,NA,NA,NA
"20026",2014-12-30,NA,NA,NA,NA
"20027",2014-12-31,NA,77,NA,NA
"20028",2015-01-01,NA,83,NA,NA
"20029",2015-01-02,-34,86,NA,120
"20030",2015-01-03,NA,145,NA,NA
"20031",2015-01-04,NA,123,NA,NA
"20032",2015-01-05,NA,92,NA,NA
"20033",2015-01-06,NA,59,0,NA
"20034",2015-01-07,NA,NA,NA,NA
"20035",2015-01-08,NA,NA,NA,NA
"20036",2015-01-09,NA,NA,NA,NA
"20037",2015-01-10,NA,160,NA,NA
"20038",2015-01-11,0,125,NA,125
"20039",2015-01-12,NA,64,NA,NA
"20040",2015-01-13,-27,62,NA,89
"20041",2015-01-14,NA,84,NA,NA
"20042",2015-01-15,NA,66,NA,NA
"20043",2015-01-16,NA,126,NA,NA
"20044",2015-01-17,-40,77,NA,117
"20045",2015-01-18,NA,120,NA,NA
"20046",2015-01-19,-23,139,NA,162
"20047",2015-01-20,NA,147,NA,NA
"20048",2015-01-21,NA,91,NA,NA
"20049",2015-01-22,-43,85,NA,128
"20050",2015-01-23,-30,123,NA,153
"20051",2015-01-24,NA,47,81,NA
"20052",2015-01-25,NA,28,NA,NA
"20053",2015-01-26,NA,64,NA,NA
"20054",2015-01-27,NA,17,3,NA
"20055",2015-01-28,NA,-4,48,NA
"20056",2015-01-29,NA,37,NA,NA
"20057",2015-01-30,-42,35,NA,77
"20058",2015-01-31,-30,33,NA,63
"20059",2015-02-01,NA,51,NA,NA
"20060",2015-02-02,NA,11,NA,NA
"20061",2015-02-03,-38,83,NA,121
"20062",2015-02-04,NA,107,NA,NA
"20063",2015-02-05,-33,83,NA,116
"20064",2015-02-06,-22,138,NA,160
"20065",2015-02-07,NA,106,NA,NA
"20066",2015-02-08,-44,57,NA,101
"20067",2015-02-09,-43,93,NA,136
"20068",2015-02-10,-32,162,NA,194
"20069",2015-02-11,NA,153,NA,NA
"20070",2015-02-12,-1,152,NA,153
"20071",2015-02-13,-5,151,NA,156
"20072",2015-02-14,13,NA,NA,NA
"20073",2015-02-15,NA,145,0,NA
"20074",2015-02-16,NA,184,NA,NA
"20075",2015-02-17,8,151,NA,143
"20076",2015-02-18,NA,NA,NA,NA
"20077",2015-02-19,NA,74,NA,NA
"20078",2015-02-20,NA,50,NA,NA
"20079",2015-02-21,NA,177,0,NA
"20080",2015-02-22,NA,100,NA,NA
"20081",2015-02-23,NA,NA,10,NA
"20082",2015-02-24,-18,102,NA,120
"20083",2015-02-25,NA,165,NA,NA
"20084",2015-02-26,9,127,NA,118
"20085",2015-02-27,NA,67,NA,NA
"20086",2015-02-28,NA,96,0,NA
"20087",2015-03-01,11,148,NA,137
"20088",2015-03-02,9,160,NA,151
"20089",2015-03-03,NA,130,NA,NA
"20090",2015-03-04,NA,71,NA,NA
"20091",2015-03-05,NA,NA,NA,NA
"20092",2015-03-06,NA,126,NA,NA
"20093",2015-03-07,1,160,NA,159
"20094",2015-03-08,50,153,NA,103
"20095",2015-03-09,NA,86,NA,NA
"20096",2015-03-10,NA,92,NA,NA
"20097",2015-03-11,2,165,NA,163
"20098",2015-03-12,16,NA,NA,NA
"20099",2015-03-13,75,NA,NA,NA
"20100",2015-03-14,NA,170,NA,NA
"20101",2015-03-15,89,NA,NA,NA
"20102",2015-03-16,NA,NA,NA,NA
"20103",2015-03-17,NA,NA,69,NA
"20104",2015-03-18,NA,NA,10,NA
"20105",2015-03-19,55,160,48,105
"20106",2015-03-20,66,203,NA,137
"20107",2015-03-21,82,NA,NA,NA
"20108",2015-03-22,NA,NA,NA,NA
"20109",2015-03-23,NA,109,15,NA
"20110",2015-03-24,53,172,5,119
"20111",2015-03-25,NA,NA,18,NA
"20112",2015-03-26,NA,NA,15,NA
"20113",2015-03-27,42,196,0,154
"20114",2015-03-28,97,NA,NA,NA
"20115",2015-03-29,NA,NA,NA,NA
"20116",2015-03-30,124,NA,NA,NA
"20117",2015-03-31,NA,205,124,NA
"20118",2015-04-01,NA,NA,455,NA
"20119",2015-04-02,44,NA,439,NA
"20120",2015-04-03,65,NA,48,NA
"20121",2015-04-04,88,NA,NA,NA
"20122",2015-04-05,NA,NA,3,NA
"20123",2015-04-06,NA,NA,NA,NA
"20124",2015-04-07,NA,NA,NA,NA
"20125",2015-04-08,36,NA,NA,NA
"20126",2015-04-09,63,NA,NA,NA
"20127",2015-04-10,78,NA,NA,NA
"20128",2015-04-11,118,228,NA,110
"20129",2015-04-12,NA,NA,0,NA
"20130",2015-04-13,NA,150,NA,NA
"20131",2015-04-14,45,NA,NA,NA
"20132",2015-04-15,115,304,NA,189
"20133",2015-04-16,NA,224,NA,NA
"20134",2015-04-17,112,NA,NA,NA
"20135",2015-04-18,NA,NA,66,NA
"20136",2015-04-19,NA,NA,99,NA
"20137",2015-04-20,72,NA,86,NA
"20138",2015-04-21,80,NA,0,NA
"20139",2015-04-22,NA,258,NA,NA
"20140",2015-04-23,116,NA,NA,NA
"20141",2015-04-24,130,NA,NA,NA
"20142",2015-04-25,NA,NA,NA,NA
"20143",2015-04-26,147,281,NA,134
"20144",2015-04-27,NA,NA,NA,NA
"20145",2015-04-28,NA,NA,NA,NA
"20146",2015-04-29,151,283,NA,132
"20147",2015-04-30,NA,NA,NA,NA
"20148",2015-05-01,NA,NA,566,NA
"20149",2015-05-02,NA,246,3,NA
"20150",2015-05-03,144,NA,0,NA
"20151",2015-05-04,NA,NA,NA,NA
"20152",2015-05-05,132,260,NA,128
"20153",2015-05-06,NA,NA,170,NA
"20154",2015-05-07,NA,NA,61,NA
"20155",2015-05-08,NA,268,NA,NA
"20156",2015-05-09,NA,NA,NA,NA
"20157",2015-05-10,NA,NA,23,NA
"20158",2015-05-11,NA,230,18,NA
"20159",2015-05-12,91,294,0,203
"20160",2015-05-13,135,314,NA,179
"20161",2015-05-14,NA,270,NA,NA
"20162",2015-05-15,NA,NA,NA,NA
"20163",2015-05-16,162,NA,NA,NA
"20164",2015-05-17,NA,271,NA,NA
"20165",2015-05-18,187,NA,NA,NA
"20166",2015-05-19,201,NA,NA,NA
"20167",2015-05-20,NA,NA,NA,NA
"20168",2015-05-21,NA,NA,NA,NA
"20169",2015-05-22,NA,285,0,NA
"20170",2015-05-23,NA,NA,NA,NA
"20171",2015-05-24,167,309,NA,142
"20172",2015-05-25,184,NA,NA,NA
"20173",2015-05-26,NA,272,NA,NA
"20174",2015-05-27,185,311,NA,126
"20175",2015-05-28,NA,NA,NA,NA
"20176",2015-05-29,NA,NA,NA,NA
"20177",2015-05-30,190,NA,NA,NA
"20178",2015-05-31,201,324,NA,123
"20179",2015-06-01,NA,NA,8,NA
"20180",2015-06-02,207,NA,NA,NA
"20181",2015-06-03,NA,NA,NA,NA
"20182",2015-06-04,NA,252,NA,NA
"20183",2015-06-05,165,370,0,205
"20184",2015-06-06,205,375,NA,170
"20185",2015-06-07,NA,326,NA,NA
"20186",2015-06-08,NA,334,NA,NA
"20187",2015-06-09,209,357,NA,148
"20188",2015-06-10,243,NA,NA,NA
"20189",2015-06-11,NA,343,NA,NA
"20190",2015-06-12,208,358,NA,150
"20191",2015-06-13,NA,NA,NA,NA
"20192",2015-06-14,NA,326,5,NA
"20193",2015-06-15,NA,NA,18,NA
"20194",2015-06-16,NA,NA,5,NA
"20195",2015-06-17,216,NA,NA,NA
"20196",2015-06-18,NA,NA,NA,NA
"20197",2015-06-19,NA,376,NA,NA
"20198",2015-06-20,NA,NA,NA,NA
"20199",2015-06-21,NA,NA,NA,NA
"20200",2015-06-22,225,NA,NA,NA
"20201",2015-06-23,NA,NA,191,NA
"20202",2015-06-24,185,NA,338,NA
"20203",2015-06-25,198,NA,277,NA
"20204",2015-06-26,214,NA,76,NA
"20205",2015-06-27,NA,NA,69,NA
"20206",2015-06-28,220,NA,66,NA
"20207",2015-06-29,NA,NA,94,NA
"20208",2015-06-30,NA,288,NA,NA
"20209",2015-07-01,206,NA,NA,NA
"20210",2015-07-02,NA,NA,NA,NA
"20211",2015-07-03,NA,NA,NA,NA
"20212",2015-07-04,NA,NA,NA,NA
"20213",2015-07-05,217,320,0,103
"20214",2015-07-06,NA,NA,0,NA
"20215",2015-07-07,NA,NA,0,NA
"20216",2015-07-08,NA,NA,NA,NA
"20217",2015-07-09,NA,311,NA,NA
"20218",2015-07-10,198,296,NA,98
"20219",2015-07-11,NA,325,8,NA
"20220",2015-07-12,NA,NA,NA,NA
"20221",2015-07-13,241,NA,NA,NA
"20222",2015-07-14,NA,NA,254,NA
"20223",2015-07-15,NA,NA,91,NA
"20224",2015-07-16,207,NA,NA,NA
"20225",2015-07-17,NA,NA,23,NA
"20226",2015-07-18,210,NA,10,NA
"20227",2015-07-19,NA,NA,13,NA
"20228",2015-07-20,227,NA,NA,NA
"20229",2015-07-21,NA,NA,NA,NA
"20230",2015-07-22,NA,312,442,NA
"20231",2015-07-23,223,NA,3,NA
"20232",2015-07-24,NA,NA,NA,NA
"20233",2015-07-25,231,348,NA,117
"20234",2015-07-26,NA,NA,NA,NA
"20235",2015-07-27,NA,NA,NA,NA
"20236",2015-07-28,NA,345,NA,NA
"20237",2015-07-29,NA,NA,NA,NA
"20238",2015-07-30,NA,NA,NA,NA
"20239",2015-07-31,NA,NA,NA,NA
"20240",2015-08-01,267,NA,NA,NA
"20241",2015-08-02,NA,NA,NA,NA
"20242",2015-08-03,NA,NA,351,NA
"20243",2015-08-04,224,NA,8,NA
"20244",2015-08-05,NA,NA,64,NA
"20245",2015-08-06,216,NA,23,NA
"20246",2015-08-07,229,NA,0,NA
"20247",2015-08-08,NA,315,NA,NA
"20248",2015-08-09,NA,NA,5,NA
"20249",2015-08-10,NA,NA,NA,NA
"20250",2015-08-11,NA,NA,NA,NA
"20251",2015-08-12,236,NA,3,NA
"20252",2015-08-13,NA,NA,NA,NA
"20253",2015-08-14,NA,331,15,NA
"20254",2015-08-15,NA,NA,NA,NA
"20255",2015-08-16,217,331,NA,114
"20256",2015-08-17,NA,NA,NA,NA
"20257",2015-08-18,NA,NA,15,NA
"20258",2015-08-19,NA,NA,8,NA
"20259",2015-08-20,NA,NA,0,NA
"20260",2015-08-21,217,NA,NA,NA
"20261",2015-08-22,NA,358,99,NA
"20262",2015-08-23,189,NA,NA,NA
"20263",2015-08-24,NA,NA,NA,NA
"20264",2015-08-25,NA,NA,NA,NA
"20265",2015-08-26,NA,NA,533,NA
"20266",2015-08-27,193,NA,NA,NA
"20267",2015-08-28,199,NA,0,NA
"20268",2015-08-29,NA,NA,175,NA
"20269",2015-08-30,NA,NA,137,NA
"20270",2015-08-31,NA,NA,15,NA
"20271",2015-09-01,186,NA,NA,NA
"20272",2015-09-02,NA,NA,NA,NA
"20273",2015-09-03,182,NA,NA,NA
"20274",2015-09-04,NA,NA,86,NA
"20275",2015-09-05,177,NA,64,NA
"20276",2015-09-06,NA,NA,0,NA
"20277",2015-09-07,NA,NA,NA,NA
"20278",2015-09-08,166,NA,NA,NA
"20279",2015-09-09,NA,NA,3,NA
"20280",2015-09-10,NA,NA,61,NA
"20281",2015-09-11,NA,221,3,NA
"20282",2015-09-12,NA,NA,0,NA
"20283",2015-09-13,127,254,NA,127
"20284",2015-09-14,NA,NA,NA,NA
"20285",2015-09-15,130,NA,NA,NA
"20286",2015-09-16,151,NA,NA,NA
"20287",2015-09-17,NA,NA,NA,NA
"20288",2015-09-18,174,NA,NA,NA
"20289",2015-09-19,NA,NA,NA,NA
"20290",2015-09-20,NA,NA,NA,NA
"20291",2015-09-21,156,NA,NA,NA
"20292",2015-09-22,NA,234,36,NA
"20293",2015-09-23,168,NA,NA,NA
"20294",2015-09-24,NA,NA,8,NA
"20295",2015-09-25,158,NA,0,NA
"20296",2015-09-26,NA,NA,0,NA
"20297",2015-09-27,NA,NA,0,NA
"20298",2015-09-28,NA,NA,0,NA
"20299",2015-09-29,NA,NA,NA,NA
"20300",2015-09-30,NA,227,0,NA
"20301",2015-10-01,NA,240,NA,NA
"20302",2015-10-02,104,NA,8,NA
"20303",2015-10-03,127,NA,NA,NA
"20304",2015-10-04,NA,NA,NA,NA
"20305",2015-10-05,120,270,NA,150
"20306",2015-10-06,NA,NA,295,NA
"20307",2015-10-07,NA,246,3,NA
"20308",2015-10-08,NA,211,0,NA
"20309",2015-10-09,NA,NA,NA,NA
"20310",2015-10-10,NA,238,NA,NA
"20311",2015-10-11,NA,NA,NA,NA
"20312",2015-10-12,NA,255,NA,NA
"20313",2015-10-13,80,NA,NA,NA
"20314",2015-10-14,114,285,NA,171
"20315",2015-10-15,NA,NA,NA,NA
"20316",2015-10-16,113,NA,NA,NA
"20317",2015-10-17,NA,NA,NA,NA
"20318",2015-10-18,NA,NA,NA,NA
"20319",2015-10-19,NA,NA,NA,NA
"20320",2015-10-20,127,264,NA,137
"20321",2015-10-21,NA,NA,NA,NA
"20322",2015-10-22,NA,NA,NA,NA
"20323",2015-10-23,106,NA,0,NA
"20324",2015-10-24,111,NA,33,NA
"20325",2015-10-25,NA,NA,297,NA
"20326",2015-10-26,NA,NA,0,NA
"20327",2015-10-27,96,NA,NA,NA
"20328",2015-10-28,95,NA,NA,NA
"20329",2015-10-29,NA,NA,NA,NA
"20330",2015-10-30,NA,NA,NA,NA
"20331",2015-10-31,59,NA,NA,NA
"20332",2015-11-01,NA,NA,NA,NA
"20333",2015-11-02,40,NA,NA,NA
"20334",2015-11-03,70,NA,NA,NA
"20335",2015-11-04,89,NA,NA,NA
"20336",2015-11-05,NA,NA,264,NA
"20337",2015-11-06,NA,NA,41,NA
"20338",2015-11-07,42,NA,3,NA
"20339",2015-11-08,59,NA,NA,NA
"20340",2015-11-09,NA,NA,NA,NA
"20341",2015-11-10,NA,NA,NA,NA
"20342",2015-11-11,NA,NA,NA,NA
"20343",2015-11-12,75,NA,NA,NA
"20344",2015-11-13,NA,NA,NA,NA
"20345",2015-11-14,NA,NA,NA,NA
"20346",2015-11-15,99,NA,25,NA
"20347",2015-11-16,NA,NA,NA,NA
"20348",2015-11-17,NA,NA,38,NA
"20349",2015-11-18,NA,NA,NA,NA
"20350",2015-11-19,NA,NA,NA,NA
"20351",2015-11-20,87,NA,3,NA
"20352",2015-11-21,NA,NA,56,NA
"20353",2015-11-22,NA,42,66,NA
"20354",2015-11-23,NA,NA,224,NA
"20355",2015-11-24,NA,NA,69,NA
"20356",2015-11-25,NA,61,30,NA
"20357",2015-11-26,NA,-6,0,NA
"20358",2015-11-27,-55,58,NA,113
"20359",2015-11-28,-22,NA,399,NA
"20360",2015-11-29,NA,NA,0,NA
"20361",2015-11-30,-1,24,8,25
"20362",2015-12-01,16,112,0,96
"20363",2015-12-02,NA,NA,0,NA
"20364",2015-12-03,NA,NA,NA,NA
"20365",2015-12-04,NA,NA,NA,NA
"20366",2015-12-05,NA,NA,NA,NA
"20367",2015-12-06,-28,NA,NA,NA
"20368",2015-12-07,39,NA,NA,NA
"20369",2015-12-08,NA,NA,NA,NA
"20370",2015-12-09,NA,NA,NA,NA
"20371",2015-12-10,NA,NA,NA,NA
"20372",2015-12-11,14,NA,NA,NA
"20373",2015-12-12,NA,NA,NA,NA
"20374",2015-12-13,3,NA,NA,NA
"20375",2015-12-14,9,NA,NA,NA
"20376",2015-12-15,NA,NA,NA,NA
"20377",2015-12-16,NA,NA,NA,NA
"20378",2015-12-17,NA,73,NA,NA
"20379",2015-12-18,-50,NA,NA,NA
"20380",2015-12-19,NA,NA,NA,NA
"20381",2015-12-20,-30,NA,NA,NA
"20382",2015-12-21,-35,NA,3,NA
"20383",2015-12-22,NA,NA,NA,NA
"20384",2015-12-23,NA,NA,NA,NA
"20385",2015-12-24,2,NA,NA,NA
"20386",2015-12-25,NA,NA,NA,NA
"20387",2015-12-26,NA,NA,NA,NA
"20388",2015-12-27,NA,NA,NA,NA
"20389",2015-12-28,-41,55,NA,96
"20390",2015-12-29,-34,127,NA,161
"20391",2015-12-30,NA,NA,NA,NA
"20392",2015-12-31,-32,NA,NA,NA
"20393",2016-01-01,-10,NA,NA,NA
"20394",2016-01-02,-12,188,NA,200
"20395",2016-01-03,NA,127,NA,NA
"20396",2016-01-04,NA,NA,NA,NA
"20397",2016-01-05,NA,NA,NA,NA
"20398",2016-01-06,NA,NA,NA,NA
"20399",2016-01-07,NA,NA,NA,NA
"20400",2016-01-08,-50,NA,NA,NA
"20401",2016-01-09,-47,NA,NA,NA
"20402",2016-01-10,-37,NA,NA,NA
"20403",2016-01-11,NA,NA,NA,NA
"20404",2016-01-12,NA,NA,NA,NA
"20405",2016-01-13,-61,NA,NA,NA
"20406",2016-01-14,NA,NA,NA,NA
"20407",2016-01-15,NA,NA,NA,NA
"20408",2016-01-16,-23,NA,NA,NA
"20409",2016-01-17,NA,NA,NA,NA
"20410",2016-01-18,NA,NA,NA,NA
"20411",2016-01-19,-66,NA,NA,NA
"20412",2016-01-20,-47,NA,NA,NA
"20413",2016-01-21,-40,NA,NA,NA
"20414",2016-01-22,NA,NA,18,NA
"20415",2016-01-23,NA,NA,NA,NA
"20416",2016-01-24,NA,NA,NA,NA
"20417",2016-01-25,NA,NA,NA,NA
"20418",2016-01-26,NA,NA,NA,NA
"20419",2016-01-27,-73,NA,NA,NA
"20420",2016-01-28,NA,NA,NA,NA
"20421",2016-01-29,NA,NA,NA,NA
"20422",2016-01-30,NA,NA,18,NA
"20423",2016-01-31,NA,NA,5,NA
"20424",2016-02-01,NA,NA,NA,NA
"20425",2016-02-02,-72,NA,NA,NA
"20426",2016-02-03,-53,101,NA,154
"20427",2016-02-04,-25,NA,NA,NA
"20428",2016-02-05,-24,NA,NA,NA
"20429",2016-02-06,NA,NA,NA,NA
"20430",2016-02-07,-30,NA,NA,NA
"20431",2016-02-08,-1,NA,NA,NA
"20432",2016-02-09,5,NA,NA,NA
"20433",2016-02-10,41,NA,NA,NA
"20434",2016-02-11,NA,NA,NA,NA
"20435",2016-02-12,NA,NA,208,NA
"20436",2016-02-13,NA,NA,3,NA
"20437",2016-02-14,NA,NA,NA,NA
"20438",2016-02-15,-12,NA,NA,NA
"20439",2016-02-16,NA,NA,NA,NA
"20440",2016-02-17,NA,NA,NA,NA
"20441",2016-02-18,NA,159,NA,NA
"20442",2016-02-19,NA,NA,NA,NA
"20443",2016-02-20,NA,NA,NA,NA
"20444",2016-02-21,NA,NA,5,NA
"20445",2016-02-22,18,NA,NA,NA
"20446",2016-02-23,NA,NA,NA,NA
"20447",2016-02-24,-26,NA,NA,NA
"20448",2016-02-25,-7,NA,NA,NA
"20449",2016-02-26,30,NA,NA,NA
"20450",2016-02-27,34,NA,NA,NA
"20451",2016-02-28,NA,NA,NA,NA
"20452",2016-02-29,7,NA,NA,NA
"20453",2017-11-01,NA,NA,NA,NA
"20454",2017-11-02,90,NA,NA,NA
"20455",2017-11-03,NA,NA,NA,NA
"20456",2017-11-04,NA,NA,NA,NA
"20457",2017-11-05,NA,NA,NA,NA
"20458",2017-11-06,70,NA,NA,NA
"20459",2017-11-07,NA,NA,NA,NA
"20460",2017-11-08,73,NA,NA,NA
"20461",2017-11-09,NA,NA,5,NA
"20462",2017-11-10,NA,NA,NA,NA
"20463",2017-11-11,52,NA,NA,NA
"20464",2017-11-12,49,NA,NA,NA
"20465",2017-11-13,57,NA,NA,NA
"20466",2017-11-14,NA,NA,NA,NA
"20467",2017-11-15,38,NA,NA,NA
"20468",2017-11-16,NA,NA,NA,NA
"20469",2017-11-17,NA,NA,NA,NA
"20470",2017-11-18,NA,NA,NA,NA
"20471",2017-11-19,NA,NA,NA,NA
"20472",2017-11-20,-7,NA,NA,NA
"20473",2017-11-21,4,NA,NA,NA
"20474",2017-11-22,NA,NA,NA,NA
"20475",2017-11-23,NA,NA,NA,NA
"20476",2017-11-24,NA,109,NA,NA
"20477",2017-11-25,-4,NA,NA,NA
"20478",2017-11-26,NA,NA,NA,NA
"20479",2017-11-27,8,NA,NA,NA
"20480",2017-11-28,NA,NA,NA,NA
"20481",2017-11-29,NA,NA,NA,NA
"20482",2017-11-30,NA,NA,NA,NA
"20483",2018-02-01,-60,NA,NA,NA
"20484",2018-02-02,NA,NA,NA,NA
"20485",2018-02-03,NA,NA,NA,NA
"20486",2018-02-04,-67,NA,NA,NA
"20487",2018-02-05,NA,NA,NA,NA
"20488",2018-02-06,-62,NA,NA,NA
"20489",2018-02-07,NA,NA,NA,NA
"20490",2018-02-08,-39,NA,NA,NA
"20491",2018-02-09,-1,NA,NA,NA
"20492",2018-02-10,NA,NA,NA,NA
"20493",2018-02-11,NA,NA,NA,NA
"20494",2018-02-12,NA,NA,NA,NA
"20495",2018-02-13,-50,NA,NA,NA
"20496",2018-02-14,NA,NA,NA,NA
"20497",2018-02-15,NA,NA,NA,NA
"20498",2018-02-16,-3,NA,NA,NA
"20499",2018-02-17,10,79,5,69
"20500",2018-02-18,NA,NA,NA,NA
"20501",2018-02-19,NA,NA,NA,NA
"20502",2018-02-20,NA,NA,15,NA
"20503",2018-02-21,NA,106,NA,NA
"20504",2018-02-22,-7,NA,NA,NA
"20505",2018-02-23,8,NA,NA,NA
"20506",2018-02-24,NA,NA,NA,NA
"20507",2018-02-25,-33,132,NA,165
"20508",2018-02-26,12,NA,NA,NA
"20509",2018-02-27,NA,NA,25,NA
"20510",2018-02-28,NA,NA,NA,NA
"20511",2018-03-01,NA,NA,NA,NA
"20512",2018-03-02,NA,NA,NA,NA
"20513",2018-03-03,55,NA,30,NA
"20514",2018-03-04,NA,NA,86,NA
"20515",2018-03-05,NA,80,69,NA
"20516",2018-03-06,27,NA,13,NA
"20517",2018-03-07,NA,NA,3,NA
"20518",2018-03-08,NA,NA,0,NA
"20519",2018-03-09,-3,NA,0,NA
"20520",2018-03-10,28,NA,NA,NA
"20521",2018-03-11,NA,NA,NA,NA
"20522",2018-03-12,65,NA,NA,NA
"20523",2018-03-13,92,NA,NA,NA
"20524",2018-03-14,NA,NA,NA,NA
"20525",2018-03-15,NA,NA,NA,NA
"20526",2018-03-16,NA,NA,NA,NA
"20527",2018-03-17,NA,NA,89,NA
"20528",2018-03-18,NA,NA,NA,NA
"20529",2018-03-19,NA,NA,NA,NA
"20530",2018-03-20,NA,NA,NA,NA
"20531",2018-03-21,28,NA,NA,NA
"20532",2018-03-22,33,NA,NA,NA
"20533",2018-03-23,66,NA,NA,NA
"20534",2018-03-24,NA,NA,NA,NA
"20535",2018-03-25,76,NA,NA,NA
"20536",2018-03-26,105,NA,NA,NA
"20537",2018-03-27,119,NA,NA,NA
"20538",2018-03-28,132,NA,NA,NA
"20539",2018-03-29,NA,NA,NA,NA
"20540",2018-03-30,NA,NA,NA,NA
"20541",2018-03-31,115,NA,NA,NA
"20542",2018-04-01,NA,NA,NA,NA
"20543",2018-04-02,140,NA,NA,NA
"20544",2018-04-03,NA,NA,NA,NA
"20545",2018-04-04,NA,NA,36,NA
"20546",2018-04-05,NA,NA,3,NA
"20547",2018-04-06,NA,NA,0,NA
"20548",2018-04-07,23,NA,NA,NA
"20549",2018-04-08,62,NA,NA,NA
"20550",2018-04-09,108,NA,NA,NA
"20551",2018-04-10,NA,NA,NA,NA
"20552",2018-04-11,NA,256,NA,NA
"20553",2018-04-12,NA,NA,135,NA
"20554",2018-04-13,NA,NA,211,NA
"20555",2018-04-14,NA,NA,178,NA
"20556",2018-04-15,76,NA,0,NA
"20557",2018-04-16,76,NA,NA,NA
"20558",2018-04-17,108,NA,NA,NA
"20559",2018-04-18,124,NA,NA,NA
"20560",2018-04-19,NA,NA,NA,NA
"20561",2018-04-20,153,NA,33,NA
"20562",2018-04-21,NA,NA,74,NA
"20563",2018-04-22,NA,NA,0,NA
"20564",2018-04-23,123,NA,0,NA
"20565",2018-04-24,NA,NA,NA,NA
"20566",2018-04-25,NA,NA,13,NA
"20567",2018-04-26,122,NA,NA,NA
"20568",2018-04-27,140,NA,NA,NA
"20569",2018-04-28,144,NA,NA,NA
"20570",2018-04-29,NA,NA,NA,NA
"20571",2018-04-30,173,NA,51,NA
"20572",2018-06-01,197,NA,NA,NA
"20573",2018-06-02,NA,NA,NA,NA
"20574",2018-06-03,185,NA,NA,NA
"20575",2018-06-04,NA,NA,NA,NA
"20576",2018-06-05,183,NA,NA,NA
"20577",2018-06-06,232,NA,NA,NA
"20578",2018-06-07,NA,NA,NA,NA
"20579",2018-06-08,NA,NA,152,NA
"20580",2018-06-09,NA,NA,30,NA
"20581",2018-06-10,167,NA,3,NA
"20582",2018-06-11,185,NA,0,NA
"20583",2018-06-12,221,NA,NA,NA
"20584",2018-06-13,NA,NA,NA,NA
"20585",2018-06-14,NA,NA,NA,NA
"20586",2018-06-15,225,NA,NA,NA
"20587",2018-06-16,NA,NA,NA,NA
"20588",2018-06-17,NA,NA,3,NA
"20589",2018-06-18,NA,NA,191,NA
"20590",2018-06-19,211,NA,183,NA
"20591",2018-06-20,NA,NA,0,NA
"20592",2018-06-21,NA,NA,NA,NA
"20593",2018-06-22,NA,NA,NA,NA
"20594",2018-06-23,NA,NA,NA,NA
"20595",2018-06-24,240,NA,33,NA
"20596",2018-06-25,NA,NA,5,NA
"20597",2018-06-26,NA,260,89,NA
"20598",2018-06-27,232,NA,64,NA
"20599",2018-06-28,NA,NA,0,NA
"20600",2018-06-29,234,NA,NA,NA
"20601",2018-06-30,NA,NA,3,NA
"20602",2018-07-01,235,NA,NA,NA
"20603",2018-07-02,NA,305,NA,NA
"20604",2018-07-03,255,NA,NA,NA
"20605",2018-07-04,NA,NA,142,NA
"20606",2018-07-05,224,331,NA,107
"20607",2018-07-06,NA,NA,NA,NA
"20608",2018-07-07,NA,NA,NA,NA
"20609",2018-07-08,NA,NA,13,NA
"20610",2018-07-09,NA,NA,15,NA
"20611",2018-07-10,228,NA,3,NA
"20612",2018-07-11,237,NA,NA,NA
"20613",2018-07-12,246,NA,109,NA
"20614",2018-07-13,251,NA,191,NA
"20615",2018-07-14,NA,NA,3,NA
"20616",2018-07-15,266,NA,NA,NA
"20617",2018-07-16,NA,NA,38,NA
"20618",2018-07-17,262,NA,NA,NA
"20619",2018-07-18,NA,NA,NA,NA
"20620",2018-07-19,NA,NA,NA,NA
"20621",2018-07-20,NA,NA,NA,NA
"20622",2018-07-21,NA,NA,NA,NA
"20623",2018-07-22,285,NA,NA,NA
"20624",2018-07-23,NA,NA,NA,NA
"20625",2018-07-24,285,NA,NA,NA
"20626",2018-07-25,NA,NA,84,NA
"20627",2018-07-26,NA,NA,91,NA
"20628",2018-07-27,NA,NA,64,NA
"20629",2018-07-28,NA,NA,36,NA
"20630",2018-07-29,NA,NA,3,NA
"20631",2018-07-30,NA,NA,8,NA
"20632",2018-07-31,255,NA,NA,NA
"20633",2018-08-01,NA,NA,211,NA
"20634",2018-08-02,NA,350,NA,NA
"20635",2018-08-03,266,NA,NA,NA
"20636",2018-08-04,277,NA,NA,NA
"20637",2018-08-05,NA,NA,10,NA
"20638",2018-08-06,NA,NA,NA,NA
"20639",2018-08-07,NA,NA,NA,NA
"20640",2018-08-08,NA,NA,NA,NA
"20641",2018-08-09,NA,NA,NA,NA
"20642",2018-08-10,NA,NA,15,NA
"20643",2018-08-11,NA,NA,NA,NA
"20644",2018-08-12,NA,NA,NA,NA
"20645",2018-08-13,255,NA,3,NA
"20646",2018-08-14,NA,NA,NA,NA
"20647",2018-08-15,NA,NA,NA,NA
"20648",2018-08-16,NA,NA,244,NA
"20649",2018-08-17,NA,NA,23,NA
"20650",2018-08-18,217,NA,752,NA
"20651",2018-08-19,NA,NA,241,NA
"20652",2018-08-20,214,NA,99,NA
"20653",2018-08-21,226,NA,0,NA
"20654",2018-08-22,NA,NA,NA,NA
"20655",2018-08-23,NA,NA,NA,NA
"20656",2018-08-24,NA,NA,NA,NA
"20657",2018-08-25,213,NA,NA,NA
"20658",2018-08-26,NA,NA,NA,NA
"20659",2018-08-27,218,NA,NA,NA
"20660",2018-08-28,140,NA,NA,NA
"20661",2018-08-29,241,NA,NA,NA
"20662",2018-08-30,NA,NA,NA,NA
"20663",2018-08-31,NA,NA,8,NA
"20664",2018-09-01,217,NA,NA,NA
"20665",2018-09-02,251,NA,NA,NA
"20666",2018-09-03,NA,NA,NA,NA
"20667",2018-09-04,201,NA,NA,NA
"20668",2018-09-05,NA,NA,3,NA
"20669",2018-09-06,NA,NA,NA,NA
"20670",2018-09-07,159,NA,NA,NA
"20671",2018-09-08,158,NA,NA,NA
"20672",2018-09-09,170,NA,NA,NA
"20673",2018-09-10,NA,NA,NA,NA
"20674",2018-09-11,166,NA,NA,NA
"20675",2018-09-12,184,NA,NA,NA
"20676",2018-09-13,188,NA,64,NA
"20677",2018-09-14,NA,NA,15,NA
"20678",2018-09-15,NA,NA,NA,NA
"20679",2018-09-16,NA,227,66,NA
"20680",2018-09-17,NA,NA,NA,NA
"20681",2018-09-18,NA,NA,310,NA
"20682",2018-09-19,178,NA,211,NA
"20683",2018-09-20,NA,227,155,NA
"20684",2018-09-21,NA,NA,0,NA
"20685",2018-09-22,126,NA,NA,NA
"20686",2018-09-23,NA,287,NA,NA
"20687",2018-09-24,136,NA,10,NA
"20688",2018-09-25,NA,NA,213,NA
"20689",2018-09-26,NA,NA,188,NA
"20690",2018-09-27,127,NA,5,NA
"20691",2018-09-28,NA,NA,NA,NA
"20692",2018-09-29,114,304,NA,190
"20693",2018-09-30,NA,NA,NA,NA
"20694",2019-03-01,18,NA,3,NA
"20695",2019-03-02,NA,NA,18,NA
"20696",2019-03-03,NA,NA,0,NA
"20697",2019-03-04,22,NA,0,NA
"20698",2019-03-05,NA,NA,NA,NA
"20699",2019-03-06,NA,NA,NA,NA
"20700",2019-03-07,NA,NA,NA,NA
"20701",2019-03-08,-2,NA,NA,NA
"20702",2019-03-09,28,NA,NA,NA
"20703",2019-03-10,32,NA,NA,NA
"20704",2019-03-11,NA,NA,NA,NA
"20705",2019-03-12,NA,157,NA,NA
"20706",2019-03-13,NA,149,NA,NA
"20707",2019-03-14,NA,NA,NA,NA
"20708",2019-03-15,35,NA,NA,NA
"20709",2019-03-16,53,NA,NA,NA
"20710",2019-03-17,76,NA,NA,NA
"20711",2019-03-18,NA,NA,NA,NA
"20712",2019-03-19,85,NA,NA,NA
"20713",2019-03-20,NA,NA,NA,NA
"20714",2019-03-21,NA,178,NA,NA
"20715",2019-03-22,31,NA,NA,NA
"20716",2019-03-23,NA,NA,NA,NA
"20717",2019-03-24,43,NA,NA,NA
"20718",2019-03-25,53,NA,NA,NA
"20719",2019-03-26,85,NA,NA,NA
"20720",2019-03-27,NA,NA,NA,NA
"20721",2019-03-28,NA,NA,NA,NA
"20722",2019-03-29,NA,NA,NA,NA
"20723",2019-03-30,NA,NA,NA,NA
"20724",2019-03-31,49,NA,NA,NA
"20725",2019-10-01,179,NA,NA,NA
"20726",2019-10-02,NA,NA,NA,NA
"20727",2019-10-03,169,NA,3,NA
"20728",2019-10-04,NA,NA,249,NA
"20729",2019-10-05,NA,NA,18,NA
"20730",2019-10-06,NA,NA,201,NA
"20731",2019-10-07,93,NA,175,NA
"20732",2019-10-08,105,NA,15,NA
"20733",2019-10-09,NA,NA,315,NA
"20734",2019-10-10,136,NA,282,NA
"20735",2019-10-11,162,NA,0,NA
"20736",2019-10-12,NA,NA,NA,NA
"20737",2019-10-13,NA,NA,3,NA
"20738",2019-10-14,NA,NA,0,NA
"20739",2019-10-15,NA,NA,3,NA
"20740",2019-10-16,NA,NA,5,NA
"20741",2019-10-17,NA,NA,0,NA
"20742",2019-10-18,83,NA,0,NA
"20743",2019-10-19,97,NA,NA,NA
"20744",2019-10-20,118,NA,NA,NA
"20745",2019-10-21,NA,NA,3,NA
"20746",2019-10-22,NA,NA,3,NA
"20747",2019-10-23,NA,222,NA,NA
"20748",2019-10-24,110,213,NA,103
"20749",2019-10-25,NA,166,NA,NA
"20750",2019-10-26,NA,175,NA,NA
"20751",2019-10-27,57,240,NA,183
"20752",2019-10-28,NA,NA,NA,NA
"20753",2019-10-29,66,235,NA,169
"20754",2019-10-30,73,NA,NA,NA
"20755",2019-10-31,111,271,NA,160
"20756",2019-11-01,121,214,NA,93
"20757",2019-11-02,NA,NA,NA,NA
"20758",2019-11-03,NA,188,NA,NA
"20759",2019-11-04,NA,NA,NA,NA
"20760",2019-11-05,77,204,NA,127
"20761",2019-11-06,NA,NA,NA,NA
"20762",2019-11-07,NA,NA,NA,NA
"20763",2019-11-08,66,193,NA,127
"20764",2019-11-09,68,200,NA,132
"20765",2019-11-10,NA,NA,0,NA
"20766",2019-11-11,68,215,NA,147
"20767",2019-11-12,91,NA,5,NA
"20768",2019-11-13,NA,171,NA,NA
"20769",2019-11-14,39,225,NA,186
"20770",2019-11-15,52,NA,NA,NA
"20771",2019-11-16,59,NA,13,NA
"20772",2019-11-17,NA,148,20,NA
"20773",2019-11-18,NA,NA,NA,NA
"20774",2019-11-19,2,NA,NA,NA
"20775",2019-11-20,15,135,NA,120
"20776",2019-11-21,NA,159,0,NA
"20777",2019-11-22,48,167,NA,119
"20778",2019-11-23,89,NA,NA,NA
"20779",2019-11-24,NA,115,3,NA
"20780",2019-11-25,NA,107,0,NA
"20781",2019-11-26,6,68,0,62
"20782",2019-11-27,NA,68,0,NA
"20783",2019-11-28,-17,73,0,90
"20784",2019-11-29,13,73,0,60
"20785",2019-11-30,NA,71,0,NA
"20786",2019-12-01,NA,116,0,NA
"20787",2019-12-02,NA,116,0,NA
"20788",2019-12-03,NA,NA,0,NA
"20789",2019-12-04,8,144,0,136
"20790",2019-12-05,NA,144,0,NA
"20791",2019-12-06,NA,103,0,NA
"20792",2019-12-07,NA,96,0,NA
"20793",2019-12-08,-34,149,0,183
"20794",2019-12-09,-17,NA,0,NA
"20795",2019-12-10,NA,181,0,NA
"20796",2019-12-11,-12,169,0,181
"20797",2019-12-12,NA,169,0,NA
"20798",2019-12-13,-2,NA,0,NA
"20799",2019-12-14,NA,162,5,NA
"20800",2019-12-15,NA,64,79,NA
"20801",2019-12-16,25,NA,3,NA
"20802",2019-12-17,NA,103,0,NA
"20803",2019-12-18,NA,103,0,NA
"20804",2019-12-19,NA,111,0,NA
"20805",2019-12-20,-20,111,0,131
"20806",2019-12-21,NA,83,0,NA
"20807",2019-12-22,NA,103,0,NA
"20808",2019-12-23,-21,103,0,124
"20809",2019-12-24,6,46,0,40
"20810",2019-12-25,NA,47,0,NA
"20811",2019-12-26,NA,NA,0,NA
"20812",2019-12-27,-47,145,0,192
"20813",2019-12-28,-43,145,0,188
"20814",2019-12-29,-24,134,0,158
"20815",2019-12-30,NA,134,0,NA
"20816",2019-12-31,NA,53,0,NA
"20817",2020-01-01,-50,52,0,102
"20818",2020-01-02,-32,74,0,106
"20819",2020-01-03,NA,100,0,NA
"20820",2020-01-04,-16,110,0,126
"20821",2020-01-05,-15,110,290,125
"20822",2020-01-06,NA,32,132,NA
"20823",2020-01-07,NA,40,36,NA
"20824",2020-01-08,NA,45,0,NA
"20825",2020-01-09,-4,57,0,61
"20826",2020-01-10,20,75,0,55
"20827",2020-01-11,NA,75,0,NA
"20828",2020-01-12,-31,44,0,75
"20829",2020-01-13,NA,NA,0,NA
"20830",2020-01-14,-48,58,0,106
"20831",2020-01-15,-47,36,10,83
"20832",2020-01-16,-12,24,3,36
"20833",2020-01-17,NA,71,0,NA
"20834",2020-01-18,NA,79,0,NA
"20835",2020-01-19,-13,106,0,119
"20836",2020-01-20,-23,106,0,129
"20837",2020-01-21,-23,85,0,108
"20838",2020-01-22,NA,81,0,NA
"20839",2020-01-23,-23,81,0,104
"20840",2020-01-24,-23,81,0,104
"20841",2020-01-25,NA,63,0,NA
"20842",2020-01-26,8,63,3,55
"20843",2020-01-27,NA,NA,0,NA
"20844",2020-01-28,NA,102,0,NA
"20845",2020-01-29,-32,102,0,134
"20846",2020-01-30,NA,116,0,NA
"20847",2020-01-31,-26,150,0,176
"20848",2020-02-01,-23,150,0,173
"20849",2020-02-02,NA,NA,0,NA
"20850",2020-02-03,NA,136,0,NA
"20851",2020-02-04,NA,92,0,NA
"20852",2020-02-05,NA,91,33,NA
"20853",2020-02-06,NA,-1,15,NA
"20854",2020-02-07,NA,77,0,NA
"20855",2020-02-08,NA,122,0,NA
"20856",2020-02-09,-24,NA,0,NA
"20857",2020-02-10,7,190,0,183
"20858",2020-02-11,NA,190,0,NA
"20859",2020-02-12,NA,168,0,NA
"20860",2020-02-13,24,168,0,144
"20861",2020-02-14,NA,131,61,NA
"20862",2020-02-15,NA,126,5,NA
"20863",2020-02-16,NA,90,0,NA
"20864",2020-02-17,NA,136,0,NA
"20865",2020-02-18,-23,155,0,178
"20866",2020-02-19,-8,155,0,163
"20867",2020-02-20,1,146,0,145
"20868",2020-02-21,NA,163,0,NA
"20869",2020-02-22,18,163,0,145
"20870",2020-02-23,29,188,0,159
"20871",2020-02-24,NA,188,0,NA
"20872",2020-02-25,62,160,0,98
"20873",2020-02-26,NA,139,61,NA
"20874",2020-02-27,NA,79,165,NA
"20875",2020-02-28,NA,106,46,NA
"20876",2020-02-29,18,106,0,88
"20877",2020-03-01,NA,123,0,NA
"20878",2020-03-02,NA,123,0,NA
"20879",2020-03-03,NA,130,0,NA
"20880",2020-03-04,NA,130,0,NA
"20881",2020-03-05,1,142,0,141
"20882",2020-03-06,24,175,0,151
"20883",2020-03-07,67,176,3,109
"20884",2020-03-08,76,176,0,100
"20885",2020-03-09,NA,172,18,NA
"20886",2020-03-10,NA,NA,0,NA
"20887",2020-03-11,16,197,0,181
"20888",2020-03-12,50,217,0,167
"20889",2020-03-13,26,217,0,191
"20890",2020-03-14,24,189,0,165
"20891",2020-03-15,NA,221,0,NA
"20892",2020-03-16,NA,221,0,NA
"20893",2020-03-17,NA,258,0,NA
"20894",2020-03-18,63,NA,0,NA
"20895",2020-03-19,NA,281,0,NA
"20896",2020-03-20,85,282,0,197
"20897",2020-03-21,NA,282,5,NA
"20898",2020-03-22,NA,276,0,NA
"20899",2020-03-23,85,232,0,147
"20900",2020-03-24,128,234,0,106
"20901",2020-03-25,NA,234,15,NA
"20902",2020-03-26,NA,191,5,NA
"20903",2020-03-27,NA,159,0,NA
"20904",2020-03-28,28,147,0,119
"20905",2020-03-29,NA,147,18,NA
"20906",2020-03-30,30,139,0,109
"20907",2020-03-31,NA,150,0,NA
"20908",2020-04-01,56,150,8,94
"20909",2020-04-02,NA,144,0,NA
"20910",2020-04-03,45,201,0,156
"20911",2020-04-04,58,221,0,163
"20912",2020-04-05,74,221,0,147
"20913",2020-04-06,91,227,0,136
"20914",2020-04-07,85,243,0,158
"20915",2020-04-08,NA,243,0,NA
"20916",2020-04-09,60,216,0,156
"20917",2020-04-10,16,138,168,122
"20918",2020-04-11,16,166,8,150
"20919",2020-04-12,46,232,0,186
"20920",2020-04-13,57,260,0,203
"20921",2020-04-14,NA,260,0,NA
"20922",2020-04-15,95,273,0,178
"20923",2020-04-16,127,273,0,146
"20924",2020-04-17,121,266,0,145
"20925",2020-04-18,NA,261,48,NA
"20926",2020-04-19,108,228,5,120
"20927",2020-04-20,NA,228,0,NA
"20928",2020-04-21,NA,213,0,NA
"20929",2020-04-22,NA,213,0,NA
"20930",2020-04-23,70,222,0,152
"20931",2020-04-24,67,256,0,189
"20932",2020-04-25,106,NA,0,NA
"20933",2020-04-26,111,266,0,155
"20934",2020-04-27,NA,266,0,NA
"20935",2020-04-28,110,260,0,150
"20936",2020-04-29,117,306,0,189
"20937",2020-04-30,156,351,0,195
"20938",2020-05-01,NA,351,0,NA
"20939",2020-05-02,NA,359,0,NA
"20940",2020-05-03,200,408,0,208
"20941",2020-05-04,NA,NA,0,NA
"20942",2020-05-05,NA,245,0,NA
"20943",2020-05-06,141,245,0,104
"20944",2020-05-07,166,227,409,61
"20945",2020-05-08,NA,225,36,NA
"20946",2020-05-09,NA,225,43,NA
"20947",2020-05-10,145,303,0,158
"20948",2020-05-11,NA,303,0,NA
"20949",2020-05-12,NA,NA,0,NA
"20950",2020-05-13,154,307,0,153
"20951",2020-05-14,NA,304,0,NA
"20952",2020-05-15,156,318,0,162
"20953",2020-05-16,NA,354,0,NA
"20954",2020-05-17,NA,354,5,NA
"20955",2020-05-18,NA,353,NA,NA
"20956",2020-05-19,143,NA,0,NA
"20957",2020-05-20,NA,318,0,NA
"20958",2020-05-21,180,NA,0,NA
"20959",2020-05-22,197,344,0,147
"20960",2020-05-23,NA,NA,0,NA
"20961",2020-05-24,202,349,0,147
"20962",2020-05-25,NA,320,0,NA
"20963",2020-05-26,NA,320,0,NA
"20964",2020-05-27,181,NA,0,NA
"20965",2020-05-28,219,NA,0,NA
"20966",2020-05-29,NA,358,0,NA
"20967",2020-05-30,NA,328,53,NA
"20968",2020-05-31,195,351,NA,156
"20969",2020-06-01,232,351,18,119
"20970",2020-06-02,175,348,0,173
"20971",2020-06-03,174,394,0,220
"20972",2020-06-04,217,396,0,179
"20973",2020-06-05,NA,396,0,NA
"20974",2020-06-06,NA,360,0,NA
"20975",2020-06-07,NA,361,0,NA
"20976",2020-06-08,NA,361,66,NA
"20977",2020-06-09,NA,344,15,NA
"20978",2020-06-10,224,329,0,105
"20979",2020-06-11,NA,329,272,NA
"20980",2020-06-12,NA,297,0,NA
"20981",2020-06-13,208,330,0,122
"20982",2020-06-14,239,340,0,101
"20983",2020-06-15,NA,340,56,NA
"20984",2020-06-16,NA,313,480,NA
"20985",2020-06-17,NA,216,259,NA
"20986",2020-06-18,188,295,0,107
"20987",2020-06-19,205,295,0,90
"20988",2020-06-20,NA,294,0,NA
"20989",2020-06-21,210,294,0,84
"20990",2020-06-22,NA,294,3,NA
"20991",2020-06-23,NA,298,0,NA
"20992",2020-06-24,217,337,15,120
"20993",2020-06-25,217,344,0,127
"20994",2020-06-26,238,344,130,106
"20995",2020-06-27,NA,320,0,NA
"20996",2020-06-28,NA,320,0,NA
"20997",2020-06-29,233,324,0,91
"20998",2020-06-30,NA,324,0,NA
"20999",2020-07-01,222,304,0,82
"21000",2020-07-02,NA,315,94,NA
"21001",2020-07-03,226,315,0,89
"21002",2020-07-04,233,NA,564,NA
"21003",2020-07-05,233,NA,0,NA
"21004",2020-07-06,233,366,0,133
"21005",2020-07-07,NA,366,0,NA
"21006",2020-07-08,NA,354,104,NA
"21007",2020-07-09,NA,336,8,NA
"21008",2020-07-10,230,314,0,84
"21009",2020-07-11,190,304,163,114
"21010",2020-07-12,190,265,28,75
"21011",2020-07-13,195,290,0,95
"21012",2020-07-14,200,290,18,90
"21013",2020-07-15,199,308,0,109
"21014",2020-07-16,217,308,0,91
"21015",2020-07-17,NA,305,74,NA
"21016",2020-07-18,217,286,20,69
"21017",2020-07-19,197,290,8,93
"21018",2020-07-20,197,342,0,145
"21019",2020-07-21,NA,342,48,NA
"21020",2020-07-22,NA,309,127,NA
"21021",2020-07-23,208,305,0,97
"21022",2020-07-24,NA,312,0,NA
"21023",2020-07-25,201,314,3,113
"21024",2020-07-26,NA,314,13,NA
"21025",2020-07-27,NA,285,0,NA
"21026",2020-07-28,214,NA,0,NA
"21027",2020-07-29,NA,322,0,NA
"21028",2020-07-30,NA,333,0,NA
"21029",2020-07-31,246,333,0,87
"21030",2020-08-01,NA,NA,5,NA
"21031",2020-08-02,NA,344,0,NA
"21032",2020-08-03,NA,345,157,NA
"21033",2020-08-04,245,345,38,100
"21034",2020-08-05,231,323,25,92
"21035",2020-08-06,230,306,521,76
"21036",2020-08-07,NA,265,366,NA
"21037",2020-08-08,234,316,3,82
"21038",2020-08-09,243,363,0,120
"21039",2020-08-10,254,363,0,109
"21040",2020-08-11,258,348,0,90
"21041",2020-08-12,NA,337,23,NA
"21042",2020-08-13,NA,337,20,NA
"21043",2020-08-14,251,326,10,75
"21044",2020-08-15,NA,326,30,NA
"21045",2020-08-16,226,NA,25,NA
"21046",2020-08-17,232,349,0,117
"21047",2020-08-18,NA,349,0,NA
"21048",2020-08-19,NA,342,48,NA
"21049",2020-08-20,207,274,61,67
"21050",2020-08-21,210,254,0,44
"21051",2020-08-22,206,254,5,48
"21052",2020-08-23,209,NA,0,NA
"21053",2020-08-24,215,300,0,85
"21054",2020-08-25,198,345,0,147
"21055",2020-08-26,NA,345,0,NA
"21056",2020-08-27,198,336,0,138
"21057",2020-08-28,NA,337,0,NA
"21058",2020-08-29,NA,340,0,NA
"21059",2020-08-30,216,340,0,124
"21060",2020-08-31,NA,337,0,NA
"21061",2020-09-01,NA,NA,3,NA
"21062",2020-09-02,NA,337,NA,NA
"21063",2020-09-03,NA,NA,0,NA
"21064",2020-09-04,NA,354,0,NA
"21065",2020-09-05,176,354,0,178
"21066",2020-09-06,NA,350,0,NA
"21067",2020-09-07,NA,350,193,NA
"21068",2020-09-08,194,349,89,155
"21069",2020-09-09,209,330,279,121
"21070",2020-09-10,NA,320,10,NA
"21071",2020-09-11,202,296,0,94
"21072",2020-09-12,208,284,0,76
"21073",2020-09-13,NA,281,0,NA
"21074",2020-09-14,NA,292,0,NA
"21075",2020-09-15,NA,NA,0,NA
"21076",2020-09-16,163,NA,0,NA
"21077",2020-09-17,NA,307,0,NA
"21078",2020-09-18,146,322,0,176
"21079",2020-09-19,NA,322,0,NA
"21080",2020-09-20,164,315,0,151
"21081",2020-09-21,NA,289,15,NA
"21082",2020-09-22,168,247,0,79
"21083",2020-09-23,NA,283,0,NA
"21084",2020-09-24,172,283,0,111
"21085",2020-09-25,NA,275,0,NA
"21086",2020-09-26,NA,261,25,NA
"21087",2020-09-27,NA,NA,23,NA
"21088",2020-09-28,161,NA,0,NA
"21089",2020-09-29,NA,257,0,NA
"21090",2020-09-30,NA,257,0,NA
"21091",2020-10-01,167,281,3,114
"21092",2020-10-02,NA,281,43,NA
"21093",2020-10-03,144,208,3,64
"21094",2020-10-04,NA,183,0,NA
"21095",2020-10-05,NA,181,8,NA
"21096",2020-10-06,84,NA,0,NA
"21097",2020-10-07,NA,210,0,NA
"21098",2020-10-08,112,223,0,111
"21099",2020-10-09,148,NA,0,NA
"21100",2020-10-10,160,228,0,68
"21101",2020-10-11,160,NA,NA,NA
"21102",2020-10-12,NA,208,10,NA
"21103",2020-10-13,NA,184,147,NA
"21104",2020-10-14,NA,170,89,NA
"21105",2020-10-15,116,156,8,40
"21106",2020-10-16,NA,NA,0,NA
"21107",2020-10-17,NA,209,0,NA
"21108",2020-10-18,NA,214,0,NA
"21109",2020-10-19,NA,221,0,NA
"21110",2020-10-20,86,221,0,135
"21111",2020-10-21,NA,242,0,NA
"21112",2020-10-22,NA,242,0,NA
"21113",2020-10-23,NA,222,0,NA
"21114",2020-10-24,53,NA,0,NA
"21115",2020-10-25,85,232,0,147
"21116",2020-10-26,122,251,0,129
"21117",2020-10-27,NA,251,0,NA
"21118",2020-10-28,NA,NA,0,NA
"21119",2020-10-29,80,204,0,124
"21120",2020-10-30,73,204,3,131
"21121",2020-10-31,98,226,NA,128
"21122",2020-11-01,82,226,0,144
"21123",2020-11-02,NA,223,0,NA
"21124",2020-11-03,52,215,0,163
"21125",2020-11-04,NA,NA,0,NA
"21126",2020-11-05,NA,NA,0,NA
"21127",2020-11-06,NA,NA,0,NA
"21128",2020-11-07,90,233,0,143
"21129",2020-11-08,NA,233,0,NA
"21130",2020-11-09,56,NA,0,NA
"21131",2020-11-10,53,210,0,157
"21132",2020-11-11,NA,210,0,NA
"21133",2020-11-12,84,NA,0,NA
"21134",2020-11-13,NA,229,0,NA
"21135",2020-11-14,70,191,0,121
"21136",2020-11-15,78,198,3,120
"21137",2020-11-16,82,198,0,116
"21138",2020-11-17,NA,171,287,NA
"21139",2020-11-18,NA,NA,15,NA
"21140",2020-11-19,NA,174,0,NA
"21141",2020-11-20,NA,171,46,NA
"21142",2020-11-21,40,113,23,73
"21143",2020-11-22,NA,73,5,NA
"21144",2020-11-23,NA,63,23,NA
"21145",2020-11-24,NA,NA,0,NA
"21146",2020-11-25,28,77,0,49
"21147",2020-11-26,7,77,0,70
"21148",2020-11-27,7,83,0,76
"21149",2020-11-28,NA,83,0,NA
"21150",2020-11-29,-12,92,0,104
"21151",2020-11-30,-6,92,0,98
"21152",2020-12-01,NA,42,51,NA
"21153",2020-12-02,NA,47,0,NA
"21154",2020-12-03,NA,54,0,NA
"21155",2020-12-04,-25,82,0,107
"21156",2020-12-05,NA,92,0,NA
"21157",2020-12-06,-10,95,0,105
"21158",2020-12-07,NA,95,0,NA
"21159",2020-12-08,-16,60,0,76
"21160",2020-12-09,NA,104,0,NA
"21161",2020-12-10,NA,NA,0,NA
"21162",2020-12-11,-14,120,0,134
"21163",2020-12-12,-14,136,0,150
"21164",2020-12-13,NA,136,0,NA
"21165",2020-12-14,NA,39,0,NA
"21166",2020-12-15,NA,69,0,NA
"21167",2020-12-16,-52,69,0,121
"21168",2020-12-17,-42,65,0,107
"21169",2020-12-18,NA,65,0,NA
"21170",2020-12-19,NA,70,0,NA
"21171",2020-12-20,NA,93,0,NA
"21172",2020-12-21,-50,113,0,163
"21173",2020-12-22,NA,125,0,NA
"21174",2020-12-23,NA,NA,0,NA
"21175",2020-12-24,NA,127,0,NA
"21176",2020-12-25,NA,133,0,NA
"21177",2020-12-26,-33,133,0,166
"21178",2020-12-27,NA,133,0,NA
"21179",2020-12-28,-6,133,33,139
"21180",2020-12-29,NA,73,0,NA
"21181",2020-12-30,NA,5,0,NA
"21182",2020-12-31,NA,NA,0,NA
"21183",2021-01-01,NA,102,0,NA
"21184",2021-01-02,-46,102,0,148
"21185",2021-01-03,NA,94,0,NA
"21186",2021-01-04,NA,41,0,NA
"21187",2021-01-05,NA,30,0,NA
"21188",2021-01-06,NA,NA,0,NA
"21189",2021-01-07,NA,32,0,NA
"21190",2021-01-08,-105,24,0,129
"21191",2021-01-09,NA,47,0,NA
"21192",2021-01-10,-35,47,0,82
"21193",2021-01-11,-45,58,0,103
"21194",2021-01-12,-45,149,0,194
"21195",2021-01-13,-42,NA,0,NA
"21196",2021-01-14,-10,176,0,186
"21197",2021-01-15,-9,176,0,185
"21198",2021-01-16,NA,87,0,NA
"21199",2021-01-17,NA,90,0,NA
"21200",2021-01-18,NA,NA,0,NA
"21201",2021-01-19,-41,148,0,189
"21202",2021-01-20,-32,56,0,88
"21203",2021-01-21,NA,100,0,NA
"21204",2021-01-22,-14,100,0,114
"21205",2021-01-23,-12,85,0,97
"21206",2021-01-24,10,85,0,75
"21207",2021-01-25,6,90,5,84
"21208",2021-01-26,NA,125,0,NA
"21209",2021-01-27,NA,125,0,NA
"21210",2021-01-28,NA,123,0,NA
"21211",2021-01-29,-31,151,0,182
"21212",2021-01-30,-21,NA,0,NA
"21213",2021-01-31,-1,165,0,166
"21214",2021-02-01,-2,167,0,169
"21215",2021-02-02,NA,167,0,NA
"21216",2021-02-03,NA,168,0,NA
"21217",2021-02-04,-11,168,0,179
"21218",2021-02-05,-2,NA,0,NA
"21219",2021-02-06,11,220,0,209
"21220",2021-02-07,NA,220,0,NA
"21221",2021-02-08,NA,109,0,NA
"21222",2021-02-09,NA,128,0,NA
"21223",2021-02-10,NA,NA,0,NA
"21224",2021-02-11,NA,NA,NA,NA
"21225",2021-02-12,NA,NA,NA,NA
"21226",2021-02-13,NA,149,25,NA
"21227",2021-02-14,NA,206,15,NA
"21228",2021-02-15,15,206,0,191
"21229",2021-02-16,NA,136,0,NA
"21230",2021-02-17,NA,136,0,NA
"21231",2021-02-18,-3,156,0,159
"21232",2021-02-19,NA,NA,0,NA
"21233",2021-02-20,51,268,0,217
"21234",2021-02-21,68,283,0,215
"21235",2021-02-22,NA,283,0,NA
"21236",2021-02-23,NA,188,0,NA
"21237",2021-02-24,NA,130,221,NA
"21238",2021-02-25,3,60,5,57
"21239",2021-02-26,21,88,0,67
"21240",2021-02-27,50,110,3,60
"21241",2021-02-28,NA,110,180,NA
"21242",2021-03-01,NA,83,5,NA
"21243",2021-03-02,4,144,0,140
"21244",2021-03-03,25,168,0,143
"21245",2021-03-04,39,213,0,174
"21246",2021-03-05,NA,213,0,NA
"21247",2021-03-06,NA,NA,0,NA
"21248",2021-03-07,NA,106,0,NA
"21249",2021-03-08,18,112,0,94
"21250",2021-03-09,44,171,0,127
"21251",2021-03-10,58,171,18,113
"21252",2021-03-11,NA,144,3,NA
"21253",2021-03-12,66,152,0,86
"21254",2021-03-13,NA,152,0,NA
"21255",2021-03-14,NA,NA,0,NA
"21256",2021-03-15,NA,204,NA,NA
"21257",2021-03-16,NA,204,0,NA
"21258",2021-03-17,77,153,0,76
"21259",2021-03-18,NA,153,0,NA
"21260",2021-03-19,NA,110,25,NA
"21261",2021-03-20,65,159,5,94
"21262",2021-03-21,NA,159,0,NA
"21263",2021-03-22,49,201,0,152
"21264",2021-03-23,38,242,0,204
"21265",2021-03-24,65,242,0,177
"21266",2021-03-25,96,233,3,137
"21267",2021-03-26,107,233,61,126
"21268",2021-03-27,NA,226,3,NA
"21269",2021-03-28,98,289,0,191
"21270",2021-03-29,NA,289,0,NA
"21271",2021-03-30,89,218,0,129
"21272",2021-03-31,NA,218,8,NA
"21273",2021-04-01,NA,168,5,NA
"21274",2021-04-02,NA,168,43,NA
"21275",2021-04-03,NA,153,5,NA
"21276",2021-04-04,32,165,0,133
"21277",2021-04-05,NA,165,0,NA
"21278",2021-04-06,41,198,0,157
"21279",2021-04-07,NA,198,0,NA
"21280",2021-04-08,71,223,0,152
"21281",2021-04-09,78,223,0,145
"21282",2021-04-10,87,215,0,128
"21283",2021-04-11,112,212,0,100
"21284",2021-04-12,NA,260,0,NA
"21285",2021-04-13,NA,260,0,NA
"21286",2021-04-14,124,209,0,85
"21287",2021-04-15,132,NA,0,NA
"21288",2021-04-16,NA,264,0,NA
"21289",2021-04-17,68,239,0,171
"21290",2021-04-18,121,239,0,118
"21291",2021-04-19,109,251,18,142
"21292",2021-04-20,NA,251,145,NA
"21293",2021-04-21,NA,156,23,NA
"21294",2021-04-22,NA,207,5,NA
"21295",2021-04-23,124,207,0,83
"21296",2021-04-24,NA,200,0,NA
"21297",2021-04-25,NA,171,0,NA
"21298",2021-04-26,119,241,0,122
"21299",2021-04-27,140,282,0,142
"21300",2021-04-28,158,282,0,124
"21301",2021-04-29,144,NA,0,NA
"21302",2021-04-30,NA,321,0,NA
"21303",2021-05-01,110,321,0,211
"21304",2021-05-02,147,277,0,130
"21305",2021-05-03,NA,205,28,NA
"21306",2021-05-04,110,275,0,165
"21307",2021-05-05,109,293,0,184
"21308",2021-05-06,154,340,0,186
"21309",2021-05-07,NA,340,0,NA
"21310",2021-05-08,131,363,0,232
"21311",2021-05-09,202,363,0,161
"21312",2021-05-10,NA,307,0,NA
"21313",2021-05-11,NA,267,0,NA
"21314",2021-05-12,154,284,0,130
"21315",2021-05-13,199,284,0,85
"21316",2021-05-14,NA,259,10,NA
"21317",2021-05-15,NA,259,112,NA
"21318",2021-05-16,NA,245,8,NA
"21319",2021-05-17,112,266,0,154
"21320",2021-05-18,131,293,0,162
"21321",2021-05-19,NA,293,0,NA
"21322",2021-05-20,NA,292,0,NA
"21323",2021-05-21,175,306,0,131
"21324",2021-05-22,182,333,0,151
"21325",2021-05-23,NA,333,5,NA
"21326",2021-05-24,NA,336,0,NA
"21327",2021-05-25,189,336,0,147
"21328",2021-05-26,NA,352,0,NA
"21329",2021-05-27,161,379,0,218
"21330",2021-05-28,NA,379,0,NA
"21331",2021-05-29,NA,398,0,NA
"21332",2021-05-30,205,398,0,193
"21333",2021-05-31,216,353,0,137
"21334",2021-06-01,219,353,0,134
"21335",2021-06-02,NA,362,251,NA
"21336",2021-06-03,167,362,0,195
"21337",2021-06-04,167,356,0,189
"21338",2021-06-05,185,395,0,210
"21339",2021-06-06,213,395,0,182
"21340",2021-06-07,NA,398,0,NA
"21341",2021-06-08,243,398,0,155
"21342",2021-06-09,NA,343,0,NA
"21343",2021-06-10,228,330,0,102
"21344",2021-06-11,247,353,0,106
"21345",2021-06-12,NA,353,10,NA
"21346",2021-06-13,NA,341,8,NA
"21347",2021-06-14,246,330,61,84
"21348",2021-06-15,NA,330,0,NA
"21349",2021-06-16,NA,325,0,NA
"21350",2021-06-17,NA,271,5,NA
"21351",2021-06-18,NA,302,0,NA
"21352",2021-06-19,194,342,0,148
"21353",2021-06-20,219,370,0,151
"21354",2021-06-21,228,370,0,142
"21355",2021-06-22,NA,368,0,NA
"21356",2021-06-23,221,368,0,147
"21357",2021-06-24,258,368,0,110
"21358",2021-06-25,230,356,109,126
"21359",2021-06-26,229,342,0,113
"21360",2021-06-27,246,344,0,98
"21361",2021-06-28,258,379,0,121
"21362",2021-06-29,247,379,15,132
"21363",2021-06-30,247,378,15,131
"21364",2021-07-01,NA,378,0,NA
"21365",2021-07-02,NA,315,447,NA
"21366",2021-07-03,232,334,0,102
"21367",2021-07-04,NA,346,0,NA
"21368",2021-07-05,NA,346,0,NA
"21369",2021-07-06,244,328,0,84
"21370",2021-07-07,NA,342,0,NA
"21371",2021-07-08,NA,378,0,NA
"21372",2021-07-09,230,386,NA,156
"21373",2021-07-10,NA,386,0,NA
"21374",2021-07-11,268,343,48,75
"21375",2021-07-12,268,385,0,117
"21376",2021-07-13,NA,385,0,NA
"21377",2021-07-14,NA,384,312,NA
"21378",2021-07-15,248,384,259,136
"21379",2021-07-16,260,342,0,82
"21380",2021-07-17,NA,316,0,NA
"21381",2021-07-18,NA,307,409,NA
"21382",2021-07-19,NA,280,739,NA
"21383",2021-07-20,227,NA,1887,NA
"21384",2021-07-21,227,274,508,47
"21385",2021-07-22,236,285,79,49
"21386",2021-07-23,238,285,0,47
"21387",2021-07-24,228,329,0,101
"21388",2021-07-25,228,340,0,112
"21389",2021-07-26,236,348,0,112
"21390",2021-07-27,NA,NA,NA,NA
"21391",2021-07-28,NA,NA,NA,NA
"21392",2021-07-29,NA,NA,NA,NA
"21393",2021-07-30,NA,NA,NA,NA
